Dream Tables by Joey Jones begins here.	
	
Table of Themes	
Proposition	Theme	Interpretation
"a"	"hay"	"[one of]To dream of making hay signifies success in all your undertakings.[or]This is a good omen to young lovers.[or]To dream you are selling hay is a bad omen and portends losses in business and dangerous accidents.[cycling]"
"an"	"ice"	"[one of]To dream of walking on slippery ice in winter is a sign that misfortune threatens you: if you slip down it foreshadows bad luck: if you dream of gliding or skating easily over smooth ice it shows that you will probably have a difficulty of some kind but will overcome it and get through handsomely.[or]For lovers to dream of going over ice is a bad omen.[cycling]"
"an"	"eye"	"[one of]If you dream you see a person with a defective eye it denotes disappointment: to see a glaring squint eye in your dream shows that you will be defeated or crossed in some enterprise.[or]To dream that your own eyes are defective or squint is a sure sign of bad luck: sore eyes denote sickness: blindness death.or deception.[cycling]"
"a"	"bankrupt"	"[one of]A bad dream your business is in a dangerous position and without great care you will be forced to stop.[cycling]"
"a"	"bed"	"[one of]A bed, clean and white, denotes peaceful surcease of worries.[or]For a woman to dream of making a bed, signifies a new lover and pleasant occupation.[or]To dream of being in bed, if in a strange room, unexpected friends will visit you.[or]If a sick person dreams of being in bed, new complications will arise, and, perhaps, death.[or]To dream that you are sleeping on a bed in the open air, foretells that you will have delightful experiences, and opportunity for improving your fortune.[or]For you to see negroes passing by your bed, denotes exasperating circumstances arising, which will interfere with your plans.[or]To see a friend looking very pale, lying in bed, signifies strange and woeful complications will oppress your friends, bringing discontent to yourself.[or]For a mother to dream that her child wets a bed, foretells she will have unusual anxiety, and persons sick, will not reach recovery as early as may be expected.[or]For persons to dream that they wet the bed, denotes sickness, or a tragedy will interfere with their daily routine of business.[cycling]"
"a"	"cornet"	"[one of]A cornet seen or heard in a dream, denotes kindly attentions from strangers.[cycling]"
"a"	"counterpane"	"[one of]A counterpane is very good to dream of, if clean and white, denoting pleasant occupations for women; but if it be soiled you may expect harassing situations.[or]Sickness usually follows this dream.[cycling]"
"a"	"crow"	"[one of]A crow indicates expedition in business adultery or a thief; if croaking an ill omen; if it flies on to the head of a child the child will be in great danger of a misfortune.[cycling]"
"a"	"lice"	"[one of]A dream of lice contains much waking worry and distress.[or]It often implies offensive ailments.[or]Lice on stock, foretells famine and loss.[or]To have lice on your body, denotes that you will conduct yourself unpleasantly with your acquaintances.[or]To dream of catching lice, foretells sickness, and that you will cultivate morbidity.[cycling]"
"a"	"greyhound"	"[one of]A greyhound is a fortunate object to see in your dream.[or]If it is following a young girl, you will be surprised with a legacy from unknown people.[or]If a greyhound is owned by you, it signifies friends where enemies were expected.[cycling]"
"a"	"hatchet"	"[one of]A hatchet seen in a dream, denotes that wanton wastefulness will expose you to the evil designs of envious persons.[or]If it is rusty or broken, you will have grief over wayward people.[cycling]"
"a"	"bay tree"	"[one of]A palmy leisure awaits you in which you will meet many pleasing varieties of diversions.[or]Much knowledge will be reaped in the rest from work.[or]It is generally a good dream for everybody.[cycling]"
"an"	"adder"	"[one of]A person that dreams of the asp and the adder, is thereby betokened to have stores of money and rich wives.[cycling]"
"a"	"priest"	"[one of]A priest is an augury of ill, if seen in dreams.[or]If he is in the pulpit, it denotes sickness and trouble for the dreamer.[or]If a woman dreams that she is in love with a priest, it warns her of deceptions and an unscrupulous lover.[or]If the priest makes love to her, she will be reproached for her love of gaiety and practical joking.[or]To confess to a priest, denotes that you will be subjected to humiliation and sorrow.[or]These dreams imply that you have done, or will do, something which will bring discomfort to yourself or relatives.[or]The priest or preacher is your spiritual adviser, and any dream of his professional presence is a warning against your own imperfections.[or]Seen in social circles, unless they rise before you as spectres, the same rules will apply as to other friends.[cycling]"
"an"	"ague"	"[one of]A sickly condition of the dreamer is sometimes implied by this dream.[or]To dream that you are shaking with an ague, signifies that you will suffer from some physical disorder, and that fluctuating opinions of your own affairs may bring you to the borders of prostration.[or]To see others thus affected, denotes that you will offend people by your supreme indifference to the influences of others.[cycling]"
"a"	"ball"	"[one of]A very satisfactory omen, if beautiful and gaily-dressed people are dancing to the strains of entrancing music.[or]If you feel gloomy and distressed at the inattention of others, a death in the family may be expected soon.[cycling]"
"a"	"virgin"	"[one of]A virgin dreaming that she has lost her virginity, signifies great danger.[cycling]"
"a"	"wail"	"[one of]A wail falling upon your ear while in the midst of a dream, brings fearful news of disaster and woe.[or]For a young woman to hear a wail, foretells that she will be deserted and left alone in distress, and perchance disgrace.[cycling]"
"a"	"washer woman"	"[one of]A washer woman seen in dreams, represents infidelity and a strange adventure.[or]For the business man, or farmer, this dream indicates expanding trade and fine crops.[or]For a woman to dream that she is a washer woman, denotes that she will throw decorum aside in her persistent effort to hold the illegal favor of men.[cycling]"
"a"	"napkin"	"[one of]A white napkin denotes orderly conduct which will bring happiness; a dirty napkin disorderly behavior.[cycling]"
"a"	"bequest"	"[one of]After this dream, pleasures of consolation from the knowledge of duties well performed, and the health of the young is assured.[cycling]"
"an"	"alum"	"[one of]Alum seen in a dream, portends frustration of well laid plans.[or]To taste alum, denotes secret remorse over some evil work by you upon some innocent person.[or]For a woman to dream of quantities of alum, foretells disappointment in her marriage and loss of affection.[cycling]"
"an"	"amethyst"	"[one of]Amethyst seen in a dream, represents contentment with fair business.[or]For a young woman to lose an amethyst, fortells broken engagements and slights in love.[cycling]"
"an"	"ammonia"	"[one of]Ammonia seen in a dream, means displeasure will be felt by the dreamer at the conduct of a friend.[or]Quarrels and disruptions of friendships will follow this dream.[or]For a young woman to see clear bottles of ammonia, foretells she will be deceived in the character and intentions of some person whom she considers friendly.[cycling]"
"an"	"arch"	"[one of]An arch in a dream, denotes your rise to distinction and the gaining of wealth by persistent effort.[or]To pass under one, foretells that many will seek you who formerly ignored your position.[or]For a young woman to see a fallen arch, denotes the destruction of her hopes, and she will be miserable in her new situation.[cycling]"
"an"	"obelisk"	"[one of]An obelisk looming up stately and cold in your dreams is the forerunner of melancholy tidings.[or]For lovers to stand at the base of an obelisk, denotes fatal disagreements.[cycling]"
"a"	"teeth"	"[one of]An ordinary dream of teeth augurs an unpleasant contact with sickness, or disquieting people.[or]If you dream that your teeth are loose, there will be failures and gloomy tidings.[or]If the doctor pulls your tooth, you will have desperate illness, if not fatal; it will be lingering.[or]To have them filled, you will recover lost valuables after much uneasiness.[or]To clean or wash your teeth, foretells that some great struggle will be demanded of you in order to preserve your fortune.[or]To dream that you are having a set of teeth made, denotes that severe crosses will fall upon you, and you will strive to throw them aside.[or]If you lose your teeth, you will have burdens which will crush your pride and demolish your affairs.[or]To dream that you have your teeth knocked out, denotes sudden misfortune.[or]Either your business will suffer, or deaths or accidents will come close to you.[or]To examine your teeth, warns you to be careful of your affairs, as enemies are lurking near you.[or]If they appear decayed and snaggled, your business or health will suffer from intense strains.[or]To dream of spitting out teeth, portends personal sickness, or sickness in your immediate family.[or]Imperfect teeth is one of the worst dreams.[or]It is full of mishaps for the dreamer.[or]A loss of estates, failure of persons to carry out their plans and desires, bad health, depressed conditions of the nervous system for even healthy persons.[or]For one tooth to fall out, foretells disagreeable news; if two, it denotes unhappy states that the dreamer will be plunged into from no carelessness on his part.[or]If three fall out, sickness and accidents of a very serious nature will follow.[or]Seeing all the teeth drop out, death and famine usually will prevail.[or]If the teeth are decayed and you pull them out, the same, only yourself, is prominent in the case.[or]To dream of tartar or any deposit falling off of the teeth and leaving them sound and white, is a sign of temporary indisposition, which will pass, leaving you wiser in regard to conduct, and you will find enjoyment in the discharge of duty.[cycling]"
"a"	"vault"	"[one of]An unexpected estate will fall to you if you dream of a vault.[cycling]"
"a"	"pope"	"[one of]Any dream in which you see the.[or]Pope, without speaking to him, warns you of servitude.[or]You will bow to the will of some master, even to that of women.[or]To speak to the.[or]Pope, denotes that certain high honors are in store for you.[or]To see the.[or]Pope looking sad or displeased, warns you against vice or sorrow of some kind.[cycling]"
"an"	"architect"	"[one of]Architects drawing plans in your dreams, denotes a change in your business, which will be likely to result in loss to you.[or]For a young woman to see an architect, foretells she will meet rebuffs in her aspirations and maneuvers to make a favorable marriage.[cycling]"
"a"	"crocodile"	"[one of]As sure as you dream of this creature, you will be deceived by your warmest friends.[or]Enemies will assail you at every turn.[or]To dream of stepping on a crocodile's back, you may expect to fall into trouble, from which you will have to struggle mightily to extricate yourself.[or]Heed this warning when dreams of this nature visit you.[or]Avoid giving your confidence even to friends.[cycling]"
"a"	"law"	"[one of]As to matters of law, to dream of places, of pleading, judges, attorneys, &c., signifies trouble, expense and revealing of secrets.[or]If a sick man dreameth he obtains a suit, he shall come to a better estate.[cycling]"
"a"	"courtship"	"[one of]Bad, bad, will be the fate of the woman who dreams of being courted.[or]She will often think that now he will propose, but often she will be disappointed.[or]Disappointments will follow illusory hopes and fleeting pleasures.[or]For a man to dream of courting, implies that he is not worthy of a companion.[cycling]"
"a"	"battle"	"[one of]Battle signifies striving with difficulties, but a final victory over the same.[or]If you are defeated in battle, it denotes that bad deals made by others will mar your prospects for good.[cycling]"
"a"	"bear"	"[one of]Bear is significant of overwhelming competition in pursuits of every kind.[or]To kill a bear, portends extrication from former entanglements.[or]A young woman who dreams of a bear will have a threatening rival or some misfortune.[cycling]"
"a"	"beauty"	"[one of]Beauty in any form is pre-eminently good.[or]A beautiful woman brings pleasure and profitable business.[or]A well formed and beautiful child, indicates love reciprocated and a happy union.[cycling]"
"an"	"orator"	"[one of]Being under the spell of an orator's eloquence, denotes that you will heed the voice of flattery to your own detriment, as you will be persuaded into offering aid to unworthy people.[or]If a young woman falls in love with an orator, it is proof that in her loves she will be affected by outward show.[cycling]"
"an"	"orchestra"	"[one of]Belonging to an orchestra and playing, foretells pleasant entertainments, and your sweetheart will be faithful and cultivated.[or]To hear the music of an orchestra, denotes that the knowledge of humanity will at all times prove you to be a much-liked person, and favors will fall unstintedly upon you.[cycling]"
"a"	"bet"	"[one of]Betting on races, beware of engaging in new undertakings.[or]Enemies are trying to divert your attention from legitimate business.[or]Betting at gaming tables, denotes that immoral devices will be used to wring money from you.[cycling]"
"a"	"cannon"	"[one of]Beware of treacherous friends.[or]To dream you hear a cannon is a sign of sickness or death.[cycling]"
"a"	"blanket"	"[one of]Blankets in your dream means treachery if soiled.[or]If new and white, success where failure is feared, and a fatal sickness will be avoided through unseen agencies.[cycling]"
"a"	"balloon"	"[one of]Blighted hopes and adversity come with this dream.[or]Business of every character will sustain an apparent falling off.[or]To ascend in a balloon, denotes an unfortunate journey.[cycling]"
"a"	"blood"	"[one of]Blood-stained garments, indicate enemies who seek to tear down a successful career that is opening up before you.[or]The dreamer should beware of strange friendships.[or]To see blood flowing from a wound, physical ailments and worry.[or]Bad business caused from disastrous dealings with foreign combines.[or]To see blood on your hands, immediate bad luck, if not careful of your person and your own affairs.[cycling]"
"a"	"boat"	"[one of]Boat signals forecast bright prospects, if upon clear water.[or]If the water is unsettled and turbulent, cares and unhappy changes threaten the dreamer.[or]If with a gay party you board a boat without an accident, many favors will be showered upon you.[or]Unlucky the dreamer who falls overboard while sailing upon stormy waters.[cycling]"
"a"	"bog"	"[one of]Bogs, denotes burdens under whose weight you feel that endeavors to rise are useless.[or]Illness and other worries may oppress you.[cycling]"
"a"	"bonnet"	"[one of]Bonnet, denotes much gossiping and slanderous insinuations, from which a woman should carefully defend herself.[or]For a man to see a woman tying her bonnet, denotes unforeseen good luck near by.[or]His friends will be faithful and true.[or]A young woman is likely to engage in pleasant and harmless flirtations if her bonnet is new and of any color except black.[or]Black bonnets, denote false friends of the opposite sex.[cycling]"
"a"	"bow and arrow"	"[one of]Bow and arrow in a dream, denotes great gain reaped from the inability of others to carry out plans.[or]To make a bad shot means disappointed hopes in carrying forward successfully business affairs.[cycling]"
"a"	"brick"	"[one of]Brick in a dream, indicates unsettled business and disagreements in love affairs.[or]To make them you will doubtless fail in your efforts to amass great wealth.[cycling]"
"a"	"broth"	"[one of]Broth denotes the sincerity of friends.[or]They will uphold you in all instances.[or]If you need pecuniary aid it will be forthcoming.[or]To lovers, it promises a strong and lasting attachment.[or]To make broth, you will rule your own and others' fate.[cycling]"
"a"	"skya"	"[one of]clear sky denotes a marriage speedy and happy; a red sky increase of wealth; if you ascend into the sky you may look for much honor; a cloudy sky shows misfortune.[cycling]"
"a"	"cocoanut"	"[one of]Cocoanuts in dreams, warns you of fatalities in your expectations, as sly enemies are encroaching upon your rights in the guise of ardent friends.[or]Dead cocoanut trees are a sign of loss and sorrow.[or]The death of some one near you may follow.[cycling]"
"a"	"back-bite"	"[one of]Conditions will change from good to bad if you are joined with others in back-biting.[or]For your friends to back-bite you, indicates worriment by servants and children.[cycling]"
"an"	"orphan"	"[one of]Condoling with orphans in a dream, means that the unhappy cares of others will touch your sympathies and cause you to sacrifice much personal enjoyment.[or]If the orphans be related to you, new duties will come into your life, causing estrangement from friends ant from some person held above mere friendly liking.[cycling]"
"a"	"copper plate"	"[one of]Copper plate seen in a dream, is a warning of discordant views causing unhappiness between members of the same household.[cycling]"
"a"	"dairy"	"[one of]Dairy is a good dream both to the married and unmarried.[cycling]"
"a"	"dandelion"	"[one of]Dandelions blossoming in green foliage, foretells happy unions and prosperous surroundings.[cycling]"
"a"	"crawfish"	"[one of]Deceit is sure to assail you in your affairs of the heart, if you are young, after dreaming of this backward-going thing.[cycling]"
"a"	"sedition"	"[one of]Denotes health and trouble and shame.[cycling]"
"a"	"bankrupt"	"[one of]Denotes partial collapse in business, and weakening of the brain faculties.[or]A warning to leave speculations alone.[cycling]"
"a"	"bullock"	"[one of]Denotes that kind friends will surround you, if you are in danger from enemies.[or]Good health is promised you.[cycling]"
"a"	"laurel"	"[one of]Denotes victory and pleasure; to the married inheritance and children; to the single marriage.[cycling]"
"a"	"derrick"	"[one of]Derricks seen in a dream, indicate strife and obstruction in your way to success.[cycling]"
"a"	"bench"	"[one of]Distrust debtors and confidants if you dream of sitting on one.[or]If you see others doing so, happy reunions between friends who have been separated through misunderstandings are suggested.[cycling]"
"a"	"cook"	"[one of]Dream you’re busy with a cook,.[or]And for a wedding shortly look.[cycling]"
"a"	"mouth"	"[one of]Dreaming of a large mouth and big lips is a sure sign you will be kissed by some one of the opposite sex: to dream of a mouth out of shape or with a hare lip denotes to a woman that she will have a deformed child and to a man that he will get into a difficulty by means of his intimacy with a woman: to dream of a small mouth and thin lips is a sign of loud and angry words and that some one will give you a scolding.[cycling]"
"a"	"nurse"	"[one of]Dreaming of a nurse for lying-in women foreshadows luck and plenty of cash; to a farmer such a dream prognosticates abundant crops and to newly married people good crops of children.[cycling]"
"a"	"pump"	"[one of]Dreaming of a pump is an excellent omen: if you dream of pumping clear water from one it shows that you will have good luck in business or in a speculation: pumping dirty water is a sign of sickness.[cycling]"
"an"	"infant"	"[one of]Dreaming of a young infant is an excellent omen as it foretells joy and gladness good luck and success generally.[or]Lovers who dream such a dream may be sure of a happy and thrifty marriage.[or]To a business man this dream predicts a new and successful enterprise.[cycling]"
"a"	"child"	"[one of]Dreaming of children is a good omen.[or]If a Woman dreams she is about to have a child it foretells a rich legacy or other good fortune: if she is a maid that has this dream she must be on her guard or she will lose her virtue.[cycling]"
"a"	"grief"	"[one of]Dreaming of grief is a sign of a jolly time as such dreams go by the rule of contrary.[or]Thus if you dream you are in great grief at the death of a friend or relative you may calculate that a happy.[or]Wedding is soon to come off at which you will be present.[cycling]"
"a"	"lovely"	"[one of]Dreaming of lovely things, brings favor to all persons connected with you.[or]For a lover to dream that his sweetheart is lovely of person and character, foretells for him a speedy and favorable marriage.[or]If through the vista of dreams you see your own fair loveliness, fate bids you, with a gleaming light, awake to happiness.[cycling]"
"a"	"will"	"[one of]Dreaming of making your will signifies that you will live a long time in uninterrupted happiness and joy.[or]For a woman with child to dream that she has made her will, is unfortunate, as it denotes an unfortunate trial of labor.[cycling]"
"a"	"milk"	"[one of]Dreaming of milk predicts to a man the love of a lady.[or]If a newly married lady dream that she has a full breast of milk it is a sign that she will be happily delivered of a fine child; to an old woman it portends much money.[cycling]"
"a"	"cousin"	"[one of]Dreaming of one's cousin, denotes disappointments and afflictions.[or]Saddened lives are predicted by this dream.[or]To dream of an affectionate correspondence with one's cousin, denotes a fatal rupture between families.[cycling]"
"an"	"oxen"	"[one of]Dreaming of oxen denotes a year of plenty and fruitfulness.[or]But if they appear poor and lean it threatens a year of scarcity and famine.[or]To dream you feed oxen is a good sign, but to see oxen go to water is a bad sign.[cycling]"
"an"	"orchard"	"[one of]Dreaming of passing through leaving and blossoming orchards with your sweetheart, omens a delightful consummation of a long courtship.[or]If the orchard is filled with ripening fruit, it denotes recompense for faithful service to those under masters, and full fruition of designs for the leaders of enterprises.[or]Happy homes, with loyal husbands and obedient children, for wives.[or]If you are in an orchard and see hogs eating the fallen fruit, it is a sign that you will lose property in trying to claim what are not really your own belongings.[or]To gather the ripe fruit, is a happy omen of plenty to all classes.[or]Orchards infested with blight, denotes a miserable existence, amid joy and wealth.[or]To be caught in brambles, while passing through an orchard, warns you of a jealous rival, or, if married, a private but large row with your partner.[or]If you dream of seeing a barren orchard, opportunities to rise to higher stations in life will be ignored.[or]If you see one robbed of its verdure by seeming winter, it denotes that you have been careless of the future in the enjoyment of the present.[or]To see a storm-swept orchard, brings an unwelcome guest, or duties.[cycling]"
"a"	"pheasant"	"[one of]Dreaming of pheasants, omens good fellowship among your friends.[or]To eat one, signifies that the jealousy of your wife will cause you to forego friendly intercourse with your friends.[or]To shoot them, denotes that you will fail to sacrifice one selfish pleasure for the comfort of friends.[cycling]"
"a"	"salmon"	"[one of]Dreaming of salmon, denotes that much good luck and pleasant duties will employ your time.[or]For a young woman to eat it, foretells that she will marry a cheerful man, with means to keep her comfortable.[cycling]"
"a"	"laurel"	"[one of]Dreaming of the laurel, brings success and fame.[or]You will acquire new possessions in love.[or]Enterprises will be laden with gain.[or]For a young woman to wreath laurel about her lover's head, denotes that she will have a faithful man, and one of fame to woo her.[cycling]"
"an"	"oil"	"[one of]Dreaming that you are anointed with oil, is good for women, but for men, denotes shame.[cycling]"
"a"	"misery"	"[one of]Dreaming that you are in great misery on account of some calamity that has befallen either your sweetheart, partner in life, or a relation, denotes that you may expect some important event occurring, which will be deeply interesting to you.[cycling]"
"a"	"fester"	"[one of]Dreaming that you have a fester on your hand or fingers is a sign that you will give somebody a present; if on your feet or legs it shows you will go to see some one who will be glad to see you.[cycling]"
"an"	"organ"	"[one of]Dreaming that you hear the sound of an organ, signifies joy.[cycling]"
"a"	"pile"	"[one of]Dreaming that you pile anything against the wall, denotes assistance in business.[cycling]"
"a"	"pond"	"[one of]Dreaming that you see a little pond, signifies the love of a beautiful woman.[or]If a woman have that dream, she shall have her design accomplished.[or]To dream that your pond is dried up, signifies poverty or death.[or]To dream that you are in a boat, upon a pond of clear water, is very good, and signifies joy and success in affairs.[cycling]"
"a"	"plant"	"[one of]Dreaming that you see a plant come out of your body, is death.[or]To dream of plants quick of growth, as the vine and the peach tree, denotes that the good and evil portended shall quickly happen.[or]But trees that are slow of growing, as the oak, olive, &c., show that the good or evil that shall happen to us shall be long in coming.[cycling]"
"a"	"rasp"	"[one of]Dreaming that you see a rasp, is unfortunate to the married.[or]To a virgin, it is a caution for her to beware of her lover.[or]To the lover, it denotes that he will travel by sea.[cycling]"
"a"	"nut tree"	"[one of]Dreaming that you see nut trees, signifies riches and content gained with labor and pain.[or]Dreaming that you find nuts that have been hid, signifies that you will find treasure.[cycling]"
"an"	"ottoman"	"[one of]Dreams in which you find yourself luxuriously reposing upon an ottoman, discussing the intricacies of love with your sweetheart, foretells that envious rivals will seek to defame you in the eyes of your affianced, and a hasty marriage will be advised.[cycling]"
"an"	"apparel"	"[one of]Dreams of apparel, denote that enterprises will be successes or failures, as the apparel seems to be whole and clean, or soiled and threadbare.[or]To see fine apparel, but out of date, foretells that you will have fortune, but you will scorn progressive ideas.[or]If you reject out-of-date apparel, you will outgrow present environments and enter into new relations, new enterprises and new loves, which will transform you into a different person.[or]To see yourself or others appareled in white, denotes eventful changes, and you will nearly always find the change bearing sadness.[or]To walk with a person wearing white, proclaims that person's illness or distress, unless it be a young woman or child, then you will have pleasing surroundings for a season at least.[or]To see yourself, or others, dressed in black, portends quarrels, disappointments, and disagreeable companions; or, if it refers to business, the business will fall short of expectations.[or]To see yellow apparel, foretells approaching gaieties and financial progress.[or]Seen as a flitting spectre, in an unnatural light, the reverse may be expected.[or]You will be fortunate if you dream of yellow cloth.[or]To dream of blue apparel, signifies carrying forward to victory your aspirations, through energetic, insistent efforts.[or]Friends will loyally support you.[or]To dream of crimson apparel, foretells that you will escape formidable enemies by a timely change in your expressed intention.[or]To see green apparel, is a hopeful sign of prosperity and happiness.[cycling]"
"a"	"kissing"	"[one of]Dreams of kissing work curiously: if a girl dreams that she is kissed by a young man in whom she takes no particular interest it may be a good omen and it may not; for if he happens to be a silly fellow who imagines that she is in love with him it is a sign she will be slandered in a way that will make her unhappy; but if he has no such sentiment then the sign is exactly the reverse—that is some one will speak well of her to those whom she esteems highly—perhaps to her lover.[or]If a girl dreams she is kissed by her lover it predicts that he will say something unpleasant to her at their next meeting; if a lover dreams that his sweetheart kisses him the sign is similar.[cycling]"
"an"	"apricot"	"[one of]Dreams of seeing apricots growing, denote that the future, though seemingly rosy hued, holds masked bitterness and sorrow for you.[or]To eat them signifies the near approach of calamitous influences.[or]If others eat them, your surroundings will be unpleasant and disagreeable to your fancies.[or]A friend says: ``Apricots denote that you have been wasting time over trifles or small things of no value.''.[cycling]"
"an"	"astral"	"[one of]Dreams of the astral, denote that your efforts and plans will culminate in worldly success and distinction.[or]A spectre or picture of your astral self brings heart-rending tribulation.[cycling]"
"a"	"buttermilk"	"[one of]Drinking buttermilk, denotes sorrow will follow some worldly pleasure, and some imprudence will impair the general health of the dreamer.[or]To give it away, or feed it to pigs, is bad still.[or]To dream that you are drinking buttermilk made into oyster soup, denotes that you will be called on to do some very repulsive thing, and ill luck will confront you.[or]There are quarrels brewing and friendships threatened.[or]If you awaken while you are drinking it, by discreet maneuvering you may effect a pleasant understanding of disagreements.[cycling]"
"an"	"ink-stand"	"[one of]Empty ink-stands denote that you will narrowly escape public denunciation for some supposed injustice.[or]To see them filled with ink, if you are not cautious, enemies will succeed in calumniation.[cycling]"
"an"	"envelope"	"[one of]Envelopes seen in a dream, omens news of a sorrowful cast.[cycling]"
"an"	"exchange"	"[one of]Exchange, denotes profitable dealings in all classes of business.[or]For a young woman to dream that she is exchanging sweethearts with her friend, indicates that she will do well to heed this as advice, as she would be happier with another.[cycling]"
"a"	"beer"	"[one of]Fateful of disappointments if drinking from a bar.[or]To see others drinking, work of designing intriguers will displace your fairest hopes.[or]To habitue's of this beverage, harmonious prospectives are foreshadowed, if pleasing, natural and cleanly conditions survive.[or]The dream occurrences frequently follow in the actual.[cycling]"
"a"	"spectre"	"[one of]Few dreams are more certain of good luck to the dreamer, than to dream of spectres.[or]It prognosticates business to the merchant, work for the artist and mechanic, and marriage to the maiden.[cycling]"
"a"	"fire"	"[one of]Fire is favorable to the dreamer if he does not get burned.[or]It brings continued prosperity to seamen and voyagers, as well as to those on land.[or]To dream of seeing your home burning, denotes a loving companion, obedient children, and careful servants.[or]For a business man to dream that his store is burning, and he is looking on, foretells a great rush in business and profitable results.[or]To dream that he is fighting fire and does not get burned, denotes that he will be much worked and worried as to the conduct of his business.[or]To see the ruins of his store after a fire, forebodes ill luck.[or]He will be almost ready to give up the effort of amassing a handsome fortune and a brilliant business record as useless, but some unforeseen good fortune will bear him up again.[or]If you dream of kindling a fire, you may expect many pleasant surprises.[or]You will have distant friends to visit.[or]To see a large conflagration, denotes to sailors a profitable and safe voyage.[or]To men of literary affairs, advancement and honors; to business people, unlimited success.[cycling]"
"a"	"flax spinning"	"[one of]Flax spinning, foretells you will be given to industrious and thrifty habits.[cycling]"
"a"	"tobacco"	"[one of]For a boy to dream of chewing tobacco is a sign of poverty as rum and tobacco-chewing go together: to dream of smoking foretells waste but is not exactly an omen of poverty though waste always precedes that state.[or]The best way is not to dream of using tobacco at all.[or]If you dream of seeing large pilesof tobacco it is a sign of bad luck and loss in some speculation.[or]To dream you take snuff is a bad omen in love affairs but if you dream you sneeze when you take it it is a sign of long life.[cycling]"
"a"	"leeward"	"[one of]For a captain or seafaring man to dream his vessel drifts leeward, is ominous of a storm.[cycling]"
"a"	"china store"	"[one of]For a china merchant to dream that his store looks empty, foretells he will have reverses in his business, and withal a gloomy period will follow.[cycling]"
"a"	"drought"	"[one of]For a farmer or planter to dream of seeing his grass or crops drying up for want of rain denotes that an accident will happen to him or his property during a storm or that some of his live stock will die or meet an accident.[cycling]"
"a"	"pound"	"[one of]For a farmer to dream that any of his cattle are taken to pound is a sign that they will increase: if he dreams of seeing strange cattle in a pound it foretells that he will soon buy some.[cycling]"
"a"	"needle"	"[one of]For a female to dream she is busy with the needle, indicates that she is about to take a journey either of pleasure or necessity.[or]For one of the male sex to dream he is using the needle (except he is a tailor), forebodes a series of distressing and unpleasant matters are about to harass and perplex him.[cycling]"
"an"	"offer"	"[one of]For a female to dream that she has received an offer of love from one of the male sex, portends troubles and sorrows await her.[or]For one to dream that she has rejected an offer of marriage, betokens that she will be surprised with the news that a near relative is dead and left her a large some of money.[cycling]"
"a"	"thorn"	"[one of]For a girl to dream of accidentally sticking a thorn into her finger is a sign she will have a ring presented to her probably a wedding ring: if a married woman dreams this some outsider will make love to her by first offering a ring.[or]If any one dreams of sticking a thorn in either foot or leg it foretells improper intimacy with the opposite sex which will not end in disgrace but in marriage: married people who dream this will do the same thing and not be found out.[cycling]"
"a"	"pancake"	"[one of]For a girl to dream of baking pancakes is a sign that some gentleman is in love with her; and if a married woman has such a dream she may be sure that some man other than her husband admires her; to dream of eating pancakes foretells falling in love to either sex; and if you relish them you will be successful in your love.[cycling]"
"a"	"plaster"	"[one of]For a girl to dream of having a plaster on her person is a sign that some one will offer her an insult or perhaps make an attempt upon her chastity: if a man dreams this the same will probably happen to his wife or sweetheart.[cycling]"
"a"	"stain"	"[one of]For a girl to dream of stains on her dress is a sign of scandal: if she imagines that the stains are in front she will be accused of an improper intimacy with a gentleman; if on the right sleeve it will be insinuated that she took what did not belong to her; if on the left sleeve some one will be disparaging her veracity.[or]If a loverdreams that his sweetheart’s dress is stained behind it shows that she is untrue to him.[cycling]"
"a"	"fife"	"[one of]For a girl to dream she hears the shrill music of a fife is a sign she will soon have a beau and that he will be a smart and desirable young man.[cycling]"
"a"	"necklace"	"[one of]For a girl to dream that a gentleman presents her with a necklace is a sign that some one meditates an attempt to seduce her: if a married woman dreams that her husband gives her a necklace it shows that she will soon be in the family way.[cycling]"
"a"	"nightcap"	"[one of]For a girl to dream that she forgot to take off her nightcap but received company in it is a sign she will be kissed by a strange gentleman or that some stranger will be smitten by her charms: if a married woman dreams this it foretells that her husband will be jealous of her and perhaps not without cause.[cycling]"
"a"	"stranger"	"[one of]For a girl to dream that she is kissed by a stranger promises her a new lover: a married woman who dreams this will probably soon present her husband with a stranger in the shape of a new baby and he will unhappily doubt its paternity.[cycling]"
"a"	"ring"	"[one of]For a lady to dream that a gentleman presents her with a ring or that she has a ring belonging to a gentleman is a sign of a wedding.[or]If a young man dreams that he has got a lady’s ring the omen is similar.[or]To dream of finding a ring foretells that the person finding it will marry within a year.[cycling]"
"a"	"tenant"	"[one of]For a landlord to see his tenant in a dream, denotes he will have business trouble and vexation.[or]To imagine you are a tenant, foretells you will suffer loss in experiments of a business character.[or]If a tenant pays you money, you will be successful in some engagements.[cycling]"
"a"	"rival"	"[one of]For a lover to dream that he has a rival who annoys him is a sign that he is in high favor with his sweetheart; such a dream to a young lady has a similar omen and she has only to name the happy day to settle the matter to her mind.[cycling]"
"a"	"garter"	"[one of]For a lover to find his lady's garter, foretells that he will lose caste with her.[or]He will find rivals.[or]For a woman to dream that she loses her garter, signifies that her lover will be jealous and suspicious of a handsomer person.[or]For a married man to dream of a garter, foretells that his wife will hear of his clandestine attachments, and he will have a stormy scene.[or]For a woman to dream that she is admiring beautiful jeweled garters on her limbs, denotes that she will be betrayed in her private movements, and her reputation will hang in the balance of public opinion.[or]If she dreams that her lover fastens them on her, she will hold his affections and faith through all adverse criticisms.[cycling]"
"a"	"failure"	"[one of]For a lover, this is sometimes of contrary significance.[or]To dream that he fails in his suit, signifies that he only needs more masterfulness and energy in his daring, as he has already the love and esteem of his sweetheart.[or](Contrary dreams are those in which the dreamer suffers fear, and not injury.).[or]For a young woman to dream that her life is going to be a failure, denotes that she is not applying her opportunities to good advantage.[or]For a business man to dream that he has made a failure, forebodes loss and bad management, which should be corrected, or failure threatens to materialize in earnest.[cycling]"
"an"	"invasion"	"[one of]For a maiden to dream of invasion, is a sign that some evil-disposed person will endeavor to lead her astray; to a man in business, it denotes much competition; to a mechanic, loss of his situation.[cycling]"
"a"	"bonnet"	"[one of]For a maiden to dream she gets a new bonnet, gives promise of a new lover, but.[or][or]Shipton says that much depends on the color; if green, he will be deceitful; if blue, he will prove affectionate; if pink, his love will not be lasting; if yellow or white, he will quickly improve marriage; but if a female loses her bonnet, it behooves her to be guarded of her virtue, for she is in danger of being led astray; if it be blown off, she will have something she dearly prizes stolen from her.[cycling]"
"a"	"fairy"	"[one of]For a maiden to dream she sees a fairy, shows she will soon change her present state by becoming the wife of a good husband.[or]It is good for women under any circumstances to dream of fairies, but it denotes evil to men, and no man should undertake any important matter for several days after, or it will surely end in his being disappointed.[cycling]"
"a"	"wedding"	"[one of]For a man that is sick to dream that he is wedded to a maid, shows he shall die quickly.[or]If any one dream he is wedded to a deformed woman, it signifies discontent.[or]If to a handsome woman, joy.[cycling]"
"a"	"garlic"	"[one of]For a man to dream he eats garlic signifies he shall discover hidden secrets and meet with some domestic jars; yet to dream he has it in the house is good.[cycling]"
"a"	"garlic"	"[one of]For a man to dream he eats garlic, signifies he shall discover hidden secrets and meet with some domestic jars.[or]Yet to dream he has it in the house, is good.[cycling]"
"a"	"beard"	"[one of]For a man to dream he has a long beard, denotes good fortune; if he is in trade, he will thrive; if he is in love, he will marry the present object of his affections, who will bring him some money; if he is a farmer, it denotes good crops, and an addition to his farm.[or]If a married woman dreams of a beard, it is unlucky; it foretells the loss of her husband and that she will fall into great distress.[or]If a maid dreams of a beard, it denotes that she will be quickly married and that the fruit of her womb is a boy.[or]For a woman to dream that she has a beard is a very lucky omen, and denotes that she will speedily attain her most sanguine desires.[cycling]"
"a"	"scold"	"[one of]For a man to dream he has a scolding shrewish wife is a sign that he will be lucky in everything he undertakes: if a lover dreams that his sweetheart scolds at him it is a sign that her love is strong and unalterable.[cycling]"
"a"	"hat"	"[one of]For a man to dream he has got a new hat shadows forth good luck and advancement; dreaming of an old or shabby hat is a sign he will soon fall in love; and if he dreams he is wearing such a hat the omen is not so favorable for he will probably endeavor to take improper liberties with his sweetheart and be successful.[cycling]"
"a"	"fool"	"[one of]For a man to dream he is a fool, is good for those who would govern and teach children.[cycling]"
"an"	"old woman"	"[one of]For a man to dream he is courting an old woman, and that she returns his love, is a very fortunate omen.[or]It prefigures success in worldly concerns, that he will many a beautiful young woman, have lovely children, and be very happy.[cycling]"
"a"	"leapfrog"	"[one of]For a man to dream he plays at leapfrog is bad.[or]For many causes, troubles and vexations will soon overtake him.[or]If a maiden has this dream, it signifies that her lover is inconstant.[cycling]"
"a"	"hair"	"[one of]For a man to dream his hair is long, like a woman’s, signifies cowardice and effeminacy, and that the person dreaming will be deceived by a woman.[or]To dream one sees a woman without hair, signifies famine, poverty and sickness.[or]To see a man bald and without hair, signifies the contrary.[cycling]"
"a"	"barmaid"	"[one of]For a man to dream of a barmaid, denotes that his desires run to low pleasures, and he will scorn purity.[or]For a young woman to dream that she is a barmaid, foretells that she will be attracted to fast men, and that she will prefer irregular pleasures to propriety.[cycling]"
"a"	"basket"	"[one of]For a man to dream of baskets is evil; it denotes decay of business to a merchant, want of employment to a mechanic, and loss of place to a servant; but if a woman dreams she receives a number of baskets it is a good omen, and especially so if well filled; to a maiden it denotes that she will have many new lovers; to a wife, that she will have an increase in her family, and to the widow, that she will soon marry again.[cycling]"
"a"	"kissing"	"[one of]For a man to dream of kissing a young maid, and that she vanishes away before he can accomplish his desire, denotes that the next day he shall see great store of good cheer.[or]To dream you kiss a person deceased, signifies long life.[cycling]"
"a"	"queen"	"[one of]For a man to dream of seeing a queen foretells the loss of money either by robbery or bad debts: if he is presented to a queen the dream is still worse in respect to losses.[cycling]"
"an"	"epaulet"	"[one of]For a man to dream of wearing epaulets, if he is a soldier, denotes his disfavor for a time, but he will finally wear honors.[or]For a woman to dream that she is introduced to a person wearing epaulets, denotes that she will form unwise attachments, very likely to result in scandal.[cycling]"
"a"	"bachelor"	"[one of]For a man to dream that he is a bachelor, is a warning for him to keep clear of women.[or]For a woman to dream of a bachelor, denotes love not born of purity.[or]Justice goes awry.[or]Politicians lose honor.[cycling]"
"a"	"pall-bearer"	"[one of]For a man to dream that he is a pall-bearer at a funeral denotes that he will be married within a year: to dream of seeing pall-bearers is a sign you will be invited to a wedding.[cycling]"
"a"	"concubine"	"[one of]For a man to dream that he is in company with a concubine, forecasts he is in danger of public disgrace, striving to keep from the world his true character and state of business.[or]For a woman to dream that she is a concubine, indicates that she will degrade herself by her own improprieties.[or]For a man to dream that his mistress is untrue, denotes that he has old enemies to encounter.[or]Expected reverses will arise.[cycling]"
"a"	"shave"	"[one of]For a man to dream that he is shaving is a sign he will get in debt: to dream that any one shaved you in a bargain foretells that some debt will be paid to you which you had given up as lost.[cycling]"
"a"	"run"	"[one of]For a man to dream that he would run, and yet cannot lift up his feet, shows he hath an earnest desire to accomplish somewhat, which he will find very difficult.[or]When a sick person dreams he runs, it is a good sign.[cycling]"
"a"	"birth"	"[one of]For a married woman to dream of giving birth to a child, great joy and a handsome legacy is foretold.[or]For a single woman, loss of virtue and abandonment by her lover.[cycling]"
"a"	"custard"	"[one of]For a married woman to dream of making or eating custard, indicates she will be called upon to entertain an unexpected guest.[or]A young woman will meet a stranger who will in time become a warm friend.[or]If the custard has a sickening sweet taste, or is insipid, nothing but sorrow will intervene where you had expected a pleasant experience.[cycling]"
"a"	"throat"	"[one of]For a married woman to dream that her throat is sore or swelled or out of order is a sign she is in the family way; and a girl who dreams this had better be careful and keep pretty clear of the young fellows for fear of accidents.[cycling]"
"a"	"widow"	"[one of]For a newly married woman to dream that she is a widow, signifies that she will be blessed with comfort and happiness in domestic life and be the mother of dutiful and obedient children.[cycling]"
"an"	"ugly"	"[one of]For a person to dream of being ugly or deformed, indicates that the dreamer will be surprised by hearing from a long absent friend a communication of a pleasing and gratifying nature.[cycling]"
"a"	"telescope"	"[one of]For a person to dream of looking through a telescope at some distant object, is an indication that the dreamer will shortly receive a letter from a friend in a far-distant country.[cycling]"
"a"	"grindstone"	"[one of]For a person to dream of turning a grindstone, his dream is prophetic of a life of energy and well directed efforts bringing handsome competency.[or]If you are sharpening tools, you will be blessed with a worthy helpmate.[or]To deal in grindstones, is significant of small but honest gain.[cycling]"
"a"	"witchcraft"	"[one of]For a person to dream that he has been to visit a supposed fortune-teller, denotes that misfortune shall befall him, unpleasantness in his family, treachery in his place of business and deception in those he supposed his best friends.[cycling]"
"an"	"office"	"[one of]For a person to dream that he holds office, denotes that his aspirations will sometimes make him undertake dangerous paths, but his boldness will be rewarded with success.[or]If he fails by any means to secure a desired office he will suffer keen disappointment in his affairs.[or]To dream that you are turned out of office, signifies loss of valuables.[cycling]"
"a"	"want"	"[one of]For a person to dream that he or she comes to sudden want in temporal things, denotes that an unexpected good fortune awaits them by the death of a wealthy relative or the success of some speculation or business bargain.[cycling]"
"a"	"beacon-light"	"[one of]For a sailor to see a beacon-light, portends fair seas and a prosperous voyage.[or]For persons in distress, warm attachments and unbroken, will arise among the young.[or]To the sick, speedy recovery and continued health.[or]Business will gain new impetus.[or]To see it go out in time of storm or distress, indicates reverses at the time when you thought.[or]Fortune was deciding in your favor.[cycling]"
"an"	"undertaker"	"[one of]For a single person to dream of seeing an undertaker enter the house, and attend to the mournful obsequies of a funeral, denotes that the dreamer will be married in a short time.[or]For a married person to dream of seeing an undertaker attending to his duties, is an indication that his family will be increased in a short time.[cycling]"
"a"	"wedding ring"	"[one of]For a woman to dream her wedding ring is bright and shining, foretells that she will be shielded from cares and infidelity.[or]If it should be lost or broken, much sadness will come into her life through death and uncongeniality.[or]To see a wedding ring on the hand of a friend, or some other person, denotes that you will hold your vows lightly and will court illicit pleasure.[cycling]"
"a"	"kitten"	"[one of]For a woman to dream of a beautiful fat, white kitten, omens artful deception will be practised upon her, which will almost ensnare her to destruction, but her good sense and judgment will prevail in warding off unfortunate complications.[or]If the kittens are soiled, or colored and lean, she will be victimized into glaring indiscretions.[or]To dream of kittens, denotes abominable small troubles and vexations will pursue and work you loss, unless you kill the kitten, and then you will overcome these worries.[or]To see snakes kill kittens, you have enemies who in seeking to injure you will work harm to themselves.[cycling]"
"a"	"bronze"	"[one of]For a woman to dream of a bronze statue, signifies that she will fail in her efforts to win the person she has determined on for a husband.[or]If the statue simulates life, or moves, she will be involved in a love affair, but no marriage will occur.[or]Disappointment to some person may follow the dream.[or]To dream of bronze serpents or insects, foretells you will be pursued by envy and ruin.[or]To see bronze metals, denotes your fortune will be uncertain and unsatisfactory.[cycling]"
"a"	"chemise"	"[one of]For a woman to dream of a chemise, denotes she will hear unfavorable gossip about herself.[cycling]"
"a"	"mouse"	"[one of]For a woman to dream of a mouse, denotes that she will have an enemy who will annoy her by artfulness and treachery.[cycling]"
"a"	"night-hag"	"[one of]For a woman to dream of a night-hag, denotes that she will be much slandered by some one whom she deems her friend.[or]For a man to dream of this nonentity, is a sign that some woman is endeavoring to do him an injury.[cycling]"
"an"	"afternoon"	"[one of]For a woman to dream of an afternoon, denotes she will form friendships which will be lasting and entertaining.[or]A cloudy, rainy afternoon, implies disappointment and displeasure.[cycling]"
"a"	"chalk"	"[one of]For a woman to dream of chalking her face, denotes that she will scheme to obtain admirers.[or]To dream of using chalk on a board, you will attain public honors, unless it is the blackboard; then it indicates ill luck.[or]To hold hands full of chalk, disappointment is foretold.[cycling]"
"a"	"bread"	"[one of]For a woman to dream of eating bread, denotes that she will be afflicted with children of stubborn will, for whom she will spend many days of useless labor and worry.[or]To dream of breaking bread with others, indicates an assured competence through life.[or]To see a lot of impure bread, want and misery will burden the dreamer.[or]If the bread is good and you have access to it, it is a favorable dream.[or][or]Baking and.[cycling]"
"a"	"niece"	"[one of]For a woman to dream of her niece, foretells she will have unexpected trials and much useless worry in the near future.[cycling]"
"a"	"nuptial"	"[one of]For a woman to dream of her nuptials, she will soon enter upon new engagements, which will afford her distinction, pleasure, and harmony.[cycling]"
"a"	"drinking"	"[one of]For a woman to dream of hilarious drinking, denotes that she is engaging in affairs which may work to her discredit, though she may now find much pleasure in the same.[or]If she dreams that she fails to drink clear water, though she uses her best efforts to do so, she will fail to enjoy some pleasure that is insinuatingly offered her.[cycling]"
"an"	"indulgence"	"[one of]For a woman to dream of indulgence, denotes that she will not escape unfavorable comment on her conduct.[cycling]"
"a"	"knitting"	"[one of]For a woman to dream of knitting, denotes that she will possess a quiet and peaceful home, where a loving companion and dutiful children delight to give pleasure.[or]For a man to be in a kniting-mill, indicates thrift and a solid rise in prospects.[or]For a young woman to dream of knitting, is an omen of a hasty but propitious marriage.[or]For a young woman to dream that she works in a knitting-mill, denotes that she will have a worthy and loyal lover.[or]To see the mill in which she works dilapidated, she will meet with reverses in fortune and love.[cycling]"
"a"	"mendicant"	"[one of]For a woman to dream of mendicants, she will meet with disagreeable interferences in her plans for betterment and enjoyment.[cycling]"
"a"	"china"	"[one of]For a woman to dream of painting or arranging her china, foretells she will have a pleasant home and be a thrifty and economical matron.[cycling]"
"a"	"plate"	"[one of]For a woman to dream of plates, denotes that she will practise economy and win a worthy husband.[or]If already married, she will retain her husband's love and respect by the wise ordering of his household.[cycling]"
"a"	"meat"	"[one of]For a woman to dream of raw meat, denotes that she will meet with much discouragement in accomplishing her aims.[or]If she sees cooked meat, it denotes that others will obtain the object for which she will strive.[cycling]"
"a"	"necklace"	"[one of]For a woman to dream of receiving a necklace, omens for her a loving husband and a beautiful home.[or]To lose a necklace, she will early feel the heavy hand of bereavement.[cycling]"
"a"	"horse"	"[one of]For a woman to dream of riding a horse, it indicates a rise above her present station.[or]To eat horseradish, you will be the object of pleasant raillery.[cycling]"
"a"	"sea foam"	"[one of]For a woman to dream of sea foam, foretells that indiscriminate and demoralizing pleasures will distract her from the paths of rectitude.[or]If she wears a bridal veil of sea foam, she will engulf herself in material pleasure to the exclusion of true refinement and innate modesty.[or]She will be likely to cause sorrow to some of those dear to her, through their inability to gratify her ambition.[cycling]"
"a"	"cap"	"[one of]For a woman to dream of seeing a cap, she will be invited to take part in some festivity.[or]For a girl to dream that she sees her sweetheart with a cap on, denotes that she will be bashful and shy in his presence.[or]To see a prisoner's cap, denotes that your courage is failing you in time of danger.[or]To see a miner's cap, you will inherit a substantial competency.[cycling]"
"a"	"lame"	"[one of]For a woman to dream of seeing any one lame, foretells that her pleasures and hopes will be unfruitful and disappointing.[cycling]"
"a"	"folly"	"[one of]For a woman to dream she is become foolish, and is publicly guilty of folly, is a sign she will have a boy, who in time will grow great.[or]If a maid, she will be speedily married, and that to an honest man.[cycling]"
"an"	"old man"	"[one of]For a woman to dream she is courted by an old man, is a sure prognostic that she will receive a sum of money and be successful in her undertakings.[or]For a maid to dream of it, shows that she will marry a rich young fellow, and have many children by him, who will all become rich.[cycling]"
"an"	"oven"	"[one of]For a woman to dream that her baking oven is red hot, denotes that she will be loved by her own family and friends, for her sweet and unselfish nature.[or]If she is baking, temporary disappointments await her.[or]If the oven is broken, she will undergo many vexations from children and servants.[cycling]"
"an"	"abortion"	"[one of]For a woman to dream that she assents to abortion being committed on her, is a warning that she is contemplating some enterprise which if carried out will steep her in disgrace and unhappiness.[or]For a doctor to dream that he is a party to an abortion, foretells that his practice will suffer from his inattention to duty, which will cause much trouble.[cycling]"
"a"	"lodger"	"[one of]For a woman to dream that she has lodgers, foretells she will be burdened with unpleasant secrets.[or]If one goes away without paying his bills, she will have unexpected trouble with men.[or]For one to pay his bill, omens favor and accumulation of money.[cycling]"
"a"	"blindfold"	"[one of]For a woman to dream that she is blindfolded, means that disturbing elements are rising around to distress and trouble her.[or]Disappointment will be felt by others through her.[cycling]"
"a"	"coca-cola"	"[one of]For a woman to dream that she is drinking coca-cola signifies that she will lose health and a chance for marrying a wealthy man by her abandonment to material delights.[cycling]"
"an"	"exile"	"[one of]For a woman to dream that she is exiled, denotes that she will have to make a journey which will interfere with some engagement or pleasure.[cycling]"
"a"	"pregnancy"	"[one of]For a woman to dream that she is pregnant when she is not is a sign of some special good fortune; she will either have a handsome present or else her husband will be lucky in some business transaction and give her a part of the money: if a girl dreams this it foretells that she will get married about as sudden as if the dream were a reality.[cycling]"
"a"	"pregnancy"	"[one of]For a woman to dream that she is pregnant, denotes she will be unhappy with her husband, and her children will be unattractive.[or]For a virgin, this dream omens scandal and adversity.[or]If a woman is really pregnant and has this dream, it prognosticates a safe delivery and swift recovery of strength.[cycling]"
"a"	"marriage"	"[one of]For a woman to dream that she marries an old, decrepit man, wrinkled face and gray headed, denotes she will have a vast amount of trouble and sickness to encounter.[or]If, while the ceremony is in progress, her lover passes, wearing black and looking at her in a reproachful way, she will be driven to desperation by the coldness and lack of sympathy of a friend.[or]To dream of seeing a marriage, denotes high enjoyment, if the wedding guests attend in pleasing colors and are happy; if they are dressed in black or other somber hues, there will be mourning and sorrow in store for the dreamer.[or]If you dream of contracting a marriage, you will have unpleasant news from the absent.[or]If you are an attendant at a wedding, you will experience much pleasure from the thoughtfulness of loved ones, and business affairs will be unusually promising.[or]To dream of any unfortunate occurrence in connection with a marriage, foretells distress, sickness, or death in your family.[or]For a young woman to dream that she is a bride, and unhappy or indifferent, foretells disappointments in love, and probably her own sickness.[or]She should be careful of her conduct, as enemies are near her.[cycling]"
"a"	"manslaughter"	"[one of]For a woman to dream that she sees, or is in any way connected with, manslaughter, denotes that she will be desperately scared lest her name be coupled with some scandalous sensation.[cycling]"
"an"	"elopement"	"[one of]For a young girl to dream she elopes with her beau is a sign her parents will give their consent and she will soon be married to the one she loves.[or]If a man dreams that he elopes with his sweetheart it portends that he will be 'cut out' by a stranger.[cycling]"
"a"	"pretty girl"	"[one of]For a young man to dream of admiring a pretty girl is a sign he will marry a simpleton: if a girl dreams she has a nice and pretty-looking lover she will be apt to take up with a putty-head.[or]Here is an ancient rhyming prediction:.[cycling]"
"a"	"prostitute"	"[one of]For a young man to dream of associating with prostitutes is a sign of poverty and disgrace: if he dreams of seeing these girls anywhere it foretells misfortune or bad luck: for a girl to dream of them is a sign that her chastity is in danger.[cycling]"
"a"	"picnic"	"[one of]For a young man to dream of going with a pic-nic party into the woods is a sign that some silly girl will fall in love with him: if a young girl dreams this some vain fellow will probably pay her attentions and compliments merely to gratify his own vanity.[cycling]"
"a"	"theatre"	"[one of]For a young man to dream of taking his sweetheart to the theatre is a sign that she will favor a new beau: if he dreams of going to the theatre alone and seeing his lady-love among the audience it shows that she has already seen and spoken to a gentleman that she likes better than him: if a lady dreams this of her beau the omen is similar.[cycling]"
"a"	"bath"	"[one of]For a young person to dream of taking a bath, means much solicitude for one of the opposite sex, fearing to lose his good opinion through the influence of others.[or]For a pregnant woman to dream this, denotes miscarriage or accident.[or]For a man, adultery.[or]Dealings of all kinds should be carried on with discretion after this dream.[or]To go in bathing with others, evil companions should be avoided.[or]Defamation of character is likely to follow.[or]If the water is muddy, evil, indeed death, and enemies are near you.[or]For a widow to dream of her bath, she has forgotten her former ties, and is hurrying on to earthly loves.[or]Girls should shun male companions.[or]Men will engage in intrigues of salacious character.[or]A warm bath is generally significant of evil.[or]A cold, clear bath is the fore-runner of joyful tidings and a long period of excellent health.[or]Bathing in a clear sea, denotes expansion of business and satisfying research after knowledge.[cycling]"
"a"	"physician"	"[one of]For a young woman to dream of a physician, denotes that she is sacrificing her beauty in engaging in frivolous pastimes.[or]If she is sick and thus dreams, she will have sickness or worry, but will soon overcome them, unless the physician appears very anxious, and then her trials may increase, ending in loss and sorrow.[cycling]"
"an"	"aroma"	"[one of]For a young woman to dream of a sweet aroma, denotes she will soon be the recipient of some pleasure or present.[cycling]"
"an"	"alms-house"	"[one of]For a young woman to dream of an alms-house, denotes she will meet failure in her efforts to contract a worldly marriage.[cycling]"
"a"	"basin"	"[one of]For a young woman to dream of bathing in a basin, foretells her womanly graces will win her real friendships and elevations.[cycling]"
"a"	"seducer"	"[one of]For a young woman to dream of being seduced, foretells that she will be easily influenced by showy persons.[or]For a man to dream that he has seduced a girl, is a warning for him to be on his guard, as there are those who will falsely accuse him.[or]If his sweetheart appears shocked or angry under these proposals, he will find that the woman he loves is above reproach.[or]If she consents, he is being used for her pecuniary pleasures.[cycling]"
"a"	"mountain"	"[one of]For a young woman to dream of crossing a mountain in company with her cousin and dead brother, who was smiling, denotes she will have a distinctive change in her life for the better, but there are warnings against allurements and deceitfulness of friends.[or]If she becomes exhausted and refuses to go further, she will be slightly disappointed in not gaining quite so exalted a position as was hoped for by her.[or]If you ascend a mountain in your dreams, and the way is pleasant and verdant, you will rise swiftly to wealth and prominence.[or]If the mountain is rugged, and you fail to reach the top, you may expect reverses in your life, and should strive to overcome all weakness in your nature.[or]To awaken when you are at a dangerous point in ascending, denotes that you will find affairs taking a flattering turn when they appear gloomy.[cycling]"
"a"	"plain"	"[one of]For a young woman to dream of crossing a plain, denotes that she will be fortunately situated, if the grasses are green and luxuriant; if they are arid, or the grass is dead, she will have much discomfort and loneliness.[cycling]"
"a"	"forsaking"	"[one of]For a young woman to dream of forsaking her home or friend, denotes that she will have troubles in love, as her estimate of her lover will decrease with acquaintance and association.[or]Abandoned and.[cycling]"
"an"	"ideal"	"[one of]For a young woman to dream of meeting her ideal, foretells a season of uninterrupted pleasure and contentment.[or]For a bachelor to dream of meeting his ideal, denotes he will soon experience a favorable change in his affairs.[cycling]"
"a"	"palmistry"	"[one of]For a young woman to dream of palmistry, foretells she will be the object of suspicion.[or]If she has her palms read, she will have many friends of the opposite sex, but her own sex will condemn her.[or]If she reads others' hands, she will gain distinction by her intelligent bearing.[or]If a minister's hand, she will need friends, even in her elevation.[cycling]"
"an"	"aunt"	"[one of]For a young woman to dream of seeing her aunt, denotes she will receive sharp censure for some action, which will cause her much distress.[or]If this relative appears smiling and happy, slight difference will soon give way to pleasure.[cycling]"
"a"	"bosom"	"[one of]For a young woman to dream that her bosom is wounded, foretells that some affliction is threatening her.[or]To see it soiled or shrunken, she will have a great disappointment in love and many rivals will vex her.[or]If it is white and full she is soon to be possessed of fortune.[or]If her lover is slyly observing it through her sheer corsage, she is about to come under the soft persuasive influence of a too ardent wooer.[cycling]"
"a"	"wreath"	"[one of]For a young woman to dream that her head is adorned with the bridal wreath, is an indication that death will shortly visit either herself or some one dear to her.[cycling]"
"a"	"play"	"[one of]For a young woman to dream that she attends a play, foretells that she will be courted by a genial friend, and will marry to further her prospects and pleasure seeking.[or]If there is trouble in getting to and from the play, or discordant and hideous scenes, she will be confronted with many displeasing surprises.[cycling]"
"a"	"bride"	"[one of]For a young woman to dream that she is a bride, foretells that she will shortly come into an inheritance which will please her exceedingly, if she is pleased in making her bridal toilet.[or]If displeasure is felt she will suffer disappointments in her anticipations.[or]To dream that you kiss a bride, denotes a happy reconciliation between friends.[or]For a bride to kiss others, foretells for you many friends and pleasures; to kiss you, denotes you will enjoy health and find that your sweetheart will inherit unexpected fortune.[or]To kiss a bride and find that she looks careworn and ill, denotes you will be displeased with your success and the action of your friends.[or]If a bride dreams that she is indifferent to her husband, it foretells that many unhappy circumstances will pollute her pleasures.[cycling]"
"a"	"lake"	"[one of]For a young woman to dream that she is alone on a turbulent and muddy lake, foretells many vicissitudes are approaching her, and she will regret former extravagances, and disregard of virtuous teaching.[or]If the water gets into the boat, but by intense struggling she reaches the boat-house safely, it denotes she will be under wrong persuasion, but will eventually overcome it, and rise to honor and distinction.[or]It may predict the illness of some one near her.[or]If she sees a young couple in the same position as herself, who succeed in rescuing themselves, she will find that some friend has committed indiscretions, but will succeed in reinstating himself in her favor.[or]To dream of sailing on a clear and smooth lake, with happy and congenial companions, you will have much happiness, and wealth will meet your demands.[or]A muddy lake, surrounded with bleak rocks and bare trees, denotes unhappy terminations to business and affection.[or]A muddy lake, surrounded by green trees, portends that the moral in your nature will fortify itself against passionate desires, and overcoming the same will direct your energy into a safe and remunerative channel.[or]If the lake be clear and surrounded by barrenness, a profitable existence will be marred by immoral and passionate dissipation.[or]To see yourself reflected in a clear lake, denotes coming joys and many ardent friends.[or]To see foliaged trees reflected in the lake, you will enjoy to a satiety.[or]Love's draught of passion and happiness.[or]To see slimy and uncanny inhabitants of the lake rise up and menace you, denotes failure and ill health from squandering time, energy and health on illicit pleasures.[or]You will drain the utmost drop of happiness, and drink deeply of Remorse's bitter concoction.[cycling]"
"a"	"lawyer"	"[one of]For a young woman to dream that she is connected in any way with a lawyer, foretells that she will unwittingly commit indiscretions, which will subject her to unfavorable and mortifying criticism.[cycling]"
"a"	"siege"	"[one of]For a young woman to dream that she is in a siege, and sees cavalry around her, denotes that she will have serious drawbacks to enjoyments, but will surmount them finally, and receive much pleasure and profit from seeming disappointments.[cycling]"
"a"	"plank"	"[one of]For a young woman to dream that she is walking across muddy water on a rotten plank, denotes that she will feel keenly the indifference shown her by one she loves, or other troubles may arise; or her defence of honor may be in danger of collapse.[or]Walking a good, sound plank, is a good omen, but a person will have to be unusually careful in conduct after such a dream.[cycling]"
"a"	"hood"	"[one of]For a young woman to dream that she is wearing a hood, is a sign she will attempt to allure some man from rectitude and bounden duty.[cycling]"
"an"	"opulence"	"[one of]For a young woman to dream that she lives in fairy like opulence, denotes that she will be deceived, and will live for a time in luxurious ease and splendor, to find later that she is mated with shame and poverty.[or]When young women dream that they are enjoying solid and real wealth and comforts, they will always wake to find some real pleasure, but when abnormal or fairy-like dreams of luxury and joy seem to encompass them, their waking moments will be filled with disappointments; as the dreams are warnings, superinduced by their practicality being supplanted by their excitable imagination and lazy desires, which should be overcome with energy, and the replacing of practicality on her base.[or]No young woman should fill her mind with idle day dreams, but energetically strive to carry forward noble ideals and thoughts, and promising and helpful dreams will come to her while she restores physical energies in sleep.[cycling]"
"a"	"revolver"	"[one of]For a young woman to dream that she sees her sweetheart with a revolver, denotes that she will have a serious disagreement with some friend, and probably separation from her lover.[or]Firearms, etc.[cycling]"
"a"	"cooling board"	"[one of]For a young woman to see a cooling board in her dreams, foretells sickness and quarrels with her lover.[or]To dream of some living person as dead and rising up from a cooling board, denotes she will be indirectly connected with that person in some trouble, but will find out that things will work out satisfactorily.[or]To see her brother, who has long since been dead, rising from a cooling board, warns her of complications which may be averted if she puts forth the proper will and energy in struggling against them.[cycling]"
"a"	"prize fighter"	"[one of]For a young woman to see a prize fighter, foretells she will have pleasure in fast society, and will give her friends much concern about her reputation.[cycling]"
"an"	"author"	"[one of]For an author to dream that his manuscript has been rejected by the publisher, denotes some doubt at first, but finally his work will be accepted as authentic and original.[or]To dream of seeing an author over his work, perusing it with anxiety, denotes that you will be worried over some literary work either of your own or that of some other person.[cycling]"
"an"	"ignominy"	"[one of]For any one to dream they suffer ignominy, shows he will be unjustly accused of having done wrong, and that he will, after a little, take a sudden rise in the world.[cycling]"
"a"	"quiver"	"[one of]For either sex, if unmarried, to dream of a quiver, is prognostic of success in love; but to the married, it is a token of uneasiness to the dreamer.[cycling]"
"a"	"devil"	"[one of]For farmers to dream of the devil, denotes blasted crops and death among stock, also family sickness.[or]Sporting people should heed this dream as a warning to be careful of their affairs, as they are likely to venture beyond the laws of their.[or]For a preacher, this dream is undeniable proof that he is over-zealous, and should forebear worshiping.[or]God by tongue-lashing his neighbor.[or]To dream of the devil as being a large, imposingly dressed person, wearing many sparkling jewels on his body and hands, trying to persuade you to enter his abode, warns you that unscrupulous persons are seeking your ruin by the most ingenious flattery.[or]Young and innocent women, should seek the stronghold of friends after this dream, and avoid strange attentions, especially from married men.[or]Women of low character, are likely to be robbed of jewels and money by seeming strangers.[or]Beware of associating with the devil, even in dreams.[or]He is always the forerunner of despair.[or]If you dream of being pursued by his majesty, you will fall into snares set for you by enemies in the guise of friends.[or]To a lover, this denotes that he will be won away from his allegiance by a wanton.[cycling]"
"a"	"balcony"	"[one of]For lovers to dream of making sad adieus on a balcony, long and perhaps final separation may follow.[or]Balcony also denotes unpleasant news of absent friends.[cycling]"
"an"	"eclipse"	"[one of]For one to dream he sees the sun in eclipse signifies the loss of his father; if he sees the moon eclipsed it denotes the death of his mother; but if he has neither father nor mother then it denotes the death of a relation.[cycling]"
"a"	"musician"	"[one of]For one to dream of being a musician, who understands nothing of the art of music, is an indication that the dreamer will have peace and comfort in the domestic state.[cycling]"
"a"	"jug"	"[one of]For one to dream of drinking out of a jug, is a sure sign of going on a journey.[or]If the jug be large, the journey will be long; if small, the journey will be short; and so, if the liquid drank be pleasant, so will the journey, and if unpleasant, the journey will be full of troubles.[cycling]"
"an"	"iron"	"[one of]For one to dream that he is hurt with iron signifies that he shall receive some damage.[cycling]"
"an"	"iron"	"[one of]For one to dream that he is hurt with iron, signifies that he shall receive some damage.[or]To dream that one trades with a stranger in iron, signifies losses and misfortune.[cycling]"
"a"	"wig"	"[one of]For one who has no lack of hair to dream that he wears a wig, signifies that he will be compelled to stand before a judge in a court of law, either as a criminal or as a witness.[cycling]"
"a"	"peacock"	"[one of]For persons dreaming of peacocks, there lies below the brilliant and flashing ebb and flow of the stream of pleasure and riches, the slums of sorrow and failure, which threaten to mix with its clearness at the least disturbing influence.[or]For a woman to dream that she owns peacocks, denotes that she will be deceived in her estimate of man's honor.[or]To hear their harsh voices while looking upon their proudly spread plumage, denotes that some beautiful and well-appearing person will work you discomfort and uneasiness of mind.[cycling]"
"a"	"bell-man"	"[one of]Fortune is hurrying after you.[or]Questions of importance will be settled amicably among disputants.[or]To see him looking sad some sorrowful event or misfortune may soon follow.[cycling]"
"a"	"grain"	"[one of]Grain is a most fortunate dream, betokening wealth and happiness.[or]For a young woman, it is a dream of fortune.[or]She will meet wealthy and adoring companions.[cycling]"
"a"	"lantern"	"[one of]He that dreams he sees a lantern with a light in it, extinguished, that signifies unto him sadness, sickness and poverty.[cycling]"
"a"	"cymbal"	"[one of]Hearing a cymbal in your dreams, foretells the death of a very aged person of your acquaintance.[or]The sun will shine, but you will see it darkly because of gloom.[cycling]"
"a"	"bray"	"[one of]Hearing an ass bray, is significant of unwelcome tidings or intrusions.[cycling]"
"an"	"idiot"	"[one of]Idiots in a dream, foretells disagreements and losses.[or]To dream that you are an idiot, you will feel humiliated and downcast over the miscarriage of plans.[or]To see idiotic children, denotes affliction and unhappy changes in life.[cycling]"
"a"	"reprieve"	"[one of]If a criminal under sentence of death dream of a reprieve or pardon he may make up his mind that it is all over with him; and if any friend who is interested in his fate dreams this it amounts to about the same thing.[cycling]"
"a"	"famine"	"[one of]If a farmer dreams that his crops have failed or of any scarcity of food it shows that there will be a quarrel which though it may not be among his people yet he will witness or hear about it and it will worry him.[cycling]"
"a"	"gondola"	"[one of]If a female dreams she is sailing in a gondola, she will speedily marry a person who will make her happy.[or]If a man dream he is in a gondola, in smooth water, it is an excellent dream; but if the water be muddy or troubled, it denotes much strife.[cycling]"
"a"	"jockey"	"[one of]If a female dreams she sees a jockey riding at full speed, she will have an offer of marriage made her very unexpectedly.[or]For a man to dream he rides with, or sees a jockey riding at a race, denotes a sudden good turn in his affairs.[cycling]"
"a"	"rape"	"[one of]If a female it is a sign that some one of the opposite sex is in love with her: if she is married the dream alludes to some man other than her husband.[or]Such dreams bode no good.[cycling]"
"a"	"shawl"	"[one of]If a girl dreams of getting a new shawl it foretells that she will soon have a new beau who will be very attentive and affable.[cycling]"
"a"	"rooster"	"[one of]If a girl dreams of hearing a cock crow it foretells that she will soon have a new lover; if a lover dreams this it is a sign that he has a formidable rival: if a married man or woman dreams of roosters it shows that some outsider is enamored of the wife.[cycling]"
"a"	"doll"	"[one of]If a girl dreams she has a new doll with which she is greatly pleased it foretells a disappointment.[cycling]"
"a"	"peti"	"[one of]If a girl dreams she has a pet animal of any kind it is a sign she will never marry: if she dreams of a pet child or one whom she adores it foretells for her a prolific marriage.[cycling]"
"a"	"thumb"	"[one of]If a girl dreams that her beau hurts her by pinching her thumb it is a sign that if she marries him she will have to get her own living and help to support him besides: for a man to dream of losing his thumb or of an injury to it foretells poverty—on the contrary to dream of a big thumb denotes much wealth.[cycling]"
"a"	"wrist"	"[one of]If a girl dreams that her wrist is large or mis-shapen it foretells that she will come to poverty after marriage; if she imagines that there is a tumor or swelling or even a wart on it it is a sign that she will be dependent on some one for her bread and that person may or may not be her husband.[cycling]"
"a"	"smock"	"[one of]If a girl dreams that she has a ragged undergarment it foretells that some rich greenhorn will try to seduce her and failing will offer her marriage: if she dreams that she has a good supply of beautiful worked undergarments it is a sign that she will sigh in vain for a lover; if she imagines that a gentleman gives her a new smock she will be in danger of losing her chastity.[cycling]"
"a"	"tailor"	"[one of]If a girl dreams that she has a tailor for her beau and is pleased with him it is a sign that she will marry a softly sort of a fellow who will allow her to be both master and mistress after marriage.[or]Here is a popular rhyme in illustration:.[cycling]"
"a"	"widow"	"[one of]If a girl dreams that she is a widow it foretells that she will have many lovers: such a dream to a married woman denotes that some man beside her husband is in love with her.[cycling]"
"an"	"impertinence"	"[one of]If a girl dreams that she meets a gentleman who is impertinent toward her in conversation it is a sign she will make a new male acquaintance who will be very agreeable to her: if she gets angry at the said impertinence she will probably fall in love with her new friend and either marry him or be on improper intimate terms with him.[cycling]"
"a"	"tongue"	"[one of]If a lady dreams of having a sore on her tongue it is a sign that she has uttered a slander.[cycling]"
"a"	"velvet"	"[one of]If a lady dreams of new velvet dresses it foretells poverty: velvet cushions slippers or bonnets are signs of waste and want.[cycling]"
"a"	"prick"	"[one of]If a lady dreams of pricking her finger while sewing she must put it in her mouth on awaking and make a wish and she will realize it within one month provided it relates to love matters: a wish of any other kind will doubtless come true some time or other as the omen is an excellent one: if a lady dreams she pricks herself with a pin the omen is not so good (_See.[or]Pin and.[cycling]"
"a"	"giant"	"[one of]If a lady dreams of seeing a very large man or giant and if she is pleased with his appearance it shows that her future husband will be a small fellow or else a man of small intellect: if she is disgusted with the giant it is a sign that she will marry such a man herself or else a man of great mind.[or]For married people to dream of giants shows a prospect of smart children.[cycling]"
"a"	"boy"	"[one of]If a lady dreams that she is delivered of a boy her life will be a pleasant one.[cycling]"
"a"	"fan"	"[one of]If a maiden dreams she has been fanned by a man, she will soon make a new conquest, or marry the present object of her affections.[or]For a man to dream he is fanning a person, signifies that he will soon meet with many changes in his affairs.[cycling]"
"a"	"pole-cat"	"[one of]If a man dream he sees one he will marry a beautiful woman; if a woman she will marry a handsome man.[or]If this delightful animal make an attack on you it is a sign you will suffer from the slander of enemies.[cycling]"
"a"	"farm"	"[one of]If a man dreams he has a good farm well enclosed with pleasant pastures bestowed upon him he will have a handsome wife; but if the land seems spacious and not enclosed that denotes pleasure joy and riches.[or]To dream you are working on a farm denotes you will soon receive a legacy from a distant relative.[cycling]"
"a"	"polecat"	"[one of]If a man dreams he has a polecat, he shall have some ill natured woman.[cycling]"
"a"	"land"	"[one of]If a man dreams he hath good lands well enclosed with pleasant pastures, bestowed upon him, he will have a handsome wife.[or]But if the land seems spacious and not enclosed, that denotes pleasure, joy and riches.[or]If he dreams that the said unenclosed lands have fair gardens and fountains, fields, pleasant groves and orchards adjoining thereto, that signifies that he will marry a discreet, chaste and beautiful wife, and that she will bear him handsome children.[or]If he dreams the land is sown with wheat, that signifies money and profit, with care and industry.[or]But if he dreams it is sown with any kind of pulse, that denotes affliction and trouble.[cycling]"
"a"	"jail"	"[one of]If a man dreams he is confined in a prison or jail it shows that he will have honors or dignities conferred upon him as such dreams go contrariwise: if his arrest and imprisonment worries him it only shows that he will be the more delighted with his new dignities.[cycling]"
"a"	"jury"	"[one of]If a man dreams he is serving on a jury it is a sign some friend will ask a favor of him that he will hesitate to grant.[cycling]"
"a"	"wife"	"[one of]If a man dreams he sees his wife married to another, it denotes change of affairs or condition.[or]If a woman dreams she is married to another man, it is the same.[cycling]"
"an"	"ear"	"[one of]If a man dreams his ears be fair and well shaped, it shows he shall come to great renown; but if he dreams his ears are ill-favored and deformed, it shows the contrary.[or]This dream is ill to a servant, and those who have a lawsuit, if he be a plaintiff or the defendant, but it is good to an artificer or one that worketh with his hands, for he shall have many that will employ him.[or]To dream that one picks or cleans his ears, betokens that good news shall come forth one side or other.[or]But to dream that the ears have been beaten or chafed, signifies we shall hear ill news.[or]If any one dreams his ear is hurt or split, he will be offended by some one that belongs to him, or by some friend.[or]If he dream that his ear is quite off, he shall be utterly deprived of their friendship.[cycling]"
"a"	"whore"	"[one of]If a man dreams of associating with one of this class of women it foretells losses and disgrace: should a girl dream of playing the whore when in fact she is chaste it foretells her speedy marriage and that she will love her husband.[cycling]"
"a"	"virgin"	"[one of]If a man dreams that he defloured a virgin it is a sign that he will be disgraced by some act of his own: to dream of seeing the.[or]Mary foretells that great honors await you: such a dream to an honest business man promises him riches and honor; but to a dishonest one it foretells disaster.[cycling]"
"a"	"profit"	"[one of]If a man dreams that he made a large and liberal profit by any transaction or speculation it foretells losses and disaster.[cycling]"
"a"	"family"	"[one of]If a man or woman dreams that they have a large family it is a sign of thrift and riches.[or]Such a dream is a lucky one to anybody.[cycling]"
"a"	"suckle"	"[one of]If a married woman dreams of suckling a child it foretells that she will soon give birth to another; should a bachelor dream of seeing a child suckled he had better make up his mind that he will soon have a young lady’s board to pay whether he marries or not; but as the latter would be the better course let him be looking round for a wife at once.[or]A married man who dreams this will soon become a happy father.[cycling]"
"a"	"mulatto"	"[one of]If a mulatto appears to you in a dream, beware of making new friendships or falling into associations with strange women, as you are threatened with loss of money and of high moral standing.[cycling]"
"a"	"rhubarb"	"[one of]If a person dreams that he handles good rhubarb, he will be taken into favor with those he was not on good terms with before; but to dream of the dried.[or]Turkey rhubarb, denotes sickness.[cycling]"
"a"	"resign"	"[one of]If a person who holds an office or a trust of any kind dreams of resigning it is a sign of advancement: to any one who cannot be advanced it shows that he will rise above his present position in society.[cycling]"
"a"	"reptile"	"[one of]If a reptile attacks you in a dream, there will be trouble of a serious nature ahead for you.[or]If you succeed in killing it, you will finally overcome obstacles.[or]To see a dead reptile come to life, denotes that disputes and disagreements, which were thought to be settled, will be renewed and pushed with bitter animosity.[or]To handle them without harm to yourself, foretells that you will be oppressed by the ill humor and bitterness of friends, but you will succeed in restoring pleasant relations.[or]For a young woman to see various kinds of reptiles, she will have many conflicting troubles.[or]Her lover will develop fancies for others.[or]If she is bitten by any of them, she will be superseded by a rival.[cycling]"
"a"	"tripe"	"[one of]If a woman dreams of cleaning tripe it foretells that she will either be untrue to her husband or an outrage will be perpetrated upon her: to dream of eating tripe is about as bad for it shows to a man that he will be engaged in some affair with a female which will bring him to disgrace.[cycling]"
"an"	"embroidery"	"[one of]If a woman dreams of embroidering, she will be admired for her tact and ability to make the best of everything that comes her way.[or]For a married man to see embroidery, signifies a new member in his household,.[or]For a lover, this denotes a wise and economical wife.[cycling]"
"a"	"stillborn"	"[one of]If a woman dreams that she gives birth to a stillborn child it foretells that her next child will be an uncommon bright one: a childless woman who dreams this will realize her fondest hopes.[cycling]"
"a"	"hair"	"[one of]If a woman dreams that she has beautiful hair and combs it, she will be careless in her personal affairs, and will lose advancement by neglecting mental application.[or]For a man to dream that he is thinning his hair, foreshadows that he will become poor by his generosity, and suffer illness through mental worry.[or]To see your hair turning gray, foretells death and contagion in the family of some relative or some friend.[or]To see yourself covered with hair, omens indulgence in vices to such an extent as will debar you from the society of refined people.[or]If a woman, she will resolve herself into a world of her own, claiming the right to act for her own pleasure regardless of moral codes.[or]If a man dreams that he has black, curling hair, he will deceive people through his pleasing address.[or]He will very likely deceive the women who trust him.[or]If a woman's hair seems black and curly, she will be threatened with seduction.[or]If you dream of seeing a woman with golden hair, you will prove a fearless lover and be woman's true friend.[cycling]"
"a"	"separation"	"[one of]If a woman dreams that she is about to live separate from her husband it promises that she will shortly find herself in the family way: such a dream to a man is a sign that some woman or girl other than his wife is in love with him.[cycling]"
"a"	"buffalo"	"[one of]If a woman dreams that she kills a lot of buffaloes, she will undertake a stupendous enterprise, but by enforcing will power and leaving off material pleasures, she will win commendation from men, and may receive long wished for favors.[or]Buffalo, seen in a dream, augurs obstinate and powerful but stupid enemies.[or]They will boldly declare against you but by diplomacy you will escape much misfortune.[cycling]"
"a"	"neck"	"[one of]If a woman or girl dreams that her neck is large and thick it is a sure sign she will bear many children: if it seems smaller than usual it denotes to a married woman a miscarriage and to a girl the loss of her beau: if a woman dreams that her neck is fair and beautiful it foretells that some gentleman will make love to her.[cycling]"
"a"	"hug"	"[one of]If a young girl dreams of being fondled and hugged by her lover it is a sign he will soon get sick of her and want to be off: it is not half so bad to let him hug her in real earnest as it is to dream of it.[or]The same sign holds good with the other sex.[cycling]"
"a"	"secret"	"[one of]If a young girl dreams that a friend has intrusted her with an important secret it is a sign that the friend will become her enemy: if her lover tells her a secret they will surely quarrel within a week; if she dreams of disclosing a secret to a friend she will be much vexed at some scandal that is afloat respecting her.[cycling]"
"an"	"umbrella"	"[one of]If a young girl dreams that she has got a new umbrella it foretells a new lover: if a married woman dreams this it is a sign that some other gentleman besides her husband is enamored of her.[or]A man who dreams of buying an umbrella will have a narrow escape from threatened danger.[cycling]"
"a"	"yeast"	"[one of]If a young housewife dreams that she is kneading bread with yeast, she may conclude that she will be the mother of a large family of children.[cycling]"
"a"	"tall"	"[one of]If a young lady dreams that her beau is a very tall man it is a sign that her future husband will be a 'wee bit of a fellow.' and not of much account.[cycling]"
"a"	"well"	"[one of]If a young man dreams that he draws water out of a well, it signifies a speedy marriage to a fair maid, who will bring him a portion.[or]If the water be troubled, he will be disturbed by her, and suddenly fall sick.[or]If he seems to give to others clear well water to drink, it denotes that he will enrich them.[or]But if the water be troubled, he will afflict them.[or]If he dreams that he sees a person fall into a well, it signifies that the person dreamed of shall die quickly.[cycling]"
"a"	"parasol"	"[one of]If a young woman dreams she has got a new parasol it predicts for her a new lover: if she imagines she has broken her parasol her lover will leave her; if not then some male friend in whom she placed confidence or derived advantage will fail her: to a married woman dreaming of a broken parasol is a very bad omen as it predicts ruin to her husband.[cycling]"
"a"	"locket"	"[one of]If a young woman dreams that her lover places a locket around her neck, she will be the recipient of many beautiful offerings, and will soon be wedded, and lovely children will crown her life.[or]If she should lose a locket, death will throw sadness into her life.[or]If a lover dreams that his sweetheart returns his locket, he will confront disappointing issues.[or]The woman he loves will worry him and conduct herself in a displeasing way toward him.[or]If a woman dreams that she breaks a locket, she will have a changeable and unstable husband, who will dislike constancy in any form, be it business or affection,.[cycling]"
"a"	"seducer"	"[one of]If a young woman dreams that her lover’s conduct is that of a gay seducer she will find him to be very sincere in his attachment: a married woman who dreams that she is over-persuaded by a seducer to yield to his desires will come to much honor as such dreams work contrariwise.[or]If a man dreams of seducing a virtuous girl it foreshadows that he will be disgraced.[cycling]"
"a"	"gain"	"[one of]If acquired justly you may hope for wealth; if by injustice you will lose your fortune.[cycling]"
"a"	"young"	"[one of]If an old or middle aged person dreams that they are young it foretells their death: for a young person to dream that he or she is a child the omen is similar; but to dream _of youths_ is a sign that you will live to a great age.[cycling]"
"an"	"infant"	"[one of]If an unmarried woman dreams of an infant, it prognosticates that she will go through some trouble, but for a man to dream of infants, is good.[cycling]"
"a"	"fortune"	"[one of]If any man become poor after he hath been rich, dreams he has the same land and possessions he had before, it signifies that his good fortune will return.[cycling]"
"a"	"thirst"	"[one of]If any one dream of thirst or of drinking water if the water appear clear and acceptable he will live joyfully and become wealthy; if the water be troubled warm or offensive it forewarns him that without prudence he will end his days in affliction.[cycling]"
"a"	"plague"	"[one of]If any one dreams he hath the plague, it signifies his hidden store will be discovered, and he will run the risk of losing it.[cycling]"
"an"	"idiot"	"[one of]If any one dreams he is turned idiot, or mad, and is guilty of public extravagancies, he shall be long-lived, a favorite, and gain pleasure and profit by the people.[cycling]"
"a"	"thirst"	"[one of]If any one dreams his thirst is quenched, and that he has drank his fill of water, if the water appeared clear and acceptable to him, he will live joyfully and become very wealthy; if the water be troubled, lukewarm, stinking or dirty, he will end his days in affliction.[cycling]"
"a"	"throat"	"[one of]If any one dreams his throat is cut, he will be injured by some person or other.[or]If he dreams he cuts the throat of another, he will do himself some great injury.[cycling]"
"a"	"murderer"	"[one of]If any one dreams of being a murderer be sure you will be slandered and calumniated by one who has been a professed friend and admirer previously.[cycling]"
"a"	"mistake"	"[one of]If any one dreams of being vexed annoyed or injured by reason of making a mistake it shadows forth disgrace.[or]Mistaking one person for another in your dream denotes scandal: thus if a young girl should dream that she hailed a young man as her lover and found it was a stranger it shows that some malicious person will talk lightly of her character.[cycling]"
"a"	"pulpit"	"[one of]If any one dreams of going into a pulpit it is a sign he or she will visit a place of disrepute as such dreams work contrariwise: for a girl to dream that she assists in ornamenting or dressing a pulpit foretells that she will do some act that she afterwards regrets because of an unworthy person being connected therewith.[cycling]"
"a"	"marriage"	"[one of]If any one should be so unfortunate as to dream that he or she was present at a happy and jolly wedding it denotes that they will attend a funeral; it will not necessarily be at the burial of either of the persons you dreamed you saw married but you will undoubtedly be called to mourn some friend or relative.[or]To dream of being married yourself foretells your death.[cycling]"
"a"	"police"	"[one of]If any respectable person dreams of being arrested by police officers it is a sign that some distinguished honor will be conferred on him: if a young girl should dream that policemen took her lover into custody she will hear of his advancement in the world.[cycling]"
"a"	"warming-pan"	"[one of]If any single person dreams that his or her bed is warmed with one of these utensils it is a positive forerunner of their marriage: if a married woman dreams this it is a sign that she will go to bed with a strange bedfellow .[cycling]"
"a"	"poet"	"[one of]If any young person should be so silly as to dream of writing poetry it foretells poverty; and for one to dream of having a poetical lover or sweetheart is a sign that they will fall in love with a fool.[cycling]"
"a"	"flesh"	"[one of]If anyone dreams he is increased in flesh, he will gain wealth.[or]On the contrary, if he dreams he is grown lean and thin, if he be rich, he will grow poor, or at least conceal his wealth, and he will be in a mean condition.[or]To dream of eating all sorts of meat, whether flesh or fish, signifies either neglect of business, or anger and sickness.[cycling]"
"an"	"orchard"	"[one of]If in your dream you imagine you are in a fine orchard and the fruit looks fair and tempting and you eat of it it foretells that you will shortly be engaged in some pleasant adventure either of love or intrigue: if you see rotten wormy or scraggy-looking apples it shows that you will be thrown into mean and low company much to your disgrace.[or]Such dreams are bad ones for young girls.[cycling]"
"a"	"butcher"	"[one of]If in your dream you see a butcher killing any animal it is a sign of the death of a friend or near relative.[or]If a farmer dreams of seeing sheep killed he will probably have a prolific flock.[cycling]"
"a"	"fire"	"[one of]If in your dream you see a house on fire other than your own it foretells that some event will happen to make you melancholy and sorrowful such as the death or ruin of some esteemed friend.[or]If you dream your own house or place of business is burning it is an omen of good fortune.[or]If you dream of playing with fire it is a sign of a quarrel in bed.[or]For this dream play your age first.[cycling]"
"a"	"pawn-shop"	"[one of]If in your dreams you enter a pawn-shop, you will find disappointments and losses in your waking moments.[or]To pawn articles, you will have unpleasant scenes with your wife or sweetheart, and perhaps disappointments in business.[or]For a woman to go to a pawn-shop, denotes that she is guilty of indiscretions, and she is likely to regret the loss of a friend.[or]To redeem an article, denotes that you will regain lost positions.[or]To dream that you see a pawn-shop, denotes you are negligent of your trust and are in danger of sacrificing your honorable name in some salacious affair.[cycling]"
"an"	"indistinct"	"[one of]If in your dreams you see objects indistinctly, it portends unfaithfulness in friendships, and uncertain dealings.[cycling]"
"a"	"newspaper reporter"	"[one of]If in your dreams you unwillingly see them, you will be annoyed with small talk, and perhaps quarrels of a low character.[or]If you are a newspaper reporter in your dreams, there will be a varied course of travel offered you, though you may experience unpleasant situations, yet there will be some honor and gain attached.[cycling]"
"a"	"martyr"	"[one of]If one dreams he dies for religion, that man will arrive at great honor.[or]It signifies also that his soul will be happy hereafter.[cycling]"
"a"	"silver"	"[one of]If one dreams he gathers up silver, it signifies deceit and loss; to see silver eaten, denotes great advantage; to eat silver, signifies wrath and anger.[cycling]"
"a"	"lean"	"[one of]If one dreams he is grown lean and wasted, he will be disturbed and have suits at law, or some other ill business that will occasion the loss of his estate, or else he is in danger of falling sick.[or]Nevertheless, if a woman dreams the tongue grows less, it signifies unto her honors, wisdom, prudence and discretion.[cycling]"
"a"	"navigation"	"[one of]If one dreams that he is sailing in a boat and recreating himself without fear, he will have comfort and success in his affairs, but if the water be tempestuous, it falleth out contrarily.[or]To dream of being in a ship or boat, and in danger of oversetting or shipwreck, it is a sign of danger unless the party be a prisoner or captive, and in that case it denotes liberty and freedom.[cycling]"
"a"	"palm"	"[one of]If one dreams that he sees or smells the palm, it signifies prosperity.[or]If it be a woman that dreams so, she shall bear children.[or]If it be a maid, she will be suddenly married.[cycling]"
"a"	"beef"	"[one of]If raw and bloody, cancers and tumors of a malignant nature will attack the subject.[or]Be on your guard as to bruises and hurts of any kind.[or]To see, or eat cooked beef, anguish surpassing human aid is before you.[or]Loss of life by horrible means will occur.[or]Beef properly served under pleasing surroundings denotes harmonious states in love and business, if otherwise, evil is foreboded, though it may be of a trifling nature.[cycling]"
"a"	"dagger"	"[one of]If seen in a dream, denotes threatening enemies.[or]If you wrench the dagger from the hand of another, it denotes that you will be able to counteract the influence of your enemies and overcome misfortune.[cycling]"
"a"	"bail"	"[one of]If the dreamer is seeking bail, unforeseen troubles will arise; accidents are likely to occur; unfortunate alliances may be made.[or]If you go bail for another, about the same conditions, though hardly as bad.[cycling]"
"a"	"police"	"[one of]If the police are trying to arrest you for some crime of which you are innocent, it foretells that you will successfully outstrip rivalry.[or]If the arrest is just, you will have a season of unfortunate incidents.[or]To see police on parole, indicates alarming fluctuations in affairs.[cycling]"
"a"	"barn"	"[one of]If well filled with ripe and matured grain, and perfect ears of corn, with fat stock surrounding it, it is an omen of great prosperity.[or]If empty, the reverse may be expected.[cycling]"
"a"	"challenge"	"[one of]If you are challenged to fight a duel, you will become involved in a social difficulty wherein you will be compelled to make apologies or else lose friendships.[or]To accept a challenge of any character, denotes that you will bear many ills yourself in your endeavor to shield others from dishonor.[cycling]"
"a"	"pit"	"[one of]If you are looking into a deep pit in your dream, you will run silly risks in business ventures and will draw uneasiness about your wooing.[or]To fall into a pit denotes calamity and deep sorrow.[or]To wake as you begin to feel yourself falling into the pit, brings you out of distress in fairly good shape.[or]To dream that you are descending into one, signifies that you will knowingly risk health and fortune for greater success.[cycling]"
"an"	"assassin"	"[one of]If you are the one to receive the assassin's blow, you will not surmount all your trials.[or]To see another, with the assassin standing over him with blood stains, portends that misfortune will come to the dreamer.[or]To see an assassin under any condition is a warning that losses may befall you through secret enemies.[cycling]"
"a"	"dun"	"[one of]If you are troubled in your dreams by imagining that people are dunning you for money it is a sure sign you will get some unexpectedly.[cycling]"
"a"	"heaven"	"[one of]If you ascend to heaven in a dream, you will fail to enjoy the distinction you have labored to gain,, and joy will end in sadness.[or]If young persons dream of climbing to heaven on a ladder, they will rise from a low estate to one of unusual prominence, but will fail to find contentment or much pleasure.[or]To dream of being in heaven and meeting.[or]Christ and friends, you will meet with many losses, but will reconcile yourself to them through your true understanding of human nature.[or]To dream of the.[or]City, denotes a contented and spiritual nature, and trouble will do you small harm.[cycling]"
"a"	"crucifixion"	"[one of]If you chance to dream of the crucifixion, you will see your opportunities slip away, tearing your hopes from your grasp, and leaving you wailing over the frustration of desires.[cycling]"
"a"	"labyrinth"	"[one of]If you dream of a labyrinth, you will find yourself entangled in intricate and perplexing business conditions, and your wife will make the home environment intolerable; children and sweethearts will prove ill-tempered and unattractive.[or]If you are in a labyrinth of night or darkness, it foretells passing, but agonizing sickness and trouble.[or]A labyrinth of green vines and timbers, denotes unexpected happiness from what was seemingly a cause for loss and despair.[or]In a network, or labyrinth of railroads, assures you of long and tedious journeys.[or]Interesting people will be met, but no financial success will aid you on these journeys.[cycling]"
"a"	"letter-carrier"	"[one of]If you dream of a letter-carrier coming with your letters, you will soon receive news of an unwelcome and an unpleasant character.[or]To hear his whistle, denotes the unexpected arrival of a visitor.[or]If he passes without your mail, disappointment and sadness will befall you.[or]If you give him letters to mail, you will suffer injury through envy or jealousy.[or]To converse with a letter-carrier, you will implicate yourself in some scandalous proceedings.[cycling]"
"a"	"railroad"	"[one of]If you dream of a railroad, you will find that your business will need close attention, as enemies are trying to usurp you.[or]For a young woman to dream of railroads, she will make a journey to visit friends, and will enjoy some distinction.[or]To see an obstruction on these roads, indicates foul play in your affairs.[or]To walk the cross ties of a railroad, signifies a time of worry and laborious work.[or]To walk the rails, you may expect to obtain much happiness from your skilful manipulation of affairs.[or]To see a road inundated with clear water, foretells that pleasure will wipe out misfortune for a time, but it will rise, phoenix like, again.[cycling]"
"a"	"silkworm"	"[one of]If you dream of a silkworm, you will engage in a very profitable work, which will also place you in a prominent position.[or]To see them dead, or cutting through their cocoons, is a sign of reverses and trying times.[cycling]"
"a"	"gaol"	"[one of]If you dream of being confined in a gaol, you will be prevented from carrying forward some profitable work by the intervention of envious people; but if you escape from the gaol, you will enjoy a season of favorable business.[cycling]"
"a"	"fight"	"[one of]If you dream of being engaged in a fight it foretells to a man of business that he will soon engage in some new enterprise that will be successful; to a laboring man it predicts increased pay.[cycling]"
"an"	"idle"	"[one of]If you dream of being idle, you will fail to accomplish your designs.[or]To see your friends in idleness, you will hear of some trouble affecting them.[or]For a young woman to dream that she is leading an idle existence, she will fall into bad habits, and is likely to marry a shiftless man.[cycling]"
"a"	"hail"	"[one of]If you dream of being in a hail storm, you will meet poor success in any undertaking.[or]If you watch hail-stones fall through sunshine and rain, you will be harassed by cares for a time, but fortune will soon smile upon you.[or]For a young woman, this dream indicates love after many slights.[or]To hear hail beating the house, indicates distressing situations.[cycling]"
"a"	"heat"	"[one of]If you dream of being in a place that is extremely hot or if the weather is so hot that the heat affects you it shows that some person is preparing either to attack you or give you a good scolding.[cycling]"
"a"	"hell"	"[one of]If you dream of being in hell, you will fall into temptations, which will almost wreck you financially and morally.[or]To see your friends in hell, denotes distress and burdensome cares.[or]You will hear of the misfortune of some friend.[or]To dream of crying in hell, denotes the powerlessness of friends to extricate you from the snares of enemies.[cycling]"
"a"	"jury"	"[one of]If you dream of being tried by a jury, you will lose your sweetheart, and gain the affections of another on a voyage.[or]If you dream of being acquitted by a jury, you will shortly meet with interesting and romantic adventures.[cycling]"
"an"	"ink"	"[one of]If you dream of black ink, you will become involved in some disgraceful scheme.[or]If you dream of red ink, good news awaits you.[cycling]"
"a"	"watch"	"[one of]If you dream of buying a gold watch it is a sign of poverty; but if you imagine that you are presented with one it foretells good luck and money-getting: to dream of losing your gold watch is also a good omen as it denotes success in business.[cycling]"
"a"	"peddler"	"[one of]If you dream of buying things of a peddler it is a sign that some one will cheat you or that one of your debtors will mysteriously disappear which amounts to about the same thing: if a lady housekeeper dreams this let her look sharp that her servants do not rob or swindle her in some way.[cycling]"
"a"	"vote"	"[one of]If you dream of casting a vote on any measure, you will be engulfed in a commotion which will affect your community.[or]To vote fraudulently, foretells that your dishonesty will overcome your better inclinations.[cycling]"
"a"	"religion"	"[one of]If you dream of discussing religion and feel religiously inclined, you will find much to mar the calmness of your life, and business will turn a disagreeable front to you.[or]If a young woman imagines that she is over religious, she will disgust her lover with her efforts to act ingenuous innocence and goodness.[or]If she is irreligious and not a transgressor, it foretells that she will have that independent frankness and kind consideration for others, which wins for women profound respect, and love from the opposite sex as well as her own; but if she is a transgressor in the eyes of religion, she will find that there are moral laws, which, if disregarded, will place her outside the pale of honest recognition.[or]She should look well after her conduct.[or]If she weeps over religion, she will be disappointed in the desires of her heart.[or]If she is defiant, but innocent of offence, she will shoulder burdens bravely, and stand firm against deceitful admonitions.[or]If you are self-reproached in the midst of a religious excitement, you will find that you will be almost induced to give up your own personality to please some one whom you hold in reverent esteem.[or]To see religion declining in power, denotes that your life will be more in harmony with creation than formerly.[or]Your prejudices will not be so aggressive.[or]To dream that a minister in a social way tells you that he has given up his work, foretells that you will be the recipient of unexpected tidings of a favorable nature, but if in a professional and warning way, it foretells that you will be overtaken in your deceitful intriguing, or other disappointments will follow.[or](These dreams are sometimes fulfilled literally in actual life.[or]When this is so, they may have no symbolical meaning.[or]Religion is thrown around men to protect them from vice, so when they propose secretly in their minds to ignore its teachings, they are likely to see a minister or some place of church worship in a dream as a warning against their contemplated action.[or]If they live pure and correct lives as indicated by the church, they will see little of the solemnity of the church or preachers.).[cycling]"
"an"	"eating"	"[one of]If you dream of eating a good meal with a relish it foretells good crops to a farmer and successful business to any one.[cycling]"
"an"	"ebony"	"[one of]If you dream of ebony furniture or other articles of ebony, you will have many distressing disputes and quarrels in your home.[cycling]"
"a"	"feast"	"[one of]If you dream of feasting at a friend’s house or eating with him anywhere it shows you will make a new acquaintance through his means.[or]If a girl dreams this it is a sign she will soon have a lover from that very house or place where she dreams of feasting.[cycling]"
"a"	"key"	"[one of]If you dream of finding a key or a bunch of keys it is a sign that some one will tell you a secret; to dream of losing a key or keys is a bad omen as it predicts that you will come to shame.[or]Such a dream is particularly unfortunate to a young lady.[cycling]"
"a"	"mill"	"[one of]If you dream of going to a flouring-mill where you see plenty of grain and flour it is a good omen as it shadows forth thrift and abundance; but to imagine in your dream that you are in any manufactory of cloth fabrics called a mill is a sign of poverty and want.[or]Girls who work in such places should be careful never to dream of them .[cycling]"
"a"	"chain"	"[one of]If you dream of gold chains it is a sign of a wedding; if a girl dreams she is presented with one it is a sure sign of a speedy marriage.[or]Such a dream to a man in business predicts that he will be prevented from doing something that he specially desires to do.[cycling]"
"a"	"grease"	"[one of]If you dream of grease it foretells that any undertaking you may then be engaged in will go right and according to your mind: if the grease is dirty you will experience difficulties but will get through them.[or]Lovers who dream of grease will be able to get married pretty easy and have things go slick afterward.[cycling]"
"a"	"heal"	"[one of]If you dream of having a sore on your person that was healed up quick it is a sign that some one will cut your acquaintance; if you have a sweetheart or lover it is probable something will happen to break off the intimacy.[cycling]"
"a"	"gout"	"[one of]If you dream of having the gout, you will be sure to be exasperated beyond endurance by the silly conduct of some relative, and suffer small financial loss through the same person.[cycling]"
"a"	"noise"	"[one of]If you dream of hearing strange or mysterious noises it is a sign that the spirit of some dead relative hovers near you and has an influence upon your actions.[cycling]"
"a"	"jug"	"[one of]If you dream of jugs well filled with transparent liquids, your welfare is being considered by more than yourself.[or]Many true friends will unite to please and profit you.[or]If the jugs are empty, your conduct will estrange you from friends and station.[or]Broken jugs, indicate sickness and failures in employment.[or]If you drink wine from a jug, you will enjoy robust health and find pleasure in all circles.[or]Optimistic views will possess you.[or]To take an unpleasant drink from a jug, disappointment and disgust will follow pleasant anticipations.[cycling]"
"a"	"lentil"	"[one of]If you dream of lentils, it denotes quarrels and unhealthy surroundings.[or]For a young woman, this dream portends dissatisfaction with her lover, but parental advice will cause her to accept the inevitable.[cycling]"
"a"	"light"	"[one of]If you dream of light, success will attend you.[or]To dream of weird light, or if the light goes out, you will be disagreeably surprised by some undertaking resulting in nothing.[or]To see a dim light, indicates partial success.[cycling]"
"a"	"gutter"	"[one of]If you dream of lying in a gutter or of seeing a man so reclining it foretells that some honor awaits you or some one in whose success you take an interest.[or]If a girl dreams of a broken gutter she should be careful of allowing her lover to be too familiar with her person or some accident may happen.[cycling]"
"a"	"hay"	"[one of]If you dream of mowing hay, you will find much good in life, and if a farmer your crops will yield abundantly.[or]To see fields of newly cut hay, is a sign of unusual prosperity.[or]If you are hauling and putting hay into barns, your fortune is assured, and you will realize great profit from some enterprise.[or]To see loads of hay passing through the street, you will meet influential strangers who will add much to your pleasure.[or]To feed hay to stock, indicates that you will offer aid to some one who will return the favor with love and advancement to higher states.[cycling]"
"a"	"pawnbroker"	"[one of]If you dream of pawning any of your goods at a pawnbroker’s provided you have never patronized such a place it foretells that fortune is about to smile on you and if you take advantage of the circumstance you will surely get rich.[or]To lazy and shiftless people such a dream would not be of much account.[cycling]"
"a"	"mother"	"[one of]If you dream of quarreling with your mother it is a sign she will do some generous act or confer a benefit that will delight you: to dream of fondling your mother shadows forth her loss by death or that you will be parted from her: if you dream she makes you a present the dream will come true so far that she will probably present you with a new brother or sister.[cycling]"
"a"	"raffle"	"[one of]If you dream of raffling any article, you will fall a victim to speculation.[or]If you are at a church raffle, you will soon find that disappointment is clouding your future.[or]For a young woman, this dream means empty expectations.[cycling]"
"a"	"rescue"	"[one of]If you dream of rescuing anyone from peril it is a sign you will rise in the world either by means of increased wealth or new honors: to dream that you are rescued from drowning or from any other mode of death shows that you will go into some successful business speculation with a partner.[or]To lovers such a dream foretells a speedyand happy union.[cycling]"
"a"	"horse"	"[one of]If you dream of riding well and easily on the back of this noble animal your fortune is sure to advance in the world: but if you imagine you are thrown from a horse it is a sign of disgrace.[or]To dream of swapping horses shows that some one will cheat you in a bargain; of selling a horse it is a sign of loss; but of buying one predicts that you will make money by some speculation or else by selling property.[or]Horses are excellent animals to dream about.[cycling]"
"an"	"oar"	"[one of]If you dream of sailing in a boat and losing one or more of the oars it is a sign of the death of your father mother or guardian or of some one to whom you look for protection: if an engaged young girl or a married woman dreams this it foretells the death of a lover or husband.[cycling]"
"a"	"lake"	"[one of]If you dream of sailing on a smooth and clear lake it foreshadows success in all your undertakings; if the lake is rough but yet has clear water the sign still holds good though you will encounter difficulties; if it is muddy water it denotes sickness and losses through dishonest people about you.[cycling]"
"a"	"fagot"	"[one of]If you dream of seeing a dense smoke ascending from a pile of fagots, it denotes that enemies are bearing down upon you, but if the fagots are burning brightly, you will escape from all unpleasant complications and enjoy great prosperity.[or]If you walk on burning fagots, you will be injured by the unwise actions of friends.[or]If you succeed in walking on them without being burned, you will have a miraculous rise in prospects.[or]To dream of seeing fagots piled up to burn you at the stake, signifies that you are threatened with loss, but if you escape, you will enjoy a long and prosperous life.[cycling]"
"a"	"fairy"	"[one of]If you dream of seeing a fairy you will meet a woman who will seduce you from the path of propriety and make your life vexatious.[cycling]"
"a"	"frog"	"[one of]If you dream of seeing a large frog or a number of frogs or of hearing frogs croak it is a good omen as regards your health.[or]To dream of catching frogs alive without killing them foretells some piece of good fortune; but if you kill them it is a sign some accident will befall you.[cycling]"
"a"	"hawk"	"[one of]If you dream of seeing a very large hawk it shows that you will soon begin a new enterprise; if the hawk darts down and takes a chicken a bird or a fish you will probably be successful; if little birds attack the hawk and drive it away you will have difficulties in your undertaking and may possibly fail in it.[cycling]"
"a"	"goat"	"[one of]If you dream of seeing goats on a high place in a mountain it shows that riches or honors await you: if the goats are merely on the road or in a building it predicts good luck.[cycling]"
"a"	"liquor"	"[one of]If you dream of seeing large quantities of liquor or of buying brandy rum whisky &c it foretells poverty and disgrace; to dream of drinking it is the same only worse if possible.[cycling]"
"a"	"horse"	"[one of]If you dream of seeing or riding a white horse, the indications are favorable for prosperity and pleasurable commingling with congenial friends and fair women.[or]If the white horse is soiled and lean, your confidence will be betrayed by a jealous friend or a woman.[or]If the horse is black, you will be successful in your fortune, but you will practice deception, and will be guilty of assignations.[or]To a woman, this dream denotes that her husband is unfaithful.[or]To dream of dark horses, signifies prosperous conditions, but a large amount of discontent.[or]Fleeting pleasures usually follow this dream.[or]To see yourself riding a fine bay horse, denotes a rise in fortune and gratification of passion.[or]For a woman, it foretells a yielding to importunate advances.[or]She will enjoy material things.[or]To ride or see passing horses, denotes ease and comfort.[or]To ride a runaway horse, your interests will be injured by the folly of a friend or employer.[or]To see a horse running away with others, denotes that you will hear of the illness of friends.[or]To see fine stallions, is a sign of success and high living, and undue passion will master you.[or]To see brood mares, denotes congeniality and absence of jealousy between the married and sweethearts.[or]To ride a horse to ford a stream, you will soon experience some good fortune and will enjoy rich pleasures.[or]If the stream is unsettled or murky, anticipated joys will be somewhat disappointing.[or]To swim on a horse's back through a clear and beautiful stream of water, your conception of passionate bliss will be swiftly realized.[or]To a business man, this dream portends great gain.[or]To see a wounded horse, foretells the trouble of friends.[or]To dream of a dead horse, signifies disappointments of various kinds.[or]To dream of riding a horse that bucks, denotes that your desires will be difficult of consummation.[or]To dream that he throws you, you will have a strong rival, and your business will suffer slightly through competition.[or]To dream that a horse kicks you, you will be repulsed by one you love.[or]Your fortune will be embarrassed by ill health.[cycling]"
"a"	"jail"	"[one of]If you dream of seeing others in jail, you will be deprived of your own liberty.[or]If you dream of being imprisoned, you will be elevated to a high station in life and increase your number of friends.[cycling]"
"a"	"lion"	"[one of]If you dream of seeing the king of beasts and if he is mild and gentle looking it shows that you will easily rise in the world to a better position than you now occupy: to dream of an angry and roaring lion who tries to get at you shows that although you may rise in position jealous people will annoy and try to injure you.[cycling]"
"a"	"governor"	"[one of]If you dream of seeing the.[or]Governor or chief magistrate of a State it foretells that something will soon happen to please you: if you shake hands with him and he smiles upon you the dream is all the better as it predicts that you will have honors conferred upon you.[cycling]"
"a"	"god"	"[one of]If you dream of seeing.[or]God, you will be domineered over by a tyrannical woman masquerading under the cloak of Christianity.[or]No good accrues from this dream.[or]God speaks to you, beware that you do not fall into condemnation.[or]Business of all sorts will take an unfavorable turn.[or]It is the forerunner of the weakening of health and may mean early dissolution.[or]If you dream of worshiping.[or]God, you will have cause to repent of an error of your own making.[or]Look well to observing the ten commandments after this dream.[or]To dream that.[or]God confers distinct favors upon you, you will become the favorite of a cautious and prominent person who will use his position to advance yours.[or]To dream that.[or]God sends his spirit upon you, great changes in your beliefs will take place.[or]Views concerning dogmatic.[or]Christianity should broaden after this dream, or you may be severely chastised for some indiscreet action which has brought shame upon you.[or]God speaks oftener to those who transgress than those who do not.[or]It is the genius of spiritual law or economy to reinstate the prodigal child by signs and visions.[or]David, and.[or]Paul were brought to the altar of repentence through the vigilant energy of the hidden forces within.[cycling]"
"an"	"influence"	"[one of]If you dream of seeking rank or advancement through the influence of others, your desires will fail to materialize; but if you are in an influential position, your prospects will assume a bright form.[or]To see friends in high positions, your companions will be congenial, and you will be free from vexations.[cycling]"
"a"	"dinner"	"[one of]If you dream of sitting down to dinner with a large company it is a sign you will either go a journey or change the present location either of your dwelling or business.[cycling]"
"a"	"throne"	"[one of]If you dream of sitting on a throne, you will rapidly rise to favor and fortune.[or]To descend from one, there is much disappointment for you.[or]To see others on a throne, you will succeed to wealth through the favor of others.[cycling]"
"a"	"straw"	"[one of]If you dream of straw, your life is threatened with emptiness and failure.[or]To see straw piles burning, is a signal of prosperous times.[or]To feed straw to stock, foretells that you will make poor provisions for those depending upon you.[cycling]"
"a"	"gipsy"	"[one of]If you dream of these wandering vagrants it foretells that you will have trouble of some kind—either a vexatious loss or else something will happen to worry you: to dream that a gipsy tells your fortune shows that some one will rob you.[cycling]"
"a"	"gypsy"	"[one of]If you dream of visiting a gypsy camp, you will have an offer of importance and will investigate the standing of the parties to your disadvantage.[or]For a woman to have a gypsy tell her fortune, is an omen of a speedy and unwise marriage.[or]If she is already married, she will be unduly jealous of her husband.[or]For a man to hold any conversation with a gypsy, he will be likely to lose valuable property.[or]To dream of trading with a gypsy, you will lose money in speculation.[or]This dream denotes that material pleasures are the biggest items in your life.[cycling]"
"a"	"meadow"	"[one of]If you dream of walking in a green and pleasant meadow where the grass grows regular and looks smooth it is an excellent omen for it denotes thrift and good luck generally.[or]Such a dream to a farmer is a sign of good crops and plenty of money.[or]To lovers it foretells a happy andspeedy marriage.[cycling]"
"a"	"kill"	"[one of]If you dream of wantonly killing any animal or insect it predicts bad luck and poverty; but if the killing be done by accident it shows that though you may have a misfortune in consequence it will not materially affect your interest.[or]For butchers or farmers to dream of killing fat and healthy animals for food is a sign of thrift and abundance; but if they dream of killing a hog that does not squeal it shadows forth a death in the family.[cycling]"
"a"	"jewi"	"[one of]If you dream that a genuine.[or]Israelite comes along and annoys you in any way it is a sign you will quarrel with your father; if you imagine that he cheats you in a bargain it predicts that you will probably receive a present from some near relative; on the contrary if he gives you an advantage in the bargain it shows that your father or some elderly relative willask a favor of you.[cycling]"
"a"	"grow"	"[one of]If you dream that a tree or shrub grows fast it is a sign that you will do something in a hurry that you will afterward be sorry for: if it be your son or daughter or any near young relative that you imagine to grow very rapidly it foretells an accident to them.[cycling]"
"a"	"basin"	"[one of]If you dream that it is full money; if empty you will make many debts.[cycling]"
"an"	"enemy"	"[one of]If you dream that some one is trying to injure you or that a person who you know is your enemy endeavors to work to your disadvantage it foretells good fortune and success.[or]Such dreams always go by contrary and you may calculate a benefit just in proportion to the injury you dream you are about to sustain.[cycling]"
"a"	"fortune"	"[one of]If you dream that some one told your fortune you may calculate every thing will go pretty nearly the reverse of what was assured to you: if you were promised money you will get poverty and _vice versa_.[or]To dream of making a sudden fortune is a sign of want.[or]All dreams of this kind go by the rule of contrary.[cycling]"
"a"	"hospital"	"[one of]If you dream that you are a patient in a hospital.[or]you will have a contagious disease in your community, and will narrowly escape affliction.[or]If you visit patients there, you will hear distressing news of the absent.[cycling]"
"a"	"dumb"	"[one of]If you dream that you are dumb or that any of your speaking friends are so afflicted it foretells sickness or misfortune.[or]But should you dream that a deaf mute of your acquaintance speaks it foretells joy and gladness at something that will happen.[cycling]"
"a"	"barn"	"[one of]If you dream that you are in a barn that is well stored with hay and grain it predicts that you will marry rich or else inherit land.[or]If the barn be empty it will be the reverse of this or else you will meet with a loss.[cycling]"
"a"	"rage"	"[one of]If you dream that you are in a great rage in consequence of a mishap or disagreeable event it is a sign that some pleasant episode in connection therewith will occur to put you in an excellent humor as such dreams work contrariwise.[cycling]"
"a"	"tornado"	"[one of]If you dream that you are in a tornado, you will be filled with disappointment and perplexity over the miscarriage of studied plans for swift attainment of fortune.[cycling]"
"a"	"jeopardy"	"[one of]If you dream that you are in jeopardy, it will be very fortunate for you.[or]If a person so dreaming be in business, it foretells success and great profit.[cycling]"
"a"	"gown"	"[one of]If you dream that you are in your nightgown, you will be afflicted with a slight illness.[or]If you see others thus clad, you will have unpleasant news of absent friends.[or]Business will receive a back set.[or]If a lover sees his sweetheart in her night gown, he will be superseded.[cycling]"
"an"	"insolvent"	"[one of]If you dream that you are insolvent, you will not have to resort to this means to square yourself with the world, as your energy and pride will enable you to transact business in a fair way.[or]But other worries may sorely afflict you.[or]To dream that others are insolvent, you will meet with honest men in your dealings, but by their frankness they may harm you.[or]For a young woman, it means her sweetheart will be honest and thrifty, but vexatious discords may arise in her affairs.[cycling]"
"a"	"ruin"	"[one of]If you dream that you are looking at old ruins or castles or buildings it is a sign you will travel in distant countries: to dream of the ruins of a house that has been burnt down foretells that you will experience a loss of property: if in your dream you see the ruins of a house that has fallen down it denotes the death of a friend or acquaintance.[cycling]"
"a"	"puzzle"	"[one of]If you dream that you are puzzled with some intricate matter, and cannot unravel the mystery, be sure that some one is about to confer a great favor on you.[cycling]"
"a"	"favor"	"[one of]If you dream that you ask a favor of a friend and he grants it it foretells that he has been talking about you; but if he refuses it it shows that some other person has spoken ill of you to him.[cycling]"
"a"	"goblet"	"[one of]If you dream that you drink water from a silver goblet, you will meet unfavorable business results in the near future.[or]To see goblets of ancient design, you will receive favors and benefits from strangers.[or]For a woman to give a man a glass goblet full of water, denotes illicit pleasures.[cycling]"
"an"	"oven"	"[one of]If you dream that you see an oven hot, it signifies change of place.[cycling]"
"an"	"image"	"[one of]If you dream that you see images, you will have poor success in business or love.[or]To set up an image in your home, portends that you will be weak minded and easily led astray.[or]Women should be careful of their reputation after a dream of this kind.[or]If the images are ugly, you will have trouble in your home.[cycling]"
"a"	"mule"	"[one of]If you dream that your are riding on a mule, it denotes that you are engaging in pursuits which will cause you the greatest anxiety, but if you reach your destination without interruption, you will be recompensed with substantial results.[or]For a young woman to dream of a white mule, shows she will marry a wealthy foreigner, or one who, while wealthy, will not be congenial in tastes.[or]If she dreams of mules running loose, she will have beaux and admirers, but no offers of marriage.[or]To be kicked by a mule, foretells disappointment in love and marriage.[or]To see one dead, portends broken engagements and social decline.[cycling]"
"a"	"hair"	"[one of]If you dream that your hair is thick and bushy it shows that you’ll grow rich or powerful; if you dream it is curly and kinky when in fact it is not it is a sign you’ll do something that you will afterward be ashamed of; if in your dream you imagine that your hair has fallen off or that it has become extremely thin it is a bad omen as it shadows forth sickness and perhaps death.[cycling]"
"a"	"gagi"	"[one of]If you dream that your mouth is stopped by a gag it denotes that you will soon thereafter be kissed by a pretty girl.[or]To a young girl such a dream predicts that she will see some gentleman who takes her fancy and perhaps will fall in love with him.[cycling]"
"a"	"navel"	"[one of]If you dream that your navel is out of shape or looks queer it is a sign of misfortune in connection with the opposite sex unless you are married in which case it denotes the birth of a child: for unmarried people to dream such dreams foretells trouble and disgrace.[cycling]"
"a"	"hand"	"[one of]If you dream that your right hand is injured or any thing is the matter with it it shows that you will soon be called upon to assist a friend in distress; if it is your left hand assistance will be solicited from you for an unfortunate stranger.[cycling]"
"a"	"sheriff"	"[one of]If you dream the sheriff is after you with a writ or a warrant and that you dodge and escape him it is a sign of bad luck and losses; but if he arrests and locks you up in prison it foretells that some good fortune is coming.[or]Soon after such a dream you will be lucky in anything you undertake.[cycling]"
"a"	"ball"	"[one of]If you dream you are at a ball and are dancing with a lady it is a sign you will marry her; if you dream that she is gone and you are looking round to find her and cannot it foretells that she will not live long after marriage.[or]Dreaming of playing ball or seeing it played foretells the speedy receipt of money; to see the ball roll about signifies delay in its reception.[cycling]"
"a"	"battle"	"[one of]If you dream you are engaged in a battle or see a battle it is a sign that you will soon undertake some new enterprise and will leave off the business or calling in which you are then engaged; it also predicts to a girl that she will meet a young man in whom she is much interested; to a soldier it foretells that he will be advanced in rank.[cycling]"
"a"	"pleasure"	"[one of]If you dream you are enjoying great pleasure, you may expect serious disappointment and difficulty in some project that engages your mind.[cycling]"
"a"	"dust"	"[one of]If you dream you are in a room or in the road where the dust is flying so as to choke you it shows that some one is plotting to injure you in some way or to make a speculation out of you.[cycling]"
"a"	"jolly"	"[one of]If you dream you are in company and feel particularly hilarious or jolly it is a sign of sorrow; mark well who it is that contributes most to your mirth for he or she may cause you pain.[or]If a girl dreams this of a young man let her beware of him for a gay seducer.[cycling]"
"a"	"maid"	"[one of]If you dream you are pleased with a pretty chambermaid milkmaid or any nice-looking young girl whose occupation carries with it the title of maid it is a good omen for it predicts an excellent match and plenty of children: it also foretells in many cases that the dreamer will marry a rich wife.[cycling]"
"a"	"fault"	"[one of]If you dream you commit a fault be very careful in your conduct; if you see a fault in a lady who is very dear to you should you trust her she will be faithful to you in every thing.[cycling]"
"a"	"bank"	"[one of]If you dream you go to a large bank and have money there it is a sign that you will be poor at some future period of your life.[cycling]"
"an"	"abundance"	"[one of]If you dream you have an over-abundance of any thing it goes by contrary and is a sign of a scarcity; as if a farmer should dream that he had a great crop it would predict a scarcity—not perhaps of that particular article of which he dreamed but of something that would be important to him.[cycling]"
"a"	"disease"	"[one of]If you dream you have any contagious or foul disease on you it foretells luck and benefit as such a dream goes by contrary.[cycling]"
"a"	"grin"	"[one of]If you dream you see people grinning at you it shows that you will do something of which you are ashamed: if you imagine that ladies are grinning at you you will probably have some adventure with one that will make you appear ridiculous.[cycling]"
"a"	"lemonade"	"[one of]If you drink lemonade in a dream, you will concur with others in signifying some entertainment as a niggardly device to raise funds for the personal enjoyment of others at your expense.[cycling]"
"a"	"butter"	"[one of]If you eat it you will be surprised by some good fortune but mixed with sadness.[cycling]"
"a"	"pork"	"[one of]If you eat pork in your dreams, you will encounter real trouble, but if you only see pork, you will come out of a conflict victoriously.[cycling]"
"a"	"morose"	"[one of]If you find yourself morose in dreams, you will awake to find the world, as far as you are concerned, going fearfully wrong.[or]To see others morose, portends unpleasant occupations and unpleasant companions.[cycling]"
"a"	"paper or parchment"	"[one of]If you have occasion in your dreams to refer to, or handle, any paper or parchment, you will be threatened with losses.[or]They are likely to be in the nature of a lawsuit.[or]For a young woman, it means that she will be angry with her lover and that she fears the opinion of acquaintances.[or]Beware, if you are married, of disagreements in the precincts of the home.[cycling]"
"a"	"noise"	"[one of]If you hear a strange noise in your dream, unfavorable news is presaged.[or]If the noise awakes you, there will be a sudden change in your affairs.[cycling]"
"a"	"hurt"	"[one of]If you hurt a person in your dreams, you will do ugly work, revenging and injuring.[or]If you are hurt, you will have enemies who will overcome you.[cycling]"
"a"	"difficulty"	"[one of]If you imagine in your dream that you are in great difficulty or in personal danger of any kind it is a favorable sign as such dreams always go by contrary.[cycling]"
"a"	"river"	"[one of]If you see a clear, smooth, flowing river in your dream, you will soon succeed to the enjoyment of delightful pleasures, and prosperity will bear flattering promises.[or]If the waters are muddy or tumultuous, there will be disagreeable and jealous contentions in your life.[or]If you are water-bound by the overflowing of a river, there will be temporary embarrassments in your business, or you will suffer uneasiness lest some private escapade will reach public notice and cause your reputation harsh criticisms.[or]If while sailing upon a clear river you see corpses in the bottom, you will find that trouble and gloom will follow swiftly upon present pleasures and fortune.[or]To see empty rivers, denotes sickness and unusual ill-luck.[cycling]"
"a"	"hare"	"[one of]If you see a hare escaping from you in a dream, you will lose something valuable in a mysterious way.[or]If you capture one, you will be the victor in a contest.[or]If you make pets of them, you will have an orderly but unintelligent companion.[or]A dead hare, betokens death to some friend.[or]Existence will be a prosy affair.[or]To see hares chased by dogs, denotes trouble and contentions among your friends, and you will concern yourself to bring about friendly relations.[or]If you dream that you shoot a hare, you will be forced to use violent measures to maintain your rightful possessions.[cycling]"
"a"	"hyena"	"[one of]If you see a hyena in your dreams, you will meet much disappointment and much ill luck in your undertakings, and your companions will be very uncongenial.[or]If lovers have this dream, they will often be involved in quarrels.[or]If one attacks you, your reputation will be set upon by busybodies.[cycling]"
"a"	"lighthouse"	"[one of]If you see a lighthouse through a storm, difficulties and grief will assail you, but they will disperse before prosperity and happiness.[or]To see a lighthouse from a placid sea, denotes calm joys and congenial friends.[cycling]"
"a"	"hand"	"[one of]If you see beautiful hands in your dream, you will enjoy great distinction, and rise rapidly in your calling; but ugly and malformed hands point to disappointments and poverty.[or]To see blood on them, denotes estrangement and unjust censure from members of your family.[or]If you have an injured hand, some person will succeed to what you are striving most to obtain.[or]To see a detached hand, indicates a solitary life, that is, people will fail to understand your views and feelings.[or]To burn your hands, you will overreach the bounds of reason in your struggles for wealth and fame, and lose thereby.[or]To see your hands covered with hair, denotes that you will not become a solid and leading factor in your circle.[or]To see your hands enlarged, denotes a quick advancement in your affairs.[or]To see them smaller, the reverse is predicted.[or]To see your hands soiled, denotes that you will be envious and unjust to others.[or]To wash your hands, you will participate in some joyous festivity.[or]For a woman to admire her own hands, is proof that she will win and hold the sincere regard of the man she prizes above all others.[or]To admire the hands of others, she will be subjected to the whims of a jealous man.[or]To have a man hold her hands, she will be enticed into illicit engagements.[or]If she lets others kiss her hands, she will have gossips busy with her reputation.[or]To handle fire without burning her hands, she will rise to high rank and commanding positions.[or]To dream that your hands are tied, denotes that you will be involved in difficulties.[or]In loosening them, you will force others to submit to your dictations.[cycling]"
"a"	"green"	"[one of]If you see green things such as fruit grass green fields &c in your dream it is a sign of long life but if the color has faded it is a sign of trouble.[cycling]"
"a"	"hack"	"[one of]If you see in your dream a row of hacks or carriages at a funeral it shows that you’ll soon attend a wedding or a jolly party.[cycling]"
"a"	"photography"	"[one of]If you see photographs in your dreams, it is a sign of approaching deception.[or]If you receive the photograph of your lover, you are warned that he is not giving you his undivided loyalty, while he tries to so impress you.[or]For married people to dream of the possession of other persons' photographs, foretells unwelcome disclosures of one's conduct.[or]To dream that you are having your own photograph made, foretells that you will unwarily cause yourself and others' trouble.[cycling]"
"a"	"soot"	"[one of]If you see soot in your dreams, it means that you will meet with ill success in your affairs.[or]Lovers will be quarrelsome and hard to please.[cycling]"
"an"	"illumination"	"[one of]If you see strange and weird illuminations in your dreams, you will meet with disappointments and failures on every hand.[or]Illuminated faces, indicate unsettled business, both private and official.[or]To see the heavens illuminated, with the moon in all her weirdness, unnatural stars and a red sun, or a golden one, you may look for distress in its worst form.[or]Death, family troubles, and national upheavals will occur.[or]To see children in the lighted heavens, warns you to control your feelings, as irrevocable wrong may be done in a frenzy of feeling arising over seeming neglect by your dear ones.[or]To see illuminated human figures or animals in the heavens, denotes failure and trouble; dark clouds overshadow fortune.[or]To see them fall to the earth and men shoot them with guns, many troubles and obstacles will go to nought before your energy and determination to rise.[or]To see illuminated snakes, or any other creeping thing, enemies will surround you, and use hellish means to overthrow you.[cycling]"
"a"	"tar"	"[one of]If you see tar in dreams, it warns you against pitfalls and designs of treacherous enemies.[or]To have tar on your hands or clothing, denotes sickness and grief.[cycling]"
"a"	"vitriol"	"[one of]If you see vitriol in your dreams, it is a token of some innocent person being censured by you.[or]To throw it on people, shows you will bear malice towards parties who seek to favor you.[or]For a young woman to have a jealous rival throw it in her face, foretells that she will be the innocent object of some person's hatred.[or]This dream for a business man, denotes enemies and much persecution.[cycling]"
"an"	"uncle"	"[one of]If you see your uncle in a dream, you will have news of a sad character soon.[or]To dream you see your uncle prostrated in mind, and repeatedly have this dream, you will have trouble with your relations which will result in estrangement, at least for a time.[or]To see your uncle dead, denotes that you have formidable enemies.[or]To have a misunderstanding with your uncle, denotes.[or]that your family relations will be unpleasant, and illness will be continually present.[cycling]"
"a"	"stumble"	"[one of]If you stumble in a dream while walking or running, you will meet with disfavor, and obstructions will bar your path to success, but you will eventually surmount them, if you do not fall.[cycling]"
"an"	"eloquent"	"[one of]If you think you are eloquent of speech in your dreams, there will be pleasant news for you concerning one in whose interest you are working.[or]To fail in impressing others with your eloquence, there will be much disorder in your affairs.[cycling]"
"a"	"thimble"	"[one of]If you use a thimble in your dreams, you will have many others to please besides yourself.[or]If a woman, you will have your own position to make.[or]To lose one, foretells poverty and trouble.[or]To see an old or broken one, denotes that you are about to act unwisely in some momentous affair.[or]To receive or buy a new thimble, portends new associations in which you will find contentment.[or]To dream that you use an open end thimble, but find that it is closed, denotes that you will have trouble, but friends will aid you in escaping its disastrous consequences.[cycling]"
"a"	"visit"	"[one of]If you visit in your dreams, you will shortly have some pleasant occasion in your life.[or]If your visit is unpleasant, your enjoyment will be marred by the action of malicious persons.[or]For a friend to visit you, denotes that news of a favorable nature will soon reach you.[or]If the friend appears sad and travel-worn, there will be a note of displeasure growing out of the visit, or other slight disappointments may follow.[or]If she is dressed in black or white and looks pale or ghastly, serious illness or accidents are predicted.[cycling]"
"an"	"ornament"	"[one of]If you wear ornaments in dreams, you will have a flattering honor conferred upon you.[or]If you receive them, you will be fortunate in undertakings.[or]Giving them away, denotes recklessness and lavish extravagance.[or]Losing an ornament, brings the loss either of a lover, or a good situation.[cycling]"
"a"	"physic"	"[one of]In a dream-book published is this prediction: 'If any man doth dreme he taketh much physicke it foretelleth a bad lyver and a quarell with ye doctor; but a virgin who dremeth this dreme will marry ye doctor first and quarell thereafter'.[cycling]"
"a"	"swine"	"[one of]In dreams, swine denote lazy persons, who think of nothing but how to prey on other people’s goods; they signify also covetous persons.[or]To dream you trade in swine, signifies sickness.[or]To dream you see a sow with a litter of pigs, denotes distress.[cycling]"
"a"	"cage"	"[one of]In your dreaming if you see a cageful of birds, you will be the happy possessor of immense wealth and many beautiful and charming children.[or]To see only one bird, you will contract a desirable and wealthy marriage.[or]No bird indicates a member of the family lost, either by elopement or death.[or]To see wild animals caged, denotes that you will triumph over your enemies and misfortunes.[or]If you are in the cage with them, it denotes harrowing scenes from accidents while traveling.[cycling]"
"a"	"ballet"	"[one of]Indicates infidelity in the marriage state; also failures in business, and quarrels and jealousies among sweethearts.[cycling]"
"a"	"grassplat"	"[one of]Is a sign of a wedding.[cycling]"
"a"	"breakfast"	"[one of]Is favorable to persons engaged in mental work.[or]To see a breakfast of fresh milk and eggs and a well filled dish of ripe fruit, indicates hasty, but favorable changes.[or]If you are eating alone, it means you will fall into your enemies' trap.[or]If you are eating with others it is good.[cycling]"
"a"	"branch"	"[one of]It betokens, if full of fruit and green leaves, wealth, many delightful hours with friends.[or]If they are dried, sorrowful news of the absent.[cycling]"
"an"	"illumination"	"[one of]It is a certain sign of war when persons dream of seeing a city illuminated.[or]To dream your own house is illuminated, betokens much quarrelling among relatives.[cycling]"
"a"	"cotton cap"	"[one of]It is a good dream, denoting many sincere friends.[cycling]"
"a"	"rainbow"	"[one of]It is an excellent dream to imagine you see a brilliant rainbow—the brighter the better: it denotes health and general prosperity: to lovers it foretells a happy marriage and riches.[or]A young girl who dreams of a rainbow will either get an agreeable lover or a present.[cycling]"
"a"	"cabbage"	"[one of]It is bad to dream of cabbage.[or]Disorders may run riot in all forms.[or]To dream of seeing cabbage green, means unfaithfulness in love and infidelity in wedlock.[or]To cut heads of cabbage, denotes that you are tightening the cords of calamity around you by lavish expenditure.[cycling]"
"a"	"belly"	"[one of]It is bad to dream of seeing a swollen mortifying belly, it indicates desperate sickness.[or]To see anything moving on the belly, prognosticates humiliation and hard labor.[or]To see a healthy belly, denotes insane desires.[cycling]"
"a"	"banquet"	"[one of]It is good to dream of a banquet.[or]Friends will wait to do you favors.[or]To dream of yourself, together with many gaily-attired guests, eating from costly plate and drinking wine of fabulous price and age, foretells enormous gain in enterprises of every nature, and happiness among friends.[or]To see inharmonious influences, strange and grotesque faces or empty tables, is ominous of grave misunderstandings or disappointments.[cycling]"
"a"	"daisy"	"[one of]It is good to dream of daisies in the spring or summer, but bad in fall or winter.[cycling]"
"a"	"juniper"	"[one of]It is unlucky to dream of the juniper, especially if the person who so dreams be sick.[or]But to dream of gathering juniper berries, if it be in winter, denotes prosperity.[cycling]"
"a"	"cardinal"	"[one of]It is unlucky to dream you see a cardinal in his robes.[or]You will meet such misfortunes as will necessitate your removal to distant or foreign lands to begin anew your ruined fortune.[or]For a woman to dream this is a sign of her downfall through false promises.[or]If priest or preacher is a spiritual adviser and his services are supposed to be needed, especially in the hour of temptation, then we find ourselves dreaming of him as a warning against approaching evil.[cycling]"
"a"	"kaleidoscope"	"[one of]Kaleidoscopes working before you in a dream, portend swift changes with little of favorable promise in them.[cycling]"
"a"	"mat"	"[one of]Keep away from mats in your dreams, as they will usher you into sorrow and perplexities.[cycling]"
"a"	"lightning"	"[one of]Lightning in your dreams, foreshadows happiness and prosperity of short duration.[or]If the lightning strikes some object near you, and you feel the shock, you will be damaged by the good fortune of a friend, or you may be worried by gossipers and scandalmongers.[or]To see livid lightning parting black clouds, sorrow and difficulties will follow close on to fortune.[or]If it strikes you, unexpected sorrows will overwhelm you in business or love.[or]To see the lightning above your head, heralds the advent of joy and gain.[or]To see lightning in the south, fortune will hide herself from you for awhile.[or]If in the southwest, luck will come your way.[or]In the west, your prospects will be brighter than formally.[or]In the north, obstacles will have to be removed before your prospects will brighten up.[or]If in the east, you will easily win favors and fortune.[or]Lightning from dark and ominous-looking clouds, is always a forerunner of threats, of loss and of disappointments.[or]Business men should stay close to business, and women near their husbands or mothers; children and the sick should be looked after closely.[cycling]"
"a"	"buttermilk"	"[one of]Losses from an extension of business.[or]To the sick it is a sign of speedy convalescence.[cycling]"
"an"	"atonement"	"[one of]Means joyous communing with friends, and speculators need not fear any drop in stocks.[or]Courting among the young will meet with happy consummation.[or]The sacrifice or atonement of another for your waywardness, is portentous of the humiliation of self or friends through your open or secret disregard of duty.[or]A woman after this dream is warned of approaching disappointment.[cycling]"
"an"	"apparel"	"[one of]Nothing more demonstrates the events that are about to happen to you, than dreaming of wearing apparel; but almost every color has a different interpretation, and must depend on its being new or old, its fitting you, or being too big or too little.[or]To dream you are dressed in white, is a sure token of success in the first object you undertake, and that you will be successful in love, and that your sweetheart is of good temper and amiable disposition.[or]To dream that you are dressed in green denotes that you are about to take a journey to your advantage, and that your sweetheart prefers you to all other lovers.[or]To dream that you are dressed in black is an unlucky omen.[or]To dream that you are dressed in blue, denotes happiness.[or]If you dream you are dressed in scarlet, you are thereby warned of some very heavy calamity.[or]To dream you are dressed in yellow, is rather lucky than otherwise.[or]To dream you are dressed in crimson, indicates that you will live to a good old age, and be neither very fortunate or unfortunate through life; it denotes a dispute between landlord and tenant, which will be settled amicably to the advantage of the latter.[or]To dream that you are dressed in a variety of colors, denotes a variety of fortunes is about to attend you.[or]To dream you are fashionably dressed and in good company, is very good for the dreamer; he will rise considerably above his present condition.[or]To dream your clothes fit you well and are comfortable to the season of the year, is favorable and denotes success.[or]To dream your clothes do not fit you, and that they are not suitable to the season, denotes death of some friend and a loss by fire.[or]To dream you see another dressed in any of the modes above described, forebodes to the person dreamt of the same fortunes.[or]To dream you are dressed in new clothes, is a very favorable omen; it portends honors and success to your undertakings.[cycling]"
"a"	"box"	"[one of]Opening a goods box in your dream, signifies untold wealth and that delightful journeys to distant places may be made with happy results.[or]If the box is empty disappointment in works of all kinds will follow.[or]To see full money boxes, augurs cessation from business cares and a pleasant retirement.[cycling]"
"a"	"nunf"	"[one of]or a young girl to dream of seeing a sober-looking nun is a sign of celibacy; if she imagines she speaks to the nun she may safely calculate on being an old maid; if a young man dreams this it foretells that he will suspect his sweetheart of being untrue to him and probably discard her altogether.[cycling]"
"an"	"amputation"	"[one of]Ordinary amputation of limbs, denotes small offices lost; the loss of entire legs or arms, unusual depression in trade.[or]To seamen, storm and loss of property.[or]Afflicted persons should be warned to watchfulness after this dream.[cycling]"
"a"	"palm tree"	"[one of]Palm trees seen in your dreams, are messages of hopeful situations and happiness of a high order.[or]For a young woman to pass down an avenue of palms, omens a cheerful home and a faithful husband.[or]If the palms are withered, some unexpected sorrowful event will disturb her serenity.[cycling]"
"a"	"parrot"	"[one of]Parrots chattering in your dreams, signifies frivolous employments and idle gossip among your friends.[or]To see them in repose, denotes a peaceful intermission of family broils.[or]For a young woman to dream that she owns a parrot, denotes that her lover will believe her to be quarrelsome.[or]To teach a parrot, you will have trouble in your private affairs.[or]A dead parrot, foretells the loss of social friends.[cycling]"
"a"	"partridge"	"[one of]Partridges seen in your dreams, denotes that conditions will be good in your immediate future for the accumulation of property.[or]To ensnare them, signifies that you will be fortunate in expectations.[or]To kill them, foretells that you will be successful, but much of your wealth will be given to others.[or]To eat them, signifies the enjoyment of deserved honors.[or]To see them flying, denotes that a promising future is before you.[cycling]"
"a"	"pipe"	"[one of]Pipes seen in dreams, are representatives of peace and comfort after many struggles.[or]Sewer, gas, and such like pipes, denotes unusual thought and prosperity in your community.[or]Old and broken pipe, signifies ill health and stagnation of business.[or]To dream that you smoke a pipe, denotes that you will enjoy the visit of an old friend, and peaceful settlements of differences will also take place.[cycling]"
"a"	"pitchfork"	"[one of]Pitchforks in dreams, denotes struggles for betterment of fortune and great laboring, either physically or mentally.[or]To dream that you are attacked by some person using a pitchfork, implies that you will have personal enemies who would not scruple to harm you.[cycling]"
"an"	"arrow"	"[one of]Pleasure follows this dream.[or]Entertainments, festivals and pleasant journeys may be expected.[or]Suffering will cease.[or]An old or broken arrow, portends disappointments in love or business.[cycling]"
"a"	"polar bear"	"[one of]Polar bears in dreams, are prognostic of deceit, as misfortune will approach you in a seeming fair aspect.[or]Your bitterest enemies will wear the garb of friendship.[or]Rivals will try to supersede you.[or]To see the skin of one, denotes that you will successfully overcome any opposition.[cycling]"
"a"	"pomegranate"	"[one of]Pomegranates, when dreamed of, denotes that you will wisely use your talents for the enrichment of the mind rather than seeking those pleasures which destroy morality and health.[or]If your sweetheart gives you one, you will be lured by artful wiles to the verge of distraction by woman's charms, but inner forces will hold you safe from thralldom.[or]To eat one, signifies that you will yield yourself a captive to the personal charms of another.[cycling]"
"a"	"quarrel"	"[one of]Quarrels in dreams, portends unhappiness, and fierce altercations.[or]To a young woman, it is the signal of fatal unpleasantries, and to a married woman it brings separation or continuous disagreements.[or]To hear others quarreling, denotes unsatisfactory business and disappointing trade.[cycling]"
"a"	"raffle"	"[one of]Raffling in your dream is the same as gambling; it foretells poverty and disgrace: to dream of raffling for poultry is a sign that your family will want bread; if you are single it shows that you will be apt to get seedy and loaferish.[cycling]"
"a"	"hamd"	"[one of]reaming of fine-looking hams is a good omen; but if they are wormy or in any way blemished it spoils all the luck and shows that you will be unfortunate.[or]To dream of eating fine-tasting hams is a sign that you will do something noted that will create a talk but all in your favor; if the ham that you eat is bad and wormy the said talkwill be a scandal against you.[cycling]"
"a"	"rice"	"[one of]Rice is good to see in dreams, as it foretells success and warm friendships.[or]Prosperity to all trades is promised, and the farmer will be blessed with a bounteous harvest.[or]To eat it, signifies happiness and domestic comfort.[or]To see it mixed with dirt or otherwise impure, denotes sickness and separation from friends.[or]For a young woman to dream of cooking it, shows she will soon assume new duties, which will make her happier, and she will enjoy wealth.[cycling]"
"a"	"rocking-chair"	"[one of]Rocking-chairs seen in dreams, bring friendly intercourse and contentment with any environment.[or]To see a mother, wife, or sweetheart in a rocking chair, is ominous of the sweetest joys that earth affords.[or]To see vacant rocking-chairs, forebodes bereavement or estrangement.[or]The dreamer will surely merit misfortune in some form.[cycling]"
"a"	"rosemary"	"[one of]Rosemary, if seen in dreams, denotes that sadness and indifference will cause unhappiness in homes where there is every appearance of prosperity.[cycling]"
"a"	"saffron"	"[one of]Saffron seen in a dream warns you that you are entertaining false hopes, as bitter enemies are interfering secretly with your plans for the future.[or]To drink a tea made from saffron, foretells that you will have quarrels and alienations in your family.[cycling]"
"a"	"salt"	"[one of]Salt is an omen of discordant surroundings when seen in dreams.[or]You will usually find after dreaming of salt that everything goes awry, and quarrels and dissatisfaction show themselves in the family circle.[or]To salt meat, portends that debts and mortgages will harass you.[or]For a young woman to eat salt, she will be deserted by her lover for a more beautiful and attractive girl, thus causing her deep chagrin.[cycling]"
"a"	"lace"	"[one of]See to it, if you are a lover, that your sweetheart wears lace, as this dream brings fidelity in love and a rise in position.[or]If a woman dreams of lace, she will be happy in the realization of her most ambitious desires, and lovers will bow to her edict.[or]No questioning or imperiousness on their part.[or]If you buy lace, you will conduct an expensive establishment, but wealth will be a solid friend.[or]If you sell laces, your desires will outrun your resources.[or]For a young girl to dream of making lace, forecasts that she will win a handsome, wealthy husband.[or]If she dreams of garnishing her wedding garments with lace, she will be favored with lovers who will bow to her charms, but the wedding will be far removed from her.[cycling]"
"a"	"pistol"	"[one of]Seeing a pistol in your dream, denotes bad fortune, generally.[or]If you own one, you will cultivate a low, designing character.[or]If you hear the report of one, you will be made aware of some scheme to ruin your interests.[or]To dream of shooting off your pistol, signifies that you will bear some innocent person envy, and you will go far to revenge the imagined wrong.[cycling]"
"a"	"porter"	"[one of]Seeing a porter in a dream, denotes decided bad luck and eventful happenings.[or]To imagine yourself a porter, denotes humble circumstances.[or]To hire one, you will be able to enjoy whatever success comes to you.[or]To discharge one, signifies that disagreeable charges will be preferred against you.[cycling]"
"an"	"acorn"	"[one of]Seeing acorns in dreams, is portent of pleasant things ahead, and much gain is to be expected.[or]To pick them from the ground, foretells success after weary labors.[or]For a woman to eat them, denotes that she will rise from a station of labor to a position of ease and pleasure.[or]To shake them from the trees, denotes that you will rapidly attain your wishes in business or love.[or]To see green-growing acorns, or to see them scattered over the ground, affairs will change for the better.[or]Decayed or blasted acorns have import of disappointments and reverses.[or]To pull them green from the trees, you will injure your interests by haste and indiscretion.[cycling]"
"an"	"axe"	"[one of]Seeing an axe in a dream, foretells that what enjoyment you may have will depend on your struggles and energy.[or]To see others using an axe, foretells, your friends will be energetic and lively, making existence a pleasure when near them.[or]For a young woman to see one, portends her lover will be worthy, but not possessed with much wealth.[or]A broken or rusty axe, indicates illness and loss of money and property.[cycling]"
"an"	"antelope"	"[one of]Seeing antelopes in a dream, foretells your ambitions will be high, but may be realized by putting forth great energy.[or]For a young woman to see an antelope miss its footing and fall from a height, denotes the love she aspires to will prove her undoing.[cycling]"
"a"	"ribbon"	"[one of]Seeing ribbons floating from the costume of any person in your dreams, indicates you will have gay and pleasant companions, and practical cares will not trouble you greatly.[or]For a young woman to dream of decorating herself with ribbons, she will soon have a desirable offer of marriage, but frivolity may cause her to make a mistake.[or]If she sees other girls wearing ribbons, she will encounter rivalry in her endeavors to secure a husband.[or]If she buys them, she will have a pleasant and easy place in life.[or]If she feels angry or displeased about them, she will find that some other woman is dividing her honors and pleasures with her in her social realm.[cycling]"
"a"	"dwarf"	"[one of]Should a single lady dream she sees a very small man or.[or]Dwarf it indicates that her husband will be a very large man or have a great intellect.[or]If a single man has this dream it is a sign he will marry a scold.[or]For married people to dream of dwarfs shows that their children will give them much trouble.[cycling]"
"a"	"nobility"	"[one of]Should anybody be so foolish as to dream that they are created a Duke an Earl or that they have conferred upon them any patent of nobility it is a sign of shiftlessness and poverty.[or]If a girl dreams that a lord is in love with her she will be apt to marry a shiftless and needy fellow.[cycling]"
"a"	"hair-dresser"	"[one of]Should you visit a hair-dresser in your dreams, you will be connected with a sensation caused by the indiscretion of a good looking woman.[or]To a woman, this dream means a family disturbance and well merited censures.[or]For a woman to dream of having her hair colored, she will narrowly escape the scorn of society, as enemies will seek to blight her reputation.[or]To have her hair dressed, denotes that she will run after frivolous things, and use any means to bend people to her wishes,.[cycling]"
"a"	"bailiff"	"[one of]Shows a striving for a higher place, and a deficiency in intellect.[or]If the bailiff comes to arrest, or make love, false friends are trying to work for your money.[cycling]"
"a"	"foxa"	"[one of]sign of thieves; to dream of fighting with them shows that you will have to deal with some cunning enemy; to keep a tame fox signifies that you will love a lewd woman or have a bad servant who will rob you.[or]A number of foxes false friends.[cycling]"
"a"	"soap"	"[one of]Signifies trouble in business but it will soon depart.[cycling]"
"a"	"balloon"	"[one of]Signifies you will undertake many visionary things in business and success will not attend you.[cycling]"
"a"	"snail"	"[one of]Snails crawling in your dream, signifies that unhealthful conditions surround you.[or]To step on them, denotes that you will come in contact with disagreeable people.[cycling]"
"a"	"belladonna"	"[one of]Strategic moves will bring success in commercial circles.[or]Women will find rivals in society; vain and fruitless efforts will be made for places in men's affections.[or]Taking it, denotes misery and failure to meet past debts.[cycling]"
"a"	"sweet oil"	"[one of]Sweet oil in dreams, implies considerate treatment will be withheld from you in some unfortunate occurrence.[cycling]"
"an"	"apparition"	"[one of]Take unusual care of all depending upon you.[or]Calamity awaits you and yours.[or]Both property and life are in danger.[or]Young people should be decidedly upright in their communications with the opposite sex.[or]Character is likely to be rated at a discount.[cycling]"
"a"	"cabin"	"[one of]The cabin of a ship is rather unfortunate to be in in{sic} a dream.[or]Some mischief is brewing for you.[or]You will most likely be engaged in a law suit, in which you will lose from the unstability of your witness.[or]For log cabin, see house.[cycling]"
"an"	"ale-house"	"[one of]The dreamer of an ale-house should be very cautious of his affairs.[or]Enemies are watching him.[cycling]"
"a"	"barley-field"	"[one of]The dreamer will obtain his highest desires, and every effort will be crowned with success.[or]Decay in anything denotes loss.[cycling]"
"a"	"wild boar"	"[one of]The wild boar, in dreams, signifies a furious enemy, well furnished with all things necessary.[or]And thus, if any one dreams he has hunted or taken a wild boar, he will chase or take some enemy that hath the same qualities as the wild boar.[cycling]"
"an"	"air"	"[one of]This dream denotes a withering state of things, and bodes no good to the dreamer.[or]To dream of breathing hot air suggests that you will be influenced to evil by oppression.[or]To feel cold air, denotes discrepancies in your business, and incompatibility in domestic relations.[or]To feel oppressed with humidity, some curse will fall on you that will prostrate and close down on your optimistical views of the future.[cycling]"
"an"	"evergreen"	"[one of]This dream denotes boundless resources of wealth, happiness and learning.[or]It is a free presentiment of prosperity to all classes.[cycling]"
"a"	"guitar"	"[one of]This dream denotes luck in love affairs if the dreamer sings and plays on the instrument at the same time.[cycling]"
"a"	"cockade"	"[one of]This dream denotes that foes will bring disastrous suits against you.[or]Beware of titles.[cycling]"
"a"	"cannon"	"[one of]This dream denotes that one's home and country are in danger of foreign intrusion, from which our youth will suffer from the perils of war.[or]For a young woman to hear or see cannons, denotes she will be a soldier's wife and will have to bid him godspeed as he marches in defense of her and honor.[or]The reader will have to interpret dreams of this character by the influences surrounding him, and by the experiences stored away in his subjective mind.[or]If you have thought about cannons a great deal and you dream of them when there is no war, they are most likely to warn you against struggle and probable defeat.[or]Or if business is manipulated by yourself successful engagements after much worry and ill luck may ensue.[cycling]"
"a"	"honey"	"[one of]This dream denotes you will have a long and happy life.[or]If you dream you are eating honey it denotes that something will happen that will give you great joy or pleasure.[or]To a young girl it is a sign that she will soon have a lover that will please her.[cycling]"
"a"	"face"	"[one of]This dream is favorable if you see happy and bright faces, but significant of trouble if they are disfigured, ugly, or frowning on you.[or]To a young person, an ugly face foretells lovers' quarrels; or for a lover to see the face of his sweetheart looking old, denotes separation and the breaking up of happy associations.[or]To see a strange and weird-looking face, denotes that enemies and misfortunes surround you.[or]To dream of seeing your own face, denotes unhappiness; and to the married, threats of divorce will be made.[or]To see your face in a mirror, denotes displeasure with yourself for not being able to carry out plans for self-advancement.[or]You will also lose the esteem of friends.[cycling]"
"a"	"coffin"	"[one of]This dream is unlucky.[or]You will, if you are a farmer, see your crops blasted and your cattle lean and unhealthy.[or]To business men it means debts whose accumulation they are powerless to avoid.[or]To the young it denotes unhappy unions and death of loved ones.[or]To see your own coffin in a dream, business defeat and domestic sorrow may be expected.[or]To dream of a coffin moving of itself, denotes sickness and marriage in close conjunction.[or]Sorrow and pleasure intermingled.[or]Death may follow this dream, but there will also be good.[or]To see your corpse in a coffin, signifies brave efforts will be crushed in defeat and ignominy,.[or]To dream that you find yourself sitting on a coffin in a moving hearse, denotes desperate if not fatal illness for you or some person closely allied to you.[or]Quarrels with the opposite sex is also indicated.[or]You will remorsefully consider your conduct toward a friend.[cycling]"
"a"	"bite"	"[one of]This dream omens ill.[or]It implies a wish to undo work that is past undoing.[or]You are also likely to suffer losses through some enemy.[cycling]"
"a"	"difficulty"	"[one of]This dream signifies temporary embarrassment for business men of all classes, including soldiers and writers.[or]But to extricate yourself from difficulties, foretells your prosperity.[or]For a woman to dream of being in difficulties, denotes that she is threatened with ill health or enemies.[or]For lovers, this is a dream of contrariety, denoting pleasant courtship.[cycling]"
"a"	"gun"	"[one of]This is a dream of distress.[or]Hearing the sound of a gun, denotes loss of employment, and bad management to proprietors of establishments.[or]If you shoot a person with a gun, you will fall into dishonor.[or]If you are shot, you will be annoyed by evil persons, and perhaps suffer an acute illness.[or]For a woman to dream of shooting, forecasts for her a quarreling and disagreeable reputation connected with sensations.[or]For a married woman, unhappiness through other women.[cycling]"
"a"	"cucumber"	"[one of]This is a dream of plenty, denoting health and prosperity.[or]For the sick to dream of serving cucumbers, denotes their speedy recovery.[or]For the married, a pleasant change.[cycling]"
"a"	"filbert"	"[one of]This is a favorable dream, denoting a peaceful and harmonious domestic life and profitable business ventures.[or]To dream of eating them, signifies to the young, delightful associations and many true friends.[cycling]"
"a"	"garter"	"[one of]This is a good dream to the lover as it signifies he will soon be united to his sweetheart.[or]To the married this dream portends much domestic trouble from jealousy.[cycling]"
"a"	"doctor"	"[one of]This is a most auspicious dream, denoting good health and general prosperity, if you meet him socially, for you will not then spend your money for his services.[or]If you be young and engaged to marry him, then this dream warns you of deceit.[or]To dream of a doctor professionally, signifies discouraging illness and disagreeable differences between members of a family.[or]To dream that a doctor makes an incision in your flesh, trying to discover blood, but failing in his efforts, denotes that you will be tormented and injured by some evil person, who may try to make you pay out money for his debts.[or]If he finds blood, you will be the loser in some transaction.[cycling]"
"a"	"damson"	"[one of]This is a peculiarly good dream if one is so fortunate as to see these trees lifting their branches loaded with rich purple fruit and dainty foliage; one may expect riches compared with his present estate.[or]To dream of eating them at any time, forebodes grief.[cycling]"
"a"	"dwarf"	"[one of]This is a very favorable dream.[or]If the dwarf is well formed and pleasing in appearance, it omens you will never be dwarfed in mind or stature.[or]Health and good constitution will admit of your engaging in many profitable pursuits both of mind and body.[or]To see your friends dwarfed, denotes their health, and you will have many pleasures through them.[or]Ugly and hideous dwarfs, always forebodes distressing states.[cycling]"
"a"	"nugget"	"[one of]This is an English word for a lump of gold: to dream of digging a big nugget of pure gold is a sign of wealth and honors.[or]Dreams relative to gold or silver promise good fortune always.[cycling]"
"a"	"corner"	"[one of]This is an unfavorable dream if the dreamer is frightened and secretes himself in a corner for safety.[or]To see persons talking in a corner, enemies are seeking to destroy you.[or]The chances are that some one whom you consider a friend will prove a traitor to your interest.[cycling]"
"a"	"drunk"	"[one of]This is an unfavorable dream if you are drunk on heavy liquors, indicating profligacy and loss of employment.[or]You will be disgraced by stooping to forgery or theft.[or]If drunk on wine, you will be fortunate in trade and love-making, and will scale exalted heights in literary pursuits.[or]This dream is always the bearer of aesthetic experiences.[or]To see others in a drunken condition, foretells for you, and probably others, unhappy states.[or]Drunkenness in all forms is unreliable as a good dream.[or]All classes are warned by this dream to shift their thoughts into more healthful channels.[cycling]"
"an"	"asp"	"[one of]This is an unfortunate dream.[or]Females may lose the respect of honorable and virtuous people.[or]Deadly enemies are at work to defame character.[or]Sweethearts will wrong each other.[cycling]"
"a"	"bag-pipe"	"[one of]This is not a bad dream, unless the music be harsh and the player in rags.[cycling]"
"an"	"employment"	"[one of]This is not an auspicious dream.[or]It implies depression in business circles and loss of employment to wage earners.[or]It also denotes bodily illness.[or]To dream of being out of work, denotes that you will have no fear, as you are always sought out for your conscientious fulfilment of contracts, which make you a desired help.[or]Giving employment to others, indicates loss for yourself.[or]All dreams of this nature may be interpreted as the above.[cycling]"
"a"	"drouth"	"[one of]This is-an evil dream, denoting warring disputes between nations, and much bloodshed therefrom.[or]Shipwrecks and land disasters will occur, and families will quarrel and separate; sickness will work damage also.[or]Your affairs will go awry, as well.[cycling]"
"a"	"cannon-ball"	"[one of]This means that secret enemies are uniting against you.[or]For a maid to see a cannon-ball, denotes that she will have a soldier sweetheart.[or]For a youth to see a cannon-ball, denotes that he will be called upon to defend his country.[cycling]"
"a"	"laughter"	"[one of]This omen is unfavorable and is a sign of tears; it also denotes that you will be worsted by your business engagements; if a lover dreams he sees his sweetheart laugh it is a sign she will jilt him for a stranger; to the married it signifies domestic trouble.[cycling]"
"a"	"beam"	"[one of]This signifies you will attain a high position in life.[cycling]"
"a"	"teeth"	"[one of]To admire your teeth for their whiteness and beauty, foretells that pleasant occupations and much happiness will be experienced through the fulfilment of wishes.[or]To dream that you pull one of your teeth and lose it, and feeling within your mouth with your tongue for the cavity, and failing to find any, and have a doctor for the same, but to no effect, leaving the whole affair enveloped in mystery, denotes that you are about to enter into some engagement which does not exactly please you, and which you decide to ignore, but will later take it up and secretly prosecute it to your own disquieting satisfaction and under the suspicion of friends.[or]To dream that a dentist cleans your teeth perfectly, and the next morning you find them rusty, foretells you will believe your interest secure concerning some person or position, but you will find that they have succumbed to the blandishments of an artful man or woman.[cycling]"
"a"	"riding school"	"[one of]To attend a riding school, foretells some friend will act falsely by you, but you will throw off the vexing influence occasioned by it.[cycling]"
"a"	"wedding"	"[one of]To attend a wedding in your dream, you will speedily find that there is approaching you an occasion which will cause you bitterness and delayed success.[or]For a young woman to dream that her wedding is a secret is decidedly unfavorable to character.[or]It imports her probable downfall.[or]If she contracts a worldly, or approved marriage, signifies she will rise in the estimation of those about her, and anticipated promises and joys will not be withheld.[or]If she thinks in her dream that there are parental objections, she will find that her engagement will create dissatisfaction among her relatives.[or]For her to dream her lover weds another, foretells that she will be distressed with needless fears, as her lover will faithfully carry out his promises.[or]For a person to dream of being wedded, is a sad augury, as death will only be eluded by a miracle.[or]If the wedding is a gay one and there are no ashen, pale-faced or black-robed ministers enjoining solemn vows, the reverses may be expected.[or]For a young woman to dream that she sees some one at her wedding dressed in mourning, denotes she will only have unhappiness in her married life.[or]If at another's wedding, she will be grieved over the unfavorable fortune of some relative or friend.[or]She may experience displeasure or illness where she expected happiness and health.[or]The pleasure trips of others or her own, after this dream, may be greatly disturbed by unpleasant intrusions or surprises.[or]Marriage and.[cycling]"
"a"	"burial"	"[one of]To attend the burial of a relative, if the sun is shining on the procession, is a sign of the good health of relations, and perhaps the happy marriage of some one of them is about to occur.[or]But if rain and dismal weather prevails, sickness and bad news of the absent will soon come, and depressions in business circles will be felt.[or]A burial where there are sad rites performed, or sorrowing faces, is indicative of adverse surroundings or their speedy approach.[cycling]"
"a"	"delay"	"[one of]To be delayed in a dream, warns you of the scheming of enemies to prevent your progress.[cycling]"
"a"	"dram-drinking"	"[one of]To be given to dram-drinking in your dreams, omens ill-natured rivalry and contention for small possession.[or]To think you have quit dram-drinking, or find that others have done so, shows that you will rise above present estate and rejoice in prosperity.[cycling]"
"a"	"printing office"	"[one of]To be in a printing office in dreams, denotes that slander and contumely will threaten you.[or]To run a printing office is indicative of hard luck.[or]For a young woman to dream that her sweetheart is connected with a printing office, denotes that she will have a lover who is unable to lavish money or time upon her, and she will not be sensible enough to see why he is so stingy.[cycling]"
"a"	"rage"	"[one of]To be in a rage and scolding and tearing up things generally, while dreaming, signifies quarrels, and injury to your friends.[or]To see others in a rage, is a sign of unfavorable conditions for business, and unhappiness in social life.[or]For a young woman to see her lover in a rage, denotes that there will be some discordant note in their love, and misunderstandings will naturally occur.[cycling]"
"a"	"despair"	"[one of]To be in despair in dreams, denotes that you will have many and cruel vexations in the working world.[or]To see others in despair, foretells the distress and unhappy position of some relative or friend.[cycling]"
"a"	"rain"	"[one of]To be out in a clear shower of rain, denotes that pleasure will be enjoyed with the zest of youth, and prosperity will come to you.[or]If the rain descends from murky clouds, you will feel alarmed over the graveness of your undertakings.[or]To see and hear rain approaching, and you escape being wet, you will succeed in your plans, and your designs will mature rapidly.[or]To be sitting in the house and see through the window a downpour of rain, denotes that you will possess fortune, and passionate love will be requited.[or]To hear the patter of rain on the roof, denotes a realization of domestic bliss and joy.[or]Fortune will come in a small way.[or]To dream that your house is leaking during a rain, if the water is clear, foretells that illicit pleasure will come to you rather unexpectedly; but if filthy or muddy, you may expect the reverse, and also exposure.[or]To find yourself regretting some duty unperformed while listening to the rain, denotes that you will seek pleasure at the expense of another's sense of propriety and justice.[or]To see it rain on others, foretells that you will exclude friends from your confidence.[or]For a young woman to dream of getting her clothes wet and soiled while out in a rain, denotes that she will entertain some person indiscreetly, and will suffer the suspicions of friends for the unwise yielding to foolish enjoyments.[or]To see it raining on farm stock, foretells disappointment in business, and unpleasantness in social circles.[or]Stormy rains are always unfortunate.[cycling]"
"a"	"golf"	"[one of]To be playing golf or watching the game, denotes that pleasant and successive wishing will be indulged in by you.[or]To see any unpleasantness connected with golf, you will be humiliated by some thoughtless person.[cycling]"
"a"	"gloomy"	"[one of]To be surrounded by many gloomy situations in your dream, warns you of rapidly approaching unpleasantness and loss.[cycling]"
"a"	"reprieve"	"[one of]To be under sentence in a dream and receive a reprieve, foretells that you will overcome some difficulty which is causing you anxiety.[or]For a young woman to dream that her lover has been reprieved, denotes that she will soon hear of some good luck befalling him, which will be of vital interest to her.[cycling]"
"a"	"desk"	"[one of]To be using a desk in a dream, denotes unforeseen ill luck will rise before you.[or]To see money on your desk, brings you unexpected extrication from private difficulties.[cycling]"
"a"	"disgrace"	"[one of]To be worried in your dream over the disgraceful conduct of children or friends, will bring you unsatisfying hopes, and worries will harass you.[or]To be in disgrace yourself, denotes that you will hold morality at a low rate, and you are in danger of lowering your reputation for uprightness.[or]Enemies are also shadowing you.[cycling]"
"a"	"steel"	"[one of]To break a piece in a dream shows that you will overcome your enemies; if you only touch it your position in life is secure; if you try to bend it and cannot you will meet with many serious accidents.[cycling]"
"a"	"breath"	"[one of]To come close to a person in your dreaming with a pure and sweet breath, commendable will be your conduct, and a profitable consummation of business deals will follow.[or]Breath if fetid, indicates sickness and snares.[or]Losing one's breath, denotes signal failure where success seemed assured.[cycling]"
"an"	"absinthe"	"[one of]To come under the influence of absinthe in dreams, denotes that you will lead a merry and foolish pace with innocent companions, and waste your inheritance in prodigal lavishness on the siren, selfish fancy.[or]For a young woman to dream that she drinks absinthe with her lover warns her to resist his persuasions to illicit consummation of their love.[or]If she dreams she is drunk, she will yield up her favors without strong persuasion (This dream typifies that you are likely to waste your energies in pleasure.).[cycling]"
"a"	"suicide"	"[one of]To commit suicide in a dream, foretells that misfortune will hang heavily over you.[or]To see or hear others committing this deed, foretells that the failure of others will affect your interests.[or]For a young woman to dream that her lover commits suicide, her disappointment by the faithlessness of her lover is accentuated.[cycling]"
"a"	"mute"	"[one of]To converse with a mute in your dreams, foretells that unusual crosses in your life will fit you for higher positions, which will be tendered you.[or]To dream that you are a mute, portends calamities and unjust persecution.[cycling]"
"a"	"jig"	"[one of]To dance a jig, denotes cheerful occupations and light pleasures.[or]To see negroes dancing a jig, foolish worries will offset pleasure.[or]To see your sweetheart dancing a jig, your companion will be possessed with a merry and hopeful disposition.[or]To see ballet girls dancing a jig, you will engage in undignified amusements and follow low desires.[cycling]"
"a"	"bear"	"[one of]To dream a bear thy step pursues,.[or]A cruel foe some mischief brews.[cycling]"
"a"	"burial"	"[one of]To dream a burial passes by,.[or]News of the living doth imply.[cycling]"
"a"	"crown"	"[one of]To dream a golden crown is placed upon your head foretells that success and great honor await you; if the crown be silver you will enjoy good health; if crowned with green leaves friends and fortune will forsake you.[cycling]"
"a"	"venison"	"[one of]To dream about venison, denotes change in affairs.[or]To dream you eat of it, signifies misfortune.[cycling]"
"a"	"volcano"	"[one of]To dream about volcanos forbodes liberty to a person in prison, and peace and happiness to those out of it.[cycling]"
"a"	"merry"	"[one of]To dream being merry, or in merry company, denotes that pleasant events will engage you for a time, and affairs will assume profitable shapes.[cycling]"
"an"	"oilt"	"[one of]To dream it is spilled on the floor signifies damage; to spill it on yourself profit.[cycling]"
"a"	"badger"	"[one of]To dream of a badger, is a sign of luck after battles with hardships.[cycling]"
"a"	"bake-house"	"[one of]To dream of a bake-house, demands caution in making changes in one's career.[or]Pitfalls may reveal themselves on every hand.[or]For a young woman to dream that she is in a bake house, portends that her character wil{l} be assailed.[or]She should exercise great care in her social affairs.[cycling]"
"a"	"banjo"	"[one of]To dream of a banjo, denotes that pleasant amusements will be enjoyed.[or]To see a negro playing one, denotes that you will have slight worries, but no serious vexation for a season.[or]For a young woman to see negroes with their banjos, foretells that she will fail in some anticipated amusement.[or]She will have misunderstandings with her lover.[cycling]"
"a"	"barber"	"[one of]To dream of a barber denotes losses.[cycling]"
"a"	"barber"	"[one of]To dream of a barber, denotes that success will come through struggling and close attention to business.[or]For a young woman to dream of a barber, foretells that her fortune will increase, though meagerly.[cycling]"
"a"	"barn"	"[one of]To dream of a barn, and that you see it well stored with corn, denotes much good; it foretells to a man that he will marry some rich woman; to a maid, that she will marry a man who will grow very rich by his industry, and be promoted in the state.[or]If you dream you see an empty barn, the reverse will happen.[cycling]"
"a"	"basin"	"[one of]To dream of a basin, signifies a good maid; and to dream you eat or drink therein, shows you have a love to the servant maid.[or]For a man to see himself in a basin as in a glass, denotes he shall have children by a servant maid.[cycling]"
"a"	"batt"	"[one of]To dream of a bat or bats is a sign you will go on a bootless journey or one that is not satisfactory.[cycling]"
"a"	"bayonet"	"[one of]To dream of a bayonet indicates that you have vindictive enemies.[cycling]"
"a"	"bayonet"	"[one of]To dream of a bayonet, signifies that enemies will hold you in their power, unless you get possession of the bayonet.[cycling]"
"a"	"countenance"	"[one of]To dream of a beautiful and ingenuous countenance, you may safely look for some pleasure to fall to your lot in the near future; but to behold an ugly and scowling visage, portends unfavorable transactions.[cycling]"
"a"	"birth"	"[one of]To dream of a birth is good for a poor man; to the sick it denotes death.[cycling]"
"a"	"birthday"	"[one of]To dream of a birthday is a signal of poverty and falsehood to the young, to the old, long trouble and desolation.[cycling]"
"a"	"bishop"	"[one of]To dream of a bishop, teachers and authors will suffer great mental worries, caused from delving into intricate subjects.[or]To the tradesman, foolish buying, in which he is likely to incur loss of good money.[or]For one to see a bishop in his dreams, hard work will be his patrimony, with chills and ague as attendant.[or]If you meet the approval of a much admired bishop, you will be successful in your undertakings in love or business.[cycling]"
"a"	"boarding house"	"[one of]To dream of a boarding house, foretells that you will suffer entanglement and disorder in your enterprises, and you are likely to change your residence.[cycling]"
"a"	"bouquet"	"[one of]To dream of a bouquet beautifully and richly colored, denotes a legacy from some wealthy and unknown relative; also, pleasant, joyous gatherings among young folks.[or]To see a withered bouquet, signifies sickness and death.[cycling]"
"a"	"bridle"	"[one of]To dream of a bridle, denotes you will engage in some enterprise which will afford much worry, but will eventually terminate in pleasure and gain.[or]If it is old or broken you will have difficulties to encounter, and the probabilities are that you will go down before them.[or]A blind bridle signifies you will be deceived by some wily enemy, or some woman will entangle you in an intrigue.[cycling]"
"a"	"rudder"	"[one of]To dream of a broken rudder in a boat or vessel in which you are sailing foretells that one of the persons who you imagine are in the boat will be drowned or come to a sudden death.[cycling]"
"a"	"daisy"	"[one of]To dream of a bunch of daisys, implies sadness, but if you dream of being in a field where these lovely flowers are in bloom, with the sun shining and birds singing, happiness, health and prosperity will vie each with the other to lead you through the pleasantest avenues of life.[or]To dream of seeing them out of season, you will be assailed by evil in some guise.[cycling]"
"a"	"straw"	"[one of]To dream of a bundle of straw denotes abundance; if scattered about poverty.[cycling]"
"a"	"funeral"	"[one of]To dream of a burial, denotes speedy marriage, and that you will hear of the death or imprisonment of some near relation or esteemed friend.[or]It also foretells the acquisition of wealth, and that an estate will fall to you from a distant relation by your mothers side.[or]If you see any particular person attending a funeral, either that person, or some friend of his, will die and leave you something.[or]If there is a hearse with feathers on it, you will many some rich person yourself, or assist at some relation’s wedding, who will marry well and be a friend to you.[cycling]"
"a"	"lamp"	"[one of]To dream of a burning lamp, signifies prosperity.[or]To dream of a lamp suddenly extinguished, signifies the death of a near friend.[cycling]"
"an"	"engagement"	"[one of]To dream of a business engagement, denotes dulness and worries in trade.[or]For young people to dream that they are engaged, denotes that they will not be much admired.[or]To dream of breaking an engagement, denotes a hasty, and an unwise action in some important matter or disappointments may follow.[cycling]"
"a"	"cable"	"[one of]To dream of a cable, foretells the undertaking of a decidedly hazardous work, which, if successfully carried to completion, will abound in riches and honor to you.[or]To dream of receiving cablegrams, denotes that a message of importance will reach you soon, and will cause disagreeable comments.[cycling]"
"a"	"calf"	"[one of]To dream of a calf is a sign of good luck.[cycling]"
"a"	"cameo brooch"	"[one of]To dream of a cameo brooch, denotes some sad occurrence will soon claim your attention.[cycling]"
"a"	"camera"	"[one of]To dream of a camera, signifies that changes will bring undeserved environments.[or]For a young woman to dream that she is taking pictures with a camera, foretells that her immediate future will have much that is displeasing and that a friend will subject her to acute disappointment.[cycling]"
"a"	"cane"	"[one of]To dream of a cane is considered a most inauspicious dream; and some authors forbid the dreamer to undertake any business on that day.[cycling]"
"a"	"canopy"	"[one of]To dream of a canopy or of being beneath one, denotes that false friends are influencing you to undesirable ways of securing gain.[or]You will do well to protect those in your care.[cycling]"
"a"	"chalice"	"[one of]To dream of a chalice, denotes pleasure will be gained by you to the sorrow of others.[or]To break one foretells your failure to obtain power over some friend.[cycling]"
"a"	"champion"	"[one of]To dream of a champion, denotes you will win the warmest friendship of some person by your dignity and moral conduct.[cycling]"
"a"	"chandelier"	"[one of]To dream of a chandelier, portends that unhoped-for success will make it possible for you to enjoy pleasure and luxury at your caprice.[or]To see a broken or ill-kept one, denotes that unfortunate speculation will depress your seemingly substantial fortune.[or]To see the light in one go out, foretells that sickness and distress will cloud a promising future.[cycling]"
"a"	"chapel"	"[one of]To dream of a chapel, denotes dissension in social circles and unsettled business.[or]To be in a chapel, denotes disappointment and change of business.[or]For young people to dream of entering a chapel, implies false loves and enemies.[or]Unlucky unions may entangle them.[cycling]"
"a"	"choir"	"[one of]To dream of a choir, foretells you may expect cheerful surroundings to replace gloom and discontent.[or]For a young woman to sing in a choir, denotes she will be miserable over the attention paid others by her lover.[cycling]"
"a"	"christmas tree"	"[one of]To dream of a Christmas tree, denotes joyful occasions and auspicious fortune.[or]To see one dismantled, foretells some painful incident will follow occasions of festivity.[cycling]"
"a"	"churchyard"	"[one of]To dream of a churchyard is a sign you will have a long and happy life.[cycling]"
"a"	"circle"	"[one of]To dream of a circle, denotes that your affairs will deceive you in their proportions of gain.[or]For a young woman to dream of a circle, warns her of indiscreet involvement to the exclusion of marriage.[cycling]"
"a"	"cistern"	"[one of]To dream of a cistern, denotes you are in danger of trespassing upon the pleasures and rights of your friends.[or]To draw from one, foretells that you will enlarge in your pastime and enjoyment in a manner which may be questioned by propriety.[or]To see an empty one, foretells despairing change from happiness to sorrow.[cycling]"
"a"	"city council"	"[one of]To dream of a city council, foretells that your interests will clash with public institutions and there will be discouraging outlooks for you.[cycling]"
"a"	"city hall"	"[one of]To dream of a city hall, denotes contentions and threatened law suits.[or]To a young woman this dream is a foreboding of unhappy estrangement from her lover by her failure to keep virtue inviolate.[cycling]"
"a"	"clarionet"	"[one of]To dream of a claironet, foretells that you will indulge in frivolity beneath your usual dignity.[or]{I}f it is broken, you will incur the displeasure of a close friend.[cycling]"
"a"	"night"	"[one of]To dream of a clear beautiful night when the stars are shining indicates that you will have a long and happy life and be very successful in all your undertakings.[or]To dream you are courting your sweetheart on such a night shows that she is true to you.[or]To dream of a cloudy night portends disasters in business and to dream of a stormy night indicates sickness.[cycling]"
"a"	"cloister"	"[one of]To dream of a cloister, omens dissatisfaction with present surroundings, and you will soon seek new environments.[or]For a young woman to dream of a cloister, foretells that her life will be made unselfish by the chastening of sorrow.[cycling]"
"a"	"cloven foot"	"[one of]To dream of a cloven foot, portends some unusual ill luck is threatening you, and you will do well to avoid the friendship of strange persons.[cycling]"
"a"	"coal-hod"	"[one of]To dream of a coal-hod, denotes that grief will be likely to fill a vacancy made by reckless extravagance.[or]To see your neighbor carrying in hods, foretells your surroundings will be decidedly distasteful and inharmonious.[cycling]"
"a"	"college"	"[one of]To dream of a college, denotes you are soon to advance to a position long sought after.[or]To dream that you are back in college, foretells you will receive distinction through some well favored work.[cycling]"
"a"	"committee"	"[one of]To dream of a committee, foretells that you will be surprised into doing some distasteful work.[or]For one to wait on you, foretells some unfruitful labor will be assigned you.[cycling]"
"a"	"concert"	"[one of]To dream of a concert of a high musical order, denotes delightful seasons of pleasure, and literary work to the author.[or]To the business man it portends successful trade, and to the young it signifies unalloyed bliss and faithful loves.[or]Ordinary concerts such as engage ballet singers, denote that disagreeable companions and ungrateful friends will be met with.[or]Business will show a falling off.[cycling]"
"a"	"conflagration"	"[one of]To dream of a conflagration, denotes, if no lives are lost, changes in the future which will be beneficial to your interests and happiness.[cycling]"
"a"	"conjurer"	"[one of]To dream of a conjuror, denotes unpleasant experience will beset you in your search for wealth and happiness.[cycling]"
"a"	"convention"	"[one of]To dream of a convention, denotes unusual activity in business affairs and final engagement in love.[or]An inharmonious or displeasing convention brings you disappointment.[cycling]"
"a"	"coppersmith"	"[one of]To dream of a coppersmith, denotes small returns for labor, but withal contentment.[cycling]"
"a"	"coronation"	"[one of]To dream of a coronation, foretells you will enjoy acquaintances and friendships with prominent people.[or]For a young woman to be participating in a coronation, foretells that she will come into some surprising favor with distinguished personages.[or]But if the coronation presents disagreeable incoherence in her dreams, then she may expect unsatisfactory states growing out of anticipated pleasure.[cycling]"
"a"	"corpse"	"[one of]To dream of a corpse is fatal to happiness, as this dream indicates sorrowful tidings of the absent, and gloomy business prospects.[or]The young will suffer many disappointments and pleasure will vanish.[or]To see a corpse placed in its casket, denotes immediate troubles to the dreamer.[or]To see a corpse in black, denotes the violent death of a friend or some desperate business entanglement.[or]To see a battle-field strewn with corpses, indicates war and general dissatisfaction between countries and political factions.[or]To see the corpse of an animal, denotes unhealthy situation, both as to business and health.[or]To see the corpse of any one of your immediate family, indicates death to that person, or to some member of the family, or a serious rupture of domestic relations, also unusual business depression.[or]For lovers it is a sure sign of failure to keep promises of a sacred nature.[or]To put money on the eyes of a corpse in your dreams, denotes that you will see unscrupulous enemies robbing you while you are powerless to resent injury.[or]If you only put it on one eye you will be able to recover lost property after an almost hopeless struggle.[or]For a young woman this dream denotes distress and loss by unfortunately giving her confidence to designing persons.[or]For a young woman to dream that the proprietor of the store in which she works is a corpse, and she sees while sitting up with him that his face is clean shaven, foretells that she will fall below the standard of perfection in which she was held by her lover.[or]If she sees the head of the corpse falling from the body, she is warned of secret enemies who, in harming her, will also detract from the interest of her employer.[or]Seeing the corpse in the store, foretells that loss and unpleasantness will offset all concerned.[or]There are those who are not conscientiously doing the right thing.[or]There will be a gloomy outlook for peace and prosperous work.[cycling]"
"a"	"corset"	"[one of]To dream of a corset, denotes that you will be perplexed as to the meaning of attentions won by you.[or]If a young woman is vexed over undoing or fastening her corset, she will be strongly inclined to quarrel with her friends under slight provocations.[cycling]"
"a"	"cossack"	"[one of]To dream of a Cossack, denotes humiliation of a personal character, brought about by dissipation and wanton extravagance.[cycling]"
"a"	"cot"	"[one of]To dream of a cot, foretells some affliction, either through sickness or accident.[or]Cots in rows signify you will not be alone in trouble, as friends will be afflicted also.[cycling]"
"a"	"cotton gin"	"[one of]To dream of a cotton gin, foretells you will make some advancement toward fortune which will be very pleasing and satisfactory.[or]To see a broken or dilapidated gin, signifies misfortune and trouble will overthrow success.[cycling]"
"a"	"counselor"	"[one of]To dream of a counselor, you are likely to be possessed of some ability yourself, and you will usually prefer your own judgment to that of others.[or]Be guarded in executing your ideas of right.[cycling]"
"a"	"coxcomb"	"[one of]To dream of a coxcomb, denotes a low state of mind.[or]The dreamer should endeavor to elevate his mind to nobler thoughts.[cycling]"
"a"	"cradle"	"[one of]To dream of a cradle, with a beautiful infant occupying it, portends prosperity and the affections of beautiful children.[or]To rock your own baby in a cradle, denotes the serious illness of one of the family.[or]For a young woman to dream of rocking a cradle is portentous of her downfall.[or]She should beware of gossiping.[cycling]"
"a"	"creek"	"[one of]To dream of a creek, denotes new experiences and short journeys.[or]If it is overflowing, you will have sharp trouble, but of brief period.[or]If it is dry, disappointment will be felt by you, and you will see another obtain the things you intrigued to secure.[cycling]"
"a"	"crocodile"	"[one of]To dream of a crocodile signifies pirates or robbers by sea or deceitful persons and troubles.[cycling]"
"a"	"crocodile"	"[one of]To dream of a crocodile, signifies pirates or robbers at sea, or wicked periods in any sort like the crocodile.[cycling]"
"a"	"crown"	"[one of]To dream of a crown, prognosticates change of mode in the habit of one's life.[or]The dreamer will travel a long distance from home and form new relations.[or]Fatal illness may also be the sad omen of this dream.[or]To dream that you wear a crown, signifies loss of personal property.[or]To dream of crowning a person, denotes your own worthiness.[or]To dream of talking with the.[or]President of the.[or]States, denotes that you are interested in affairs of state, and sometimes show a great longing to be a politician.[cycling]"
"a"	"crust"	"[one of]To dream of a crust of bread, denotes incompetency, and threatened misery through carelessness in appointed duties.[cycling]"
"a"	"cuckoo"	"[one of]To dream of a cuckoo, prognosticates a sudden ending of a happy life caused by the downfall of a dear friend.[or]To dream that you hear a cuckoo, denotes the painful illness of the death of some absent loved one, or accident to some one in your family.[cycling]"
"a"	"currycomb"	"[one of]To dream of a currycomb foretells that great labors must be endured in order to obtain wealth and comfort.[cycling]"
"a"	"custom-house"	"[one of]To dream of a custom-house, denotes you will have rivalries and competition in your labors.[or]To enter a custom-house, foretells that you will strive for, or have offered you, a position which you have long desired.[or]To leave one, signifies loss of position, trade or failure of securing some desired object.[cycling]"
"a"	"cut"	"[one of]To dream of a cut, denotes sickness or the treachery of a friend will frustrate your cheerfulness.[cycling]"
"a"	"dagger"	"[one of]To dream of a dagger you may expect news of absent persons and your dearest hope will be fulfilled.[cycling]"
"a"	"dancing master"	"[one of]To dream of a dancing master, foretells you will neglect important affairs to pursue frivolities.[or]For a young woman to dream that her lover is a dancing master, portends that she will have a friend in accordance with her views of pleasure and life.[cycling]"
"a"	"dentist"	"[one of]To dream of a dentist working on your teeth, denotes that you will have occasion to doubt the sincerity and honor of some person with whom you have dealings.[or]To see him at work on a young woman's teeth, denotes that you will soon be shocked by a scandal in circles near you.[cycling]"
"a"	"detective"	"[one of]To dream of a detective keeping in your wake when you are innocent of charges preferred, denotes that fortune and honor are drawing nearer to you each day; but if you feel yourself guilty, you are likely to find your reputation at stake, and friends will turn from you.[or]For a young woman, this is not a fortunate dream.[cycling]"
"a"	"storm"	"[one of]To dream of a devastating storm foretells losses and trouble: a violent rain-storm denotes that you will have good luck but that misfortunes will nevertheless injure your prospects: gentle showers promise the luck without the adverse omen.[cycling]"
"a"	"diadem"	"[one of]To dream of a diadem, denotes that some honor will be tendered you for acceptance.[cycling]"
"a"	"table-cloth"	"[one of]To dream of a dirty table-cloth foretells that you will have plenty to eat.[cycling]"
"a"	"liver"	"[one of]To dream of a disordered liver, denotes a querulous person will be your mate, and fault-finding will occupy her time, and disquiet will fill your hours.[or]To dream of eating liver, indicates that some deceitful person has installed himself in the affection of your sweetheart.[cycling]"
"a"	"distaff"	"[one of]To dream of a distaff, denotes frugality, with pleasant surroundings.[or]It also signifies that a devotional spirit will be cultivated by you.[cycling]"
"a"	"dolphin"	"[one of]To dream of a dolphin, indicates your liability to come under a new government.[or]It is not a very good dream.[cycling]"
"a"	"dolphin"	"[one of]To dream of a dolphin, shows to seafaring men a wind from the place whence you dream he cometh.[or]But to dream you see the dolphin out of water, signifies the death of friends.[cycling]"
"a"	"donkey"	"[one of]To dream of a donkey braying in your face, denotes that you are about to be publicly insulted by a lewd and unscrupulous person.[or]To hear the distant braying filling space with melancholy, you will receive wealth and release from unpleasant bonds by the death of some person close to you.[or]If you see yourself riding on a donkey, you will visit foreign lands and make many explorations into places difficult of passage.[or]To see others riding donkeys, denotes a meagre inheritance for them and a toiling life.[or]To dream of seeing many of the old patriarchs traveling on donkeys, shows that the influence of Christians will be thrown against you in your selfish wantonness, causing you to ponder over the rights and duties of man to man.[or]To drive a donkey, signifies that all your energies and pluck will be brought into play against a desperate effort on the part of enemies to overthrow you.[or]If you are in love, evil women will cause you trouble.[or]If you are kicked by this little animal, it shows that you are carrying on illicit connections, from which you will suffer much anxiety from fear of betrayal.[or]If you lead one by a halter, you will be master of every situation, and lead women into your way of seeing things by flattery.[or]To see children riding and driving donkeys, signifies health and obedience for them.[or]To fall or be thrown from one, denotes ill luck and disappointment in secular affairs.[or]Lovers will quarrel and separate.[or]To see one dead, denotes satiated appetites, resulting from licentious excesses.[or]To dream of drinking the milk of a donkey, denotes that whimsical desires will be gratified, even to the displacement of important duties.[or]If you see in your dreams a strange donkey among your stock, or on your premises, you will inherit some valuable effects.[or]To dream of coming into the possession of a donkey by present, or buying, you will attain to enviable heights in the business or social world, and if single, will contract a congenial marriage.[or]To dream of a white donkey, denotes an assured and lasting fortune, which will enable you to pursue the pleasures or studies that lie nearest your heart.[or]For a woman, it signals entrance into that society for which she has long entertained the most ardent desire.[or]Woman has in her composition those qualities, docility and stubbornness, which tallies with the same qualities in the donkey; both being supplied from the same storehouse, mother.[or]Nature; and consequently, they would naturally maintain an affinity, and the ugliest phase of the donkey in her dreams are nothing but woman's nature being sounded for her warning, or vice versa.[or]when pleasure is just before her.[cycling]"
"a"	"dragon"	"[one of]To dream of a dragon, denotes that you allow yourself to be governed by your passions, and that you are likely to place yourself in the power of your enemies through those outbursts of sardonic tendencies.[or]You should be warned by this dream to cultivate self-control.[cycling]"
"a"	"dromedary"	"[one of]To dream of a dromedary, denotes that you will be the recipient of unexpected beneficence, and will wear your new honors with dignity; you will dispense charity with a gracious hands.[or]To lovers, this dream foretells congenial dispositions.[cycling]"
"a"	"dulcimer"	"[one of]To dream of a dulcimer, denotes that the highest wishes in life will be attained by exalted qualities of mind.[or]To women, this is significant of a life free from those petty jealousies which usually make women unhappy.[cycling]"
"a"	"dunghill"	"[one of]To dream of a dunghill, you will see profits coming in through the most unexpected sources.[or]To the farmer this is a lucky dream, indicating fine seasons and abundant products from soil and stock.[or]For a young woman, it denotes that she will unknowingly marry a man of great wealth.[cycling]"
"a"	"dynamo"	"[one of]To dream of a dynamo, omens successful enterprises if attention is shown to details of business.[or]One out of repair, shows you are nearing enemies who will involve you in trouble.[cycling]"
"a"	"fairy"	"[one of]To dream of a fairy, is a favorable omen to all classes, as it is always a scene with a beautiful face portrayed as a happy child, or woman.[cycling]"
"a"	"falcon"	"[one of]To dream of a falcon, denotes that your prosperity will make you an object of envy and malice.[or]For a young woman, this dream denotes that she will be calumniated by a rival.[cycling]"
"a"	"famine"	"[one of]To dream of a famine, foretells that your business will be unremunerative and sickness will prove a scourge.[or]This dream is generally bad.[or]If you see your enemies perishing by famine, you will be successful in competition.[or]If dreams of famine should break in wild confusion over slumbers, tearing up all heads in anguish, filling every soul with care, hauling down.[or]Hope's banners, somber with omens of misfortune and despair, your waking grief more poignant still must grow ere you quench ambition and en{??}y{envy??} overthrow.[cycling]"
"a"	"pig"	"[one of]To dream of a fat, healthy pig, denotes reasonable success in affairs.[or]If they are wallowing in mire, you will have hurtful associates, and your engagements will be subject to reproach.[or]This dream will bring to a young woman a jealous and greedy companion though the chances are that he will be wealthy.[cycling]"
"a"	"feast"	"[one of]To dream of a feast, foretells that pleasant surprises are being planned for you.[or]To see disorder or misconduct at a feast, foretells quarrels or unhappiness through the negligence or sickness of some person.[or]To arrive late at a feast, denotes that vexing affairs will occupy you.[cycling]"
"a"	"fiddle"	"[one of]To dream of a fiddle, foretells harmony in the home and many joyful occasions abroad.[or]If you dream that you are playing on a fiddle or hearing the music of one it is a sign you will soon attend a funeral.[or]Such a dream is a bad omen to girls as it points to the death of a lover or of some dear friend.[cycling]"
"a"	"forehead"	"[one of]To dream of a fine and smooth forehead, denotes that you will be thought well of for your judgment and fair dealings.[or]An ugly forehead, denotes displeasure in your private affairs.[or]To pass your hand over the forehead of your child, indicates sincere praises from friends, because of some talent and goodness displayed by your children.[or]For a young woman to dream of kissing the forehead of her lover, signifies that he will be displeased with her for gaining notice by indiscreet conduct.[cycling]"
"a"	"fire budget"	"[one of]To dream of a fire budget, denotes disagreement over small matters.[cycling]"
"a"	"firebrand"	"[one of]To dream of a firebrand, denotes favorable fortune, if you are not burned or distressed by it.[cycling]"
"a"	"fish-net"	"[one of]To dream of a fish-net, portends numerous small pleasures and gains.[or]A torn one, represents vexatious disappointments.[cycling]"
"a"	"fish-pond"	"[one of]To dream of a fish-pond, denotes illness through dissipation, if muddy.[or]To see one clear and well stocked with fish, portends profitable enterprises and extensive pleasures.[or]To see one empty, proclaims the near approach of deadly enemies.[or]For a young woman to fall into a clear pond, omens decided good fortune and reciprocal love.[or]If muddy, the opposite is foretold.[cycling]"
"a"	"fisherman"	"[one of]To dream of a fisherman, denotes you are nearing times of greater prosperity than you have yet known.[cycling]"
"a"	"flood"	"[one of]To dream of a flood generally denotes riches and plenty particularly if the water is calm it shows that though you may lose something you will be fortunate in other ways sufficient to counterbalance it.[cycling]"
"a"	"foal"	"[one of]To dream of a foal, indicates new undertakings in which you will be rather fortunate.[cycling]"
"a"	"fork"	"[one of]To dream of a fork indicates that a false friend will attempt your ruin by flattery.[cycling]"
"a"	"fork"	"[one of]To dream of a fork, denotes that enemies are working for your displacement.[or]For a woman, this dream denotes unhappy domestic relations, and separation for lovers.[cycling]"
"a"	"grave"	"[one of]To dream of a fresh made grave is a sign of losses: a man of business will probably lose money that is owing to him.[or]But to lovers this sign is apt to be a 'grave to their dearest hopes:''grave to their dearest hopes:' such a dream is decidedly a bad one for them.[cycling]"
"an"	"elopement"	"[one of]To dream of a friend’s elopement, signifies marriage against the wishes of your friends, and unhappiness.[or]To dream of your own elopement, betokens entering into ruinous speculations in love or business.[cycling]"
"a"	"fruit seller"	"[one of]To dream of a fruit seller, denotes you will endeavor to recover your loss too rapidly and will engage in unfortunate speculations.[cycling]"
"a"	"cash box"	"[one of]To dream of a full cash box, denotes that favorable prospects will open around you.[or]If empty, you will experience meager reimbursements.[cycling]"
"a"	"trunk"	"[one of]To dream of a full trunk shows the necessity of economy; an empty one signifies that you may expect to receive money.[cycling]"
"a"	"furnace"	"[one of]To dream of a furnace, foretells good luck if it is running.[or]If out of repair, you will have trouble with children or hired help.[or]To fall into one, portends some enemy will overpower you in a business struggle.[cycling]"
"a"	"gavel"	"[one of]To dream of a gavel, denotes you will be burdened with some unprofitable yet not unpleasant pursuit.[or]To use one, denotes that officiousness will be shown by you toward your friends.[cycling]"
"a"	"rain"	"[one of]To dream of a gentle rain is a good omen as it foretells success in any undertaking: if you dream of a violent rain-storm accompanied by wind and thunder and lightning it predicts much trouble and misfortune though ultimate success in your undertakings.[cycling]"
"a"	"giant"	"[one of]To dream of a giant appearing suddenly before you, denotes that there will be a great struggle between you and your opponents.[or]If the giant succeeds in stopping your journey, you will be overcome by your enemy.[or]If he runs from you, prosperity and good health will be yours.[cycling]"
"a"	"guardian"	"[one of]To dream of a guardian, denotes you will be treated with consideration by your friends.[or]For a young woman to dream that she is being unkindly dealt with by her guardian, foretells that she will have loss and trouble in the future.[cycling]"
"a"	"gutter"	"[one of]To dream of a gutter, is a sign of degradation.[or]You will be the cause of unhappiness to others.[or]To find articles of value in a gutter, your right to certain property will be questioned.[cycling]"
"a"	"gymnast"	"[one of]To dream of a gymnast, denotes you will have misfortune in speculation or trade.[cycling]"
"a"	"hail"	"[one of]To dream of a hail-storm is a sign that you will make a good bargain or will be lucky in some undertaking provided the hail is white or in crystals; black hail denotes sorrow and death therefore you should never dream of that kind of hail if you can help it.[or]To dream of seeing white hail lying on the ground intimates that you’ll soon get plenty of cash in some transaction.[cycling]"
"a"	"pudding"	"[one of]To dream of a hard-boiled plum pudding or a hard roll of pudding of any kind is a sign you will be invited to a dinner party; but if you imagine the pudding looks soft and mussy it foretells that you will go to some entertainment where there will be a row.[cycling]"
"a"	"harlequin"	"[one of]To dream of a harlequin cheating you, you will find uphill work to identify certain claims that promise profit to you.[or]If you dream of a harlequin, trouble will beset you.[or]To be dressed as a harlequin, denotes passionate error and unwise attacks on strength and purse.[or]Designing women will lure you to paths of sin.[cycling]"
"a"	"harvest"	"[one of]To dream of a harvest field is a good omen.[or]If you dream you are working in one it indicates success in business.[or]To lovers this is one of the most fortunate signs; to a young man it signifies he will wed a rich and beautiful bride; to a young maiden it is a sign she will soon be engaged to the object of her affections; to the married it signifies domestic bliss.[cycling]"
"a"	"hassock"	"[one of]To dream of a hassock, forebodes the yielding of your power and fortune to another.[or]If a woman dreams of a hassock, she should cultivate spirit and independence.[cycling]"
"a"	"hawk"	"[one of]To dream of a hawk, foretells you will be cheated in some way by intriguing persons.[or]To shoot one, foretells you will surmount obstacles after many struggles.[or]For a young woman to frighten hawks away from her chickens, signifies she will obtain her most extravagant desires through diligent attention to her affairs.[or]It also denotes that enemies are near you, and they are ready to take advantage of your slightest mistakes.[or]If you succeed in scaring it away before your fowls are injured, you will be lucky in your business.[or]To see a dead hawk, signifies that your enemies will be vanquished.[or]To dream of shooting at a hawk, you will have a contest with enemies, and will probably win.[cycling]"
"a"	"hearse"	"[one of]To dream of a hearse, denotes uncongenial relations in the home, and failure to carry on business in a satisfactory manner.[or]It also betokens the death of one near to you, or sickness and sorrow.[or]If a hearse crosses your path, you will have a bitter enemy to overcome.[cycling]"
"a"	"heart"	"[one of]To dream of a heart is a bad omen.[or]If you lose your heart it signifies sickness and death.[or]To the married it denotes infidelity of their marital vows.[or]To dream you see a human heart shows you are sincerely beloved; but to dream you have a pain or palpitation in your heart showsyou are doomed to suffer through treachery.[cycling]"
"a"	"chicken"	"[one of]To dream of a hen or chicken signifies losses in trade and deceit in love.[cycling]"
"a"	"hermit"	"[one of]To dream of a hermit, denotes sadness and loneliness caused by the unfaithfulness of friends.[or]If you are a hermit yourself, you will pursue researches into intricate subjects, and will take great interest in the discussions of the hour.[or]To find yourself in the abode of a hermit, denotes unselfishness toward enemies and friends alike.[cycling]"
"a"	"high school"	"[one of]To dream of a high school, foretells ascension to more elevated positions in love, as well as social and business affairs.[or]For a young woman to be suspended from a high school, foretells she will have troubles in social circles.[cycling]"
"a"	"holiday"	"[one of]To dream of a holiday, foretells interesting strangers will soon partake of your hospitality.[or]For a young woman to dream that she is displeased with a holiday, denotes she will be fearful of her own attractions in winning a friend back from a rival.[cycling]"
"a"	"hook"	"[one of]To dream of a hook, foretells unhappy obligations will be assumed by you.[cycling]"
"a"	"hoop"	"[one of]To dream of a hoop, foretells you will form influential friendships.[or]Many will seek counsel of you.[or]To jump through, or see others jumping through hoops, denotes you will have discouraging outlooks, but you will overcome them with decisive victory.[cycling]"
"a"	"hornet"	"[one of]To dream of a hornet, signals disruption to lifelong friendship, and loss of money.[or]For a young woman to dream that one stings her, or she is in a nest of them, foretells that many envious women will seek to disparage her before her admirers.[cycling]"
"a"	"horse-trader"	"[one of]To dream of a horse-trader, signifies great profit from perilous ventures.[or]To dream that you are trading horses, and the trader cheats you, you will lose in trade or love.[or]If you get a better horse than the one you traded, you will better yourself in fortune.[cycling]"
"a"	"horseshoe"	"[one of]To dream of a horseshoe, indicates advance in business and lucky engagements for women.[or]To see them broken, ill fortune and sickness is portrayed.[or]To find a horseshoe hanging on the fence, denotes that your interests will advance beyond your most sanguine expectations.[or]To pick one up in the road, you will receive profit from a source you know not of.[cycling]"
"a"	"hunchback"	"[one of]To dream of a hunchback, denotes unexpected reverses in your prospects.[cycling]"
"a"	"hut"	"[one of]To dream of a hut, denotes indifferent success.[or]To dream that you are sleeping in a hut, denotes ill health and dissatisfaction.[or]To see a hut in a green pasture, denotes prosperity, but fluctuating happiness.[cycling]"
"a"	"janitor"	"[one of]To dream of a janitor, denotes bad management and disobedient children.[or]Unworthy servants will annoy you.[or]To look for a janitor and fail to find him, petty annoyances will disturb your otherwise placid existence.[or]If you find him, you will have pleasant associations with strangers, and your affairs will have no hindrances.[cycling]"
"a"	"jay-bird"	"[one of]To dream of a jay-bird, foretells pleasant visits from friends and interesting gossips.[or]To catch a jay-bird, denotes pleasant, though unfruitful, tasks.[or]To see a dead jay-bird, denotes domestic unhappiness and many vicissitudes.[cycling]"
"a"	"jester"	"[one of]To dream of a jester, foretells you will ignore important things in looking after silly affairs.[cycling]"
"a"	"jew's-harp"	"[one of]To dream of a Jew's-harp, foretells you will experience a slight improvement in your affairs.[or]To play one, is a sign that you will fall in love with a stranger.[cycling]"
"a"	"jockey"	"[one of]To dream of a jockey, omens you will appreciate a gift from an unexpected source.[or]For a young woman to dream that she associates with a jockey, or has one for a lover, indicates she will win a husband out of her station.[or]To see one thrown from a horse, signifies you will be called on for aid by strangers.[cycling]"
"a"	"journeyman"	"[one of]To dream of a journeyman, denotes you are soon to lose money by useless travels.[or]For a woman, this dream brings pleasant trips, though unexpected ones.[cycling]"
"a"	"jubilee"	"[one of]To dream of a jubilee, denotes many pleasureable enterprises in which you will be a participant.[or]For a young woman, this is a favorable dream, pointing to matrimony and increase of temporal blessings.[or]To dream of a religious jubilee, denotes close but comfortable environments.[cycling]"
"a"	"jumping-jack"	"[one of]To dream of a jumping-jack, denotes that idleness and trivial pastimes will occupy your thoughts to the exclusion of serious and sustaining plans.[cycling]"
"a"	"keg"	"[one of]To dream of a keg, denotes you will have a struggle to throw off oppression.[or]Broken ones, indicate separation from family or friends.[cycling]"
"a"	"kid"	"[one of]To dream of a kid, denotes you will not be over-scrupulous in your morals or pleasures.[or]You will be likely to bring grief to some loving heart.[cycling]"
"a"	"spade"	"[one of]To dream of a kind of shovel called spade, denotes that you will have work to complete, which will give you much annoyance in superintending.[or]If you dream of cards named spades, you will be enticed into follies which will bring you grief and misfortune.[or]For a gambler to dream that spades are trumps, means that unfortunate deals will deplete his winnings.[cycling]"
"a"	"king"	"[one of]To dream of a king denotes that the dreamer is ambitious and will be disappointed.[or]If you dream you speak to a king it is a happy omen and is a sign of riches and honor.[cycling]"
"a"	"king"	"[one of]To dream of a king, you are struggling with your might, and ambition is your master.[or]To dream that you are crowned king, you will rise above your comrades and co-workers.[or]If you are censured by a king, you will be reproved for a neglected duty.[or]For a young woman to be in the presence of a king, she will marry a man whom she will fear.[or]To receive favors from a king, she will rise to exalted positions and be congenially wedded.[cycling]"
"a"	"kitchen"	"[one of]To dream of a kitchen, denotes you will be forced to meet emergencies which will depress your spirits.[or]For a woman to dream that her kitchen is clear and orderly, foretells she will become the mistress of interesting fortunes.[cycling]"
"a"	"knife grinder"	"[one of]To dream of a knife grinder, foretells unwarrantable liberties will be taken with your possessions.[or]For a woman, this omens unhappy unions and much drudgery.[cycling]"
"a"	"knife"	"[one of]To dream of a knife is bad for the dreamer, as it portends separation and quarrels, and losses in affairs of a business character.[or]To see rusty knives, means dissatisfaction, and complaints of those in the home, and separation of lovers.[or]Sharp knives and highly polished, denotes worry.[or]Foes are ever surrounding you.[or]Broken knives, denotes defeat whatever the pursuit, whether in love or business.[or]To dream that you are wounded with a knife, foretells domestic troubles, in which disobedient children will figure largely.[or]To the unmarried, it denotes that disgrace may follow.[or]To dream that you stab another with a knife, denotes baseness of character, and you should strive to cultivate a higher sense of right.[cycling]"
"a"	"label"	"[one of]To dream of a label, foretells you will let an enemy see the inside of your private affairs, and will suffer from the negligence.[cycling]"
"a"	"ladder"	"[one of]To dream of a ladder being raised for you to ascend to some height, your energetic and nervy qualifications will raise you into prominence in business affairs.[or]To ascend a ladder, means prosperity and unstinted happiness.[or]To fall from one, denotes despondency and unsuccessful transactions to the tradesman, and blasted crops to the farmer.[or]To see a broken ladder, betokens failure in every instance.[or]To descend a ladder, is disappointment in business, and unrequited desires.[or]To escape from captivity, or confinement, by means of a ladder, you will be successful, though many perilous paths may intervene.[or]To grow dizzy as you ascend a ladder, denotes that you will not wear new honors serenely.[or]You are likely to become haughty and domineering in your newly acquired position.[cycling]"
"a"	"lagoon"	"[one of]To dream of a lagoon, denotes that you will be drawn into a whirlpool of doubt and confusion through misapplication of your intelligence.[cycling]"
"a"	"lance"	"[one of]To dream of a lance, denotes formidable enemies and injurious experiments.[or]To be wounded by a lance, error of judgment will cause you annoyance.[or]To break a lance, denotes seeming impossibilities will be overcome and your desires will be fulfilled.[cycling]"
"a"	"lap-dog"	"[one of]To dream of a lap-dog, foretells you will be succored by friends in some approaching dilemma.[or]If it be thin and ill-looking, there will be distressing occurrences to detract from your prospects.[cycling]"
"a"	"lap-robe"	"[one of]To dream of a lap-robe, indicates suspicious engagements will place you under the surveillance of enemies or friends.[or]To lose one, your actions will be condemned by enemies to injure your affairs.[cycling]"
"a"	"manufactory"	"[one of]To dream of a large manufactory, denotes unusual activity in business circles.[cycling]"
"a"	"crowd"	"[one of]To dream of a large, handsomely dressed crowd of people at some entertainment, denotes pleasant association with friends; but anything occurring to mar the pleasure of the guests, denotes distress and loss of friendship, and unhappiness will be found where profit and congenial intercourse was expected.[or]It also denotes dissatisfaction in government and family dissensions.[or]To see a crowd in a church, denotes that a death will be likely to affect you, or some slight unpleasantness may develop.[or]To see a crowd in the street, indicates unusual briskness in trade and a general air of prosperity will surround you.[or]To try to be heard in a crowd, foretells that you will push your interests ahead of all others.[or]To see a crowd is usually good, if too many are not wearing black or dull costumes.[or]To dream of seeing a hypnotist trying to hypnotize others, and then turn his attention on you, and fail to do so, indicates that a trouble is hanging above you which friends will not succeed in warding off.[or]Yourself alone can avert the impending danger.[cycling]"
"a"	"latch"	"[one of]To dream of a latch, denotes you will meet urgent appeals for aid, to which you will respond unkindly.[or]To see a broken latch, foretells disagreements with your dearest friend.[or]Sickness is also foretold in this dream.[cycling]"
"a"	"leap year"	"[one of]To dream of a leap year is one of the best and most lucky dreams.[or]Everything you undertake about this time will prosper and your efforts will be fourfold successful.[or]It is like good to male and female.[cycling]"
"a"	"leopard"	"[one of]To dream of a leopard attacking you, denotes that while the future seemingly promises fair, success holds many difficulties through misplaced confidence.[or]To kill one, intimates victory in your affairs.[or]To see one caged, denotes that enemies will surround but fail to injure you.[or]To see leopards in their native place trying to escape from you, denotes that you will be embarrassed in business or love, but by persistent efforts you will overcome difficulties.[or]To dream of a leopard's skin, denotes that your interests will be endangered by a dishonest person who will win your esteem.[cycling]"
"a"	"lettercarrier"	"[one of]To dream of a letter carrier indicates you will hear from an absent one whom you love.[cycling]"
"a"	"license"	"[one of]To dream of a license, is an omen of disputes and loss.[or]Married women will exasperate your cheerfulness.[or]For a woman to see a marriage license, foretells that she will soon enter unpleasant bonds, which will humiliate her pride.[cycling]"
"a"	"lily"	"[one of]To dream of a lily, denotes much chastisement through illness and death.[or]To see lilies growing with their rich foliage, denotes early marriage to the young and subsequent separation through death.[or]To see little children among the flowers, indicates sickness and fragile constitutions to these little ones.[or]For a young woman to dream of admiring, or gathering, lilies, denotes much sadness coupled with joy, as the one she loves will have great physical suffering, if not an early dissolution.[or]If she sees them withered, sorrow is even nearer than she could have suspected.[or]To dream that you breathe the fragrance of lilies, denotes that sorrow will purify and enhance your mental qualities.[cycling]"
"a"	"lime-kiln"	"[one of]To dream of a lime-kiln, foretells the immediate future holds no favor for speculations in love or business.[cycling]"
"a"	"lion"	"[one of]To dream of a lion, signifies that a great force is driving you.[or]If you subdue the lion, you will be victorious in any engagement.[or]If it overpowers you, then you will be open to the successful attacks of enemies.[or]To see caged lions, denotes that your success depends upon your ability to cope with opposition.[or]To see a man controlling a lion in its cage, or out denotes success in business and great mental power.[or]You will be favorably regarded by women.[or]To see young lions, denotes new enterprises, which will bring success if properly attended.[or]For a young woman to dream of young lions, denotes new and fascinating lovers.[or]For a woman to dream that she sees.[or]Daniel in the lions' den, signifies that by her intellectual qualifications and personal magnetism she will win fortune and lovers to her highest desire.[or]To hear the roar of a lion, signifies unexpected advancement and preferment with women.[or]To see a lion's head over you, showing his teeth by snarls, you are threatened with defeat in your upward rise to power.[or]To see a lion's skin, denotes a rise to fortune and happiness.[or]To ride one, denotes courage and persistency in surmounting difficulties.[or]To dream you are defending your children from a lion with a pen-knife, foretells enemies will threaten to overpower you, and will well nigh succeed if you allow any artfulness to persuade you for a moment from duty and business obligations.[cycling]"
"a"	"loadstone"	"[one of]To dream of a loadstone, denotes you will make favorable opportunities for your own advancement in a material way.[or]For a young woman to think a loadstone is attracting her, is an omen of happy changes in her family.[cycling]"
"a"	"lock"	"[one of]To dream of a lock, denotes bewilderment.[or]If the lock works at your command, or efforts, you will discover that some person is working you injury.[or]If you are in love, you will find means to aid you in overcoming a rival; you will also make a prosperous journey.[or]If the lock resists your efforts, you will be derided and scorned in love and perilous voyages will bring to you no benefit.[or]To put a lock upon your fiance'e's neck and arm, foretells that you are distrustful of her fidelity, but future episodes will disabuse your mind of doubt.[cycling]"
"a"	"locomotive"	"[one of]To dream of a locomotive running with great speed, denotes a rapid rise in fortune, and foreign travel.[or]If it is disabled, then many vexations will interfere with business affairs, and anticipated journeys will be laid aside through the want of means.[or]To see one completely demolished, signifies great distress and loss of property.[or]To hear one coming, denotes news of a foreign nature.[or]Business will assume changes that will mean success to all classes.[or]To hear it whistle, you will be pleased and surprised at the appearance of a friend who has been absent, or an unexpected offer, which means preferment to you.[cycling]"
"a"	"lottery"	"[one of]To dream of a lottery, and that you are taking great interest in the drawing, you will engage in some worthless enterprise, which will cause you to make an unpropitious journey.[or]If you hold the lucky number, you will gain in a speculation which will perplex and give you much anxiety.[or]To see others winning in a lottery, denotes convivialities and amusements, bringing many friends together.[or]If you lose in a lottery, you will be the victim of designing persons.[or]Gloomy depressions in your affairs will result.[or]For a young woman to dream of a lottery in any way, denotes that her careless way of doing things will bring her disappointment, and a husband who will not be altogether reliable or constant.[or]To dream of a lottery, denotes you will have unfavorable friendships in business.[or]Your love affairs will produce temporary pleasure.[cycling]"
"a"	"louse"	"[one of]To dream of a louse, foretells that you will have uneasy feelings regarding your health, and an enemy will give you exasperating vexation.[cycling]"
"a"	"magistrate"	"[one of]To dream of a magistrate, foretells that you will be harassed with threats of law suits and losses in your business.[or]Judge and.[cycling]"
"a"	"magnet"	"[one of]To dream of a magnet, denotes that evil influences will draw you from the path of honor.[or]A woman is probably luring you to ruin.[or]To a woman, this dream foretells that protection and wealth will be showered upon her.[cycling]"
"a"	"magpie"	"[one of]To dream of a magpie, denotes much dissatisfaction and quarrels.[or]The dreamer should guard well his conduct and speech after this dream.[cycling]"
"a"	"mallet"	"[one of]To dream of a mallet, denotes you will meet unkind treatment from friends on account of your ill health.[or]Disorder in the home is indicated.[cycling]"
"a"	"mant"	"[one of]To dream of a man dressed in black is lucky; in white a bad omen: to dream of a murdered man is a sign of long life.[or]To dream you meet a strange man is a sign you have a vindictive enemy.[or]For a girl to dream she sees her lover by her bedside is a sign he will attempt some very improper things.[cycling]"
"a"	"man-of-war"	"[one of]To dream of a man-of-war, denotes long journeys and separation from country and friends, dissension in political affairs is portended.[or]If she is crippled, foreign elements will work damage to home interests.[or]If she is sailing upon rough seas, trouble with foreign powers may endanger private affairs.[or]Personal affairs may also go awry.[cycling]"
"a"	"man"	"[one of]To dream of a man, if handsome, well formed and supple, denotes that you will enjoy life vastly and come into rich possessions.[or]If he is misshapen and sour-visaged, you will meet disappointments and many perplexities will involve you.[or]For a woman to dream of a handsome man, she is likely to have distinction offered her.[or]If he is ugly, she will experience trouble through some one whom she considers a friend.[cycling]"
"a"	"map"	"[one of]To dream of a map, or studying one, denotes a change will be contemplated in your business.[or]Some disappointing things will occur, but much profit also will follow the change.[or]To dream of looking for one, denotes that a sudden discontent with your surroundings will inspire you with new energy, and thus you will rise into better conditions.[or]For a young woman, this dream denotes that she will rise into higher spheres by sheer ambition.[cycling]"
"a"	"marble"	"[one of]To dream of a marble quarry, denotes that you life will be a financial success, but that your social surroundings will be devoid of affection.[or]To dream of polishing marble, you will come into a pleasing inheritance.[or]To see it broken, you will fall into disfavor among your associates by defying all moral codes.[cycling]"
"a"	"mausoleum"	"[one of]To dream of a mausoleum, indicates the sickness, death, or trouble of some prominent friend.[or]To find yourself inside a mausoleum, foretells your own illness.[cycling]"
"a"	"mechanic"	"[one of]To dream of a mechanic, denotes change in your dwelling place and a more active business.[or]Advancement in wages usually follows after seeing mechanics at work on machinery.[cycling]"
"a"	"memorial"	"[one of]To dream of a memorial, signifies there will be occasion for you to show patient kindness, as trouble and sickness threatens your relatives.[cycling]"
"a"	"microscope"	"[one of]To dream of a microscope, denotes you will experience failure or small returns in your enterprises.[cycling]"
"a"	"mill"	"[one of]To dream of a mill, indicates thrift and fortunate undertakings.[or]To see a dilapidated mill, denotes sickness and ill fortune.[or]Mill, etc.[cycling]"
"a"	"minx"	"[one of]To dream of a minx, denotes you will have sly enemies to overcome.[or]If you kill one, you will win your desires.[or]For a young woman to dream that she is partial to minx furs, she will find protection and love in some person who will be inordinately jealous.[cycling]"
"a"	"miser"	"[one of]To dream of a miser is a sign of waste loss or destruction: if you see him counting and hoarding money it foretells you will either lose or be robbed of some: to see him patching his clothes or his house or barn denotes a calamity such as a robbery or a fire.[cycling]"
"a"	"miser"	"[one of]To dream of a miser, foretells you will be unfortunate in finding true happiness owing to selfishness, and love will disappoint you sorely.[or]For a woman to dream that she is befriended by a miser, foretells she will gain love and wealth by her intelligence and tactful conduct.[or]To dream that you are miserly, denotes that you will be obnoxious to others by your conceited bearing.[or]To dream that any of your friends are misers, foretells that you will be distressed by the importunities of others.[cycling]"
"a"	"monkey"	"[one of]To dream of a monkey, denotes that deceitful people will flatter you to advance their own interests.[or]To see a dead monkey, signifies that your worst enemies will soon be removed.[or]If a young woman dreams of a monkey, she should insist on an early marriage, as her lover will suspect unfaithfulness.[or]For a woman to dream of feeding a monkey, denotes that she will be betrayed by a flatterer.[cycling]"
"a"	"museum"	"[one of]To dream of a museum, denotes you will pass through many and varied scenes in striving for what appears your rightful position.[or]You will acquire useful knowledge, which will stand you in better light than if you had pursued the usual course to learning.[or]If the museum is distasteful, you will have many causes for vexation.[cycling]"
"a"	"napkin"	"[one of]To dream of a napkin, foretells convivial entertainments in which you will figure prominently.[or]For a woman to dream of soiled napkins, foretells that humiliating affairs will thrust themselves upon her.[cycling]"
"a"	"necromancer"	"[one of]To dream of a necromancer and his arts, denotes that you are threatened with strange acquaintances who will influence you for evil.[cycling]"
"a"	"notary"	"[one of]To dream of a notary, is a prediction of unsatisfied desires, and probable lawsuits.[or]For a woman to associate with a notary, foretells she will rashly risk her reputation, in gratification of foolish pleasure.[cycling]"
"a"	"pall-bearer"	"[one of]To dream of a pall-bearer, indicates some enemy will provoke your ill feeling, by constant attacks on your integrity.[or]If you see a pall-bearer, you will antagonize worthy institutions, and make yourself obnoxious to friends.[cycling]"
"a"	"pallet"	"[one of]To dream of a pallet, denotes that you will suffer temporary uneasiness over your love affairs.[or]For a young woman, it is a sign of a jealous rival.[cycling]"
"a"	"panorama"	"[one of]To dream of a panorama, denotes that you will change your occupation or residence.[or]You should curb your inclinations for change of scene and friends.[cycling]"
"a"	"parade"	"[one of]To dream of a parade of soldiers and that you are delighted with the military display foretells that some one will deceive you: to a business man it is an omen of losses by bad debts or dull trade: to a young girl it foreshadows a gay but false lover: to a married woman it is a sign that her husband though kind will be false to his vows.[cycling]"
"a"	"parasol"	"[one of]To dream of a parasol, denotes, for married people, illicit enjoyments.[or]If a young woman has this dream, she will engage in many flirtations, some of which will cause her interesting disturbances, lest her lover find out her inclinations.[cycling]"
"a"	"parcel"	"[one of]To dream of a parcel being delivered to you, denotes that you will be pleasantly surprised by the return of some absent one, or be cared for in a worldly way.[or]If you carry a parcel, you will have some unpleasant task to perform.[or]To let a parcel fall on the way as you go to deliver it, you will see some deal fail to go through.[cycling]"
"a"	"password"	"[one of]To dream of a password, foretells you will have influential aid in some slight trouble soon to attack you.[or]For a woman to dream that she has given away the password, signifies she will endanger her own standing through seeking frivolous or illicit desires.[cycling]"
"a"	"lake"	"[one of]To dream of a peaceful lake, denotes content.[or]To dream of gazing into a lake, denotes an access of fortune from an unexpected source.[or]To dream of floating on a lake, signifies to glide through life without trouble and with many friends.[cycling]"
"a"	"peddler"	"[one of]To dream of a peddler, signifies that you have a false estimate of your friends’ value, and that time will show them to be hypocrites.[cycling]"
"a"	"pelican"	"[one of]To dream of a pelican, denotes a mingling of disappointments with successes.[or]To catch one, you will be able to overcome disappointing influences.[or]To kill one, denotes that you will cruelly set aside the rights of others.[or]To see them flying, you are threatened with changes, which will impress you with ideas of uncertainty as to good.[cycling]"
"a"	"pen-knife"	"[one of]To dream of a pen-knife is a bad omen and foretells loss in trade attacks by thieves and unfaithfulness in love.[cycling]"
"a"	"pen"	"[one of]To dream of a pen, foretells you are unfortunately being led into serious complications by your love of adventure.[or]If the pen refuses to write, you will be charged with a serious breach of morality.[cycling]"
"a"	"penitentiary"	"[one of]To dream of a penitentiary, denotes you will have engagements which will, unfortunately, result in your loss.[or]To be an inmate of one, foretells discontent in the home and failing business.[or]To escape from one, you will overcome difficult obstacles.[cycling]"
"a"	"physician"	"[one of]To dream of a physician, signifies good in many forms; if he is relieving you, you have made a favorable impression where you most desire it; if, as a friend, you meet him in society, look for true, happy love.[cycling]"
"a"	"pickaxe"	"[one of]To dream of a pickaxe, denotes a relentless enemy is working to overthrow you socially.[or]A broken one, implies disaster to all your interests.[cycling]"
"a"	"pickpocket"	"[one of]To dream of a pickpocket, foretells some enemy will succeed in harassing and causing you loss.[or]For a young woman to have her pocket picked, denotes she will be the object of some person's envy and spite, and may lose the regard of a friend through these evil machinations, unless she keeps her own counsel.[or]If she picks others' pockets, she will incur the displeasure of a companion by her coarse behavior.[cycling]"
"a"	"pillow"	"[one of]To dream of a pillow, denotes luxury and comfort.[or]For a young woman to dream that she makes a pillow, she will have encouraging prospects of a pleasant future.[cycling]"
"a"	"pitcher"	"[one of]To dream of a pitcher, denotes that you will be of a generous and congenial disposition.[or]Success will attend your efforts.[or]A broken pitcher, denotes loss of friends.[cycling]"
"a"	"plague"	"[one of]To dream of a plague raging, denotes disappointing returns in business, and your wife or lover will lead you a wretched existence.[or]If you are afflicted with the plague, you will keep your business out of embarrassment with the greatest maneuvering.[or]If you are trying to escape it, some trouble, which looks impenetrable, is pursuing you.[cycling]"
"a"	"planet"	"[one of]To dream of a planet, foretells an uncomfortable journey and depressing work.[cycling]"
"a"	"plow"	"[one of]To dream of a plow, signifies unusual success, and affairs will reach a pleasing culmination.[or]To see persons plowing, denotes activity and advancement in knowledge and fortune.[or]For a young woman to see her lover plowing, indicates that she will have a noble and wealthy husband.[or]Her joys will be deep and lasting.[or]To plow yourself, denotes rapid increase in property and joys.[cycling]"
"a"	"pole-cat"	"[one of]To dream of a pole-cat, signifies salacious scandals.[or]To inhale the odor of a pole-cat on your clothes, or otherwise smell one, you will find that your conduct will be considered rude, and your affairs will prove unsatisfactory.[or]To kill one, denotes that you will overcome formidable obstacles.[cycling]"
"a"	"politician"	"[one of]To dream of a politician, denotes displeasing companionships, and incidences where you will lose time and means.[or]If you engage in political wrangling, it portends that misunderstandings and ill feeling will be shown you by friends.[or]For a young woman to dream of taking interest in politics, warns her against designing duplicity,.[cycling]"
"a"	"porch"	"[one of]To dream of a porch, denotes that you will engage a new undertakings, and the future will be full of uncertainties.[or]If a young woman dreams that she is with her lover on a porch, implies her doubts of some one's intentions.[or]To dream that you build a porch, you will assume new duties.[cycling]"
"a"	"portfolio"	"[one of]To dream of a portfolio, denotes that your employment will not be to your liking, and you will seek a change in your location.[cycling]"
"a"	"post-office"	"[one of]To dream of a post-office, is a sign of unpleasant tidings and ill luck generally.[cycling]"
"a"	"postman"	"[one of]To dream of a postman, denotes that hasty news will more frequently be of a distressing nature than otherwise.[cycling]"
"a"	"pot"	"[one of]To dream of a pot, foretells that unimportant events will work you vexation.[or]For a young woman to see a boiling pot, omens busy employment of pleasant and social duties.[or]To see a broken or rusty one, implies that keen disappointment will be experienced by you.[cycling]"
"a"	"potter"	"[one of]To dream of a potter, denotes constant employment, with satisfactory results.[or]For a young woman to see a potter, foretells she will enjoy pleasant engagements.[cycling]"
"a"	"prairie"	"[one of]To dream of a prairie, denotes that you will enjoy ease, and even luxury and unobstructed progress.[or]An undulating prairie, covered with growing grasses and flowers, signifies joyous happenings.[or]A barren prairie, represents loss and sadness through the absence of friends.[or]To be lost on one, is a sign of sadness and ill luck.[cycling]"
"a"	"preacher"	"[one of]To dream of a preacher, denotes that your ways are not above reproach, and your affairs will not move evenly.[or]To dream that you are a preacher, foretells for you losses in business, and distasteful amusements will jar upon you.[or]To hear preaching, implies that you will undergo misfortune.[or]To argue with a preacher, you will lose in some contest.[or]To see one walk away from you, denotes that your affairs will move with new energy.[or]If he looks sorrowful, reproaches will fall heavily upon you.[or]To see a long-haired preacher, denotes that you are shortly to have disputes with overbearing and egotistical people.[cycling]"
"a"	"prison"	"[one of]To dream of a prison, is the forerunner of misfortune in every instance, if it encircles your friends, or yourself.[or]To see any one dismissed from prison, denotes that you will finally overcome misfortune.[cycling]"
"a"	"procession"	"[one of]To dream of a procession, denotes that alarming fears will possess you relative to the fulfilment of expectations.[or]If it be a funeral procession, sorrow is fast approaching, and will throw a shadow around pleasures.[or]To see or participate in a torch-light procession, denotes that you will engage in gaieties which will detract from your real merit.[cycling]"
"a"	"riot"	"[one of]To dream of a public tumult or riot is a sign of scarcity and bad crops to farmers and dull business to tradesmen and mechanics: if any friend or relative is injured in the riot you or they will probably suffer from misfortune but if they are successful and pacify the crowd it foretells that you will overcome your difficulties.[cycling]"
"a"	"publican"	"[one of]To dream of a publican, denotes that you will have your sympathies aroused by some one in a desperate condition, and you will diminish your own gain for his advancement.[or]To a young woman, this dream brings a worthy lover; but because of his homeliness she will trample on his feelings unnecessarily.[cycling]"
"a"	"publisher"	"[one of]To dream of a publisher, foretells long journeys and aspirations to the literary craft.[or]If a woman dreams that her husband is a publisher, she will be jealous of more than one woman of his acquaintance, and spicy scenes will ensue.[or]For a publisher to reject your manuscript, denotes that you will suffer disappointment at the miscarriage of cherished designs.[or]If he accepts it, you will rejoice in the full fruition of your hopes.[or]If he loses it, you will suffer evil at the hands of strangers.[cycling]"
"a"	"pulpit"	"[one of]To dream of a pulpit, denotes sorrow and vexation.[or]To dream that you are in a pulpit, foretells sickness, and unsatisfactory results in business or trades of any character.[cycling]"
"a"	"quaker"	"[one of]To dream of a Quaker, denotes that you will have faithful friends and fair business.[or]If you are one, you will deport yourself honorably toward an enemy.[or]For a young woman to attend a Quaker meeting, portends that she will by her modest manners win a faithful husband who will provide well for her household.[cycling]"
"a"	"quartette"	"[one of]To dream of a quartette, and you are playing or singing, denotes favorable affairs, jolly companions, and good times.[or]To see or hear a quartette, foretells that you will aspire to something beyond you.[cycling]"
"a"	"quay"	"[one of]To dream of a quay, denotes that you will contemplate making a long tour in the near future.[or]To see vessels while standing on the quay, denotes the fruition of wishes and designs.[cycling]"
"a"	"queen"	"[one of]To dream of a queen, foretells succesful{sic} ventures.[or]If she looks old or haggard, there will be disappointments connected with your pleasures.[cycling]"
"a"	"raccoon"	"[one of]To dream of a raccoon, denotes you are being deceived by the friendly appearance of enemies.[cycling]"
"a"	"turf"	"[one of]To dream of a racing turf, signifies that you will have pleasure and wealth at your command, but your morals will be questioned by your most intimate friends.[or]To see a green turf, indicates that interesting affairs will hold your attention.[cycling]"
"a"	"rack"	"[one of]To dream of a rack, denotes the uncertainty of the outcome of some engagement which gives you much anxious thought.[cycling]"
"a"	"racket"	"[one of]To dream of a racket, denotes that you will be foiled in some anticipated pleasure.[or]For a young woman, this dream is ominous of disappointment in not being able to participate in some amusement that has engaged her attention.[cycling]"
"a"	"raft"	"[one of]To dream of a raft, denotes that you will go into new locations to engage in enterprises, which will prove successful.[or]To dream of floating on a raft, denotes uncertain journeys.[or]If you reach your destination, you will surely come into good fortune.[or]If a raft breaks, or any such mishap befalls it, yourself or some friend will suffer from an accident, or sickness will bear unfortunate results.[cycling]"
"a"	"ramrod"	"[one of]To dream of a ramrod, denotes unfortunate adventures.[or]You will have cause for grief.[or]For a young woman to see one bent or broken, foretells that a dear friend or lover will fail her.[cycling]"
"a"	"rattan cane"	"[one of]To dream of a rattan cane, foretells that you will depend largely upon the judgment of others, and you should cultivate independence in planning and executing your own affairs.[cycling]"
"a"	"raven"	"[one of]To dream of a raven, denotes reverse in fortune and inharmonious surroundings.[or]For a young woman, it is implied that her lover will betray her.[cycling]"
"a"	"razor"	"[one of]To dream of a razor, portends disagreements and contentions over troubles.[or]To cut yourself with one, denotes that you will be unlucky in some deal which you are about to make.[or]Fighting with a razor, foretells disappointing business, and that some one will keep you harassed almost beyond endurance.[or]A broken or rusty one, brings unavoidable distress.[cycling]"
"a"	"reindeer"	"[one of]To dream of a reindeer, signifies faithful discharge of duties, and remaining staunch to friends in their adversity.[or]To drive them, foretells that you will have hours of bitter anguish, but friends will attend you.[cycling]"
"a"	"revival"	"[one of]To dream of a religious revival or of being where a great many people are holding a revival meeting is a sign that you will go into a disreputable public place and lose _caste_: if you take part in the meeting it foretells that you will come to disgrace as all such dreams work contrariwise.[cycling]"
"a"	"revelation"	"[one of]To dream of a revelation, if it be of a pleasant nature, you may expect a bright outlook, either in business or love; but if the revelation be gloomy you will have many discouraging features to overcome.[cycling]"
"a"	"ring"	"[one of]To dream of a ring is favorable, if it be on your finger.[or]If you are in love, expect to be speedily united to the person on whom you have placed your affections.[or]To dream your ring falls off your finger, betokens evil, also the death of some near friend.[or]To a woman with child, it shows that the child with which she is pregnant will encounter many difficulties, and be far from being happy.[or]To a maiden, it is a warning to beware of her present lover.[cycling]"
"a"	"rooster"	"[one of]To dream of a rooster, foretells that you will be very successful and rise to prominence, but you will allow yourself to become conceited over your fortunate rise.[or]To see roosters fighting, foretells altercations and rivals.[cycling]"
"a"	"waist and shirt-waist"	"[one of]To dream of a round full waist, denotes that you will be favored by an agreeable dispensation of fortune.[or]A small, unnatural waist, foretells displeasing success and recriminating disputes.[or]For a young woman to dream of a nice, ready-made shirt-waist, denotes that she will win admiration through her ingenuity and pleasing manners.[or]To dream that her shirt-waist is torn, she will be censured for her illicit engagements.[or]If she is trying on a shirt-waist, she will encounter rivalry in love, but if she succeeds in adjusting the waist to her person, she will successfully combat the rivalry and win the object of her love.[cycling]"
"a"	"ruby"	"[one of]To dream of a ruby, foretells you will be lucky in speculations of business or love.[or]For a woman to lose one, is a sign of approaching indifference of her lover.[cycling]"
"a"	"rudder"	"[one of]To dream of a rudder, you will soom{sic} make a pleasant journey to foreign lands, and new friendships will be formed.[or]A broken rudder, augurs disappointment and sickness.[cycling]"
"a"	"scabbard"	"[one of]To dream of a scabbard, denotes some misunderstanding will be amicably settled.[or]If you wonder where your scabbard can be, you will have overpowering difficulties to meet.[cycling]"
"a"	"scaffold"	"[one of]To dream of a scaffold, denotes that you will undergo keen disappointment in failing to secure the object of your affection.[or]To ascend one, you will be misunderstood and censured by your friends for some action, which you never committed.[or]To decend one, you will be guilty of wrong doing, and you will suffer the penalty.[or]To fall from one, you will be unexpectedly surprised while engaged in deceiving and working injury to others.[cycling]"
"a"	"scarcity"	"[one of]To dream of a scarcity of anything is a sign that some of the article dreamed about is on its way to you; as if a farmer were to dream of a scarcity of hay it shows that his next hay crop will be very abundant; or if a girl should dream of a scarcity of compliments she will probably be overwhelmed by them from gentlemen when she next goes into company.[cycling]"
"a"	"school teacher"	"[one of]To dream of a school teacher, denotes you are likely to enjoy learning and amusements in a quiet way.[or]If you are one, you are likely to reach desired success in literary and other works.[cycling]"
"a"	"scorpion"	"[one of]To dream of a scorpion, foretells that false friends will improve opportunities to undermine your prosperity.[or]If you fail to kill it, you will suffer loss from an enemy's attack.[cycling]"
"a"	"scrap-book"	"[one of]To dream of a scrap-book, denotes disagreeable acquaintances will shortly be made.[cycling]"
"a"	"sculptor"	"[one of]To dream of a sculptor, foretells you will change from your present position to one less lucrative, but more distinguished.[or]For a woman to dream that her husband or lover is a sculptor, foretells she will enjoy favors from men of high position.[cycling]"
"a"	"scythe"	"[one of]To dream of a scythe, foretells accidents or sickness will prevent you from attending to your affairs, or making journeys.[or]An old or broken scythe, implies separation from friends, or failure in some business enterprise.[cycling]"
"a"	"sentry"	"[one of]To dream of a sentry, denotes that you will have kind protectors, and your life will be smoothly conducted.[cycling]"
"a"	"sepulchre"	"[one of]To dream of a sepulchre is a sign of great good to the dreamer.[cycling]"
"a"	"servant"	"[one of]To dream of a servant, is a sign that you will be fortunate, despite gloomy appearances.[or]Anger is likely to precipitate you into useless worries and quarrels.[or]To discharge one, foretells regrets and losses.[or]To quarrel with one in your dream, indicates that you will, upon waking, have real cause for censuring some one who is derelict in duty.[or]To be robbed by one, shows that you have some one near you, who does not respect the laws of ownership.[cycling]"
"a"	"shanty"	"[one of]To dream of a shanty, denotes that you will leave home in the quest of health.[or]This also warns you of decreasing prosperity.[cycling]"
"a"	"moon"	"[one of]To dream of a sharp new moon with horns pointing upwards is a sign you will be rich: if the horns point sideways or downward it foretells poverty: seeing a full moon in your dream denotes a thrifty and happy marriage: a half moon shadows forth the loss of a wife or husband by death or desertion.[or]Dreaming of seeing a half moon is fatal to the prospects of lovers.[cycling]"
"a"	"shawl"	"[one of]To dream of a shawl, denotes that some one will offer you flattery and favor.[or]To lose your shawl, foretells sorrow and discomfort.[or]A young woman is in danger of being jilted by a good-looking man, after this dream.[cycling]"
"a"	"shop"	"[one of]To dream of a shop, denotes that you will be opposed in every attempt you make for advancement by scheming and jealous friends.[cycling]"
"a"	"shotgun"	"[one of]To dream of a shotgun, foretells domestic troubles and worry with children and servants.[or]To shoot both barrels of a double-barreled shotgun, foretells that you will meet such exasperating and unfeeling attention in your private and public life that suave manners giving way under the strain and your righteous wrath will be justifiable.[or]Revolver, etc.[cycling]"
"a"	"shrew"	"[one of]To dream of a shrew, foretells that you will have a task to keep some friend in a cheerful frame of mind, and that you will unfit yourself for the experiences of everyday existence.[cycling]"
"a"	"shroud"	"[one of]To dream of a shroud is a sign of a wedding: to see in your dream a woman laid out in her shroud foretells to a young person that he or she will either be present at a marriage or will become a victim of Cupid’s archery.[cycling]"
"a"	"shroud"	"[one of]To dream of a shroud, denotes sickness and its attendant distress and anxiety, coupled with the machinations of the evil-minded and false friends.[or]Business will threaten decline after this dream.[or]To see shrouded corpses, denotes a multitude of misfortunes.[or]To see a shroud removed from a corpse, denotes that quarrels will result in alienation.[cycling]"
"a"	"sieve"	"[one of]To dream of a sieve, foretells some annoying transaction will soon be made by you, which will probably be to your loss.[or]If the meshes are too small, you will have the chance to reverse a decision unfavorable to yourself.[or]If too large, you will eventually lose what you have recently acquired.[cycling]"
"a"	"single combat"	"[one of]To dream of a single combat, signifies lawsuits and marriages.[cycling]"
"a"	"slaughter-house"	"[one of]To dream of a slaughter-house, denotes that you will be feared more than loved by your sweetheart or mistress.[or]Your business will divulge a private drain, and there will be unkind insinuations.[cycling]"
"a"	"sleigh-ride"	"[one of]To dream of a sleigh-ride where the sleighing is good and the sleigh glides free and noiseless is an excellent omen as it foretells success and good fortune generally particularly to farmers: but if you imagine the sleighing is poor and that the runners screech on the ground it foretells trouble and unhappiness.[or]Young men who dream of sleigh-riding with girls stopping at taverns drinking getting the girls boozy and then performing unnamable pranks are thus forewarned that they will be poor and shiftless as such dreams are certain omens of misery and disgrace.[cycling]"
"a"	"screw"	"[one of]To dream of a small screw is a good sign and indicates success in all you undertake; but to dream of a large bed-screw portends trouble brought about by love affairs.[cycling]"
"a"	"sorcerer"	"[one of]To dream of a sorcerer, foretells your ambitions will undergo strange disappointments and change.[cycling]"
"a"	"sovereign"	"[one of]To dream of a sovereign, denotes increasing prosperity and new friends.[cycling]"
"a"	"sow"	"[one of]To dream of a sow with a large litter of pigs denotes abundance to a farmer but is a sign of ill-health to a tradesman or mechanic: if a girl dreams this it foretells that she will soon marry a man in bad health.[cycling]"
"a"	"spider"	"[one of]To dream of a spider, denotes that you will be careful and energetic in your labors, and fortune will be amassed to pleasing proportions.[or]To see one building its web, foretells that you will be happy and secure in your own home.[or]To kill one, signifies quarrels with your wife or sweetheart.[or]If one bites you, you will be the victim of unfaithfulness and will suffer from enemies in your business.[or]If you dream that you see many spiders hanging in their webs around you, foretells most favorable conditions, fortune, good health and friends.[or]To dream of a large spider confronting you, signifies that your elevation to fortune will be swift, unless you are in dangerous contact.[or]To dream that you see a very large spider and a small one coming towards you, denotes that you will be prosperous, and that you will feel for a time that you are immensely successful; but if the large one bites you, enemies will steal away your good fortune.[or]If the little one bites you, you will be harassed with little spites and jealousies.[or]To imagine that you are running from a large spider, denotes you will lose fortune in slighting opportunities.[or]If you kill the spider you will eventually come into fair estate.[or]If it afterwards returns to life and pursues you, you will be oppressed by sickness and wavering fortunes.[or]For a young woman to dream she sees gold spiders crawling around her, foretells that her fortune and prospect for happiness will improve, and new friends will surround her.[cycling]"
"a"	"squirrel"	"[one of]To dream of a squirrel, shows that enemies are endeavoring to slander your reputation.[or]To the lover, it shows your sweetheart is of a bad temper, and much given to drinking.[or]If you have a lawsuit, it will surely be decided against you.[or]If you are in trade, sharpers will endeavor to defraud you, and you will quarrel with your principal creditor.[cycling]"
"a"	"stable"	"[one of]To dream of a stable denotes hospitality and good entertainment.[cycling]"
"a"	"stable"	"[one of]To dream of a stable, is a sign of fortune and advantageous surroundings.[or]To see a stable burning denotes successful changes, or it may be seen in actual life.[cycling]"
"a"	"stage driver"	"[one of]To dream of a stage driver, signifies you will go on a strange journey in quest of fortune and happiness.[cycling]"
"a"	"stall"	"[one of]To dream of a stall, denotes impossible results from some enterprise will be expected by you.[cycling]"
"a"	"stallion"	"[one of]To dream of a stallion, foretells prosperous conditions are approaching you, in which you will hold a position which will confer honor upon you.[or]To dream you ride a fine stallion, denotes you will rise to position and affluence in a phenomenal way; however, your success will warp your morality and sense of justice.[or]To see one with the rabies, foretells that wealthy surroundings will cause you to assume arrogance, which will be distasteful to your friends, and your pleasures will be deceitful.[cycling]"
"a"	"step-sister"	"[one of]To dream of a step-sister, denotes you will have unavoidable care and annoyance upon you.[cycling]"
"a"	"stethoscope"	"[one of]To dream of a stethoscope, foretells calamity to your hopes and enterprises.[or]There will be troubles and recriminations in love.[cycling]"
"a"	"stillborn"	"[one of]To dream of a stillborn infant, denotes that some distressing incident will come before your notice.[cycling]"
"a"	"storage battery"	"[one of]To dream of a storage battery, opportune speculations will return you handsome gains.[cycling]"
"a"	"store"	"[one of]To dream of a store filled with merchandise, foretells prosperity and advancement.[or]An empty one, denotes failure of efforts and quarrels.[or]To dream that your store is burning, is a sign of renewed activity in business and pleasure.[or]If you find yourself in a department store, it foretells that much pleasure will be derived from various sources of profit.[or]To sell goods in one, your advancement will be accelerated by your energy and the efforts of friends.[or]To dream that you sell a pair of soiled, gray cotton gloves to a woman, foretells that your opinion of women will place you in hazardous positions.[or]If a woman has this dream, her preference for some one of the male sex will not be appreciated very much by him.[cycling]"
"a"	"stove"	"[one of]To dream of a stove is a sign of wealth if there be a fire in it; but if cold a sign of poverty.[cycling]"
"an"	"alien"	"[one of]To dream of a stranger pleasing you, denotes good health and pleasant surroundings; if he displeases you, look for disappointments.[or]To dream you are an alien, denotes abiding friendships.[cycling]"
"a"	"surgeon"	"[one of]To dream of a surgeon, denotes you are threatened by enemies who are close to you in business.[or]For a young woman, this dream promises a serious illness from which she will experience great inconvenience.[cycling]"
"a"	"switch"	"[one of]To dream of a switch, foretells changes and misfortune.[or]A broken switch, foretells disgrace and trouble.[or]To dream of a railroad switch, denotes that travel will cause you much loss and inconvenience.[or]To dream of a switch, signifies you will meet discouragements in momentous affairs.[cycling]"
"a"	"sybil"	"[one of]To dream of a sybil, foretells that you will enjoy assignations and other demoralizing pleasures.[cycling]"
"a"	"synagogue"	"[one of]To dream of a synagogue, foretells that you have enemies powerfully barricading your entrance into fortune's realms.[or]If you climb to the top on the outside, you will overcome oppositions and be successful.[or]If you read the.[or]Hebrew inscription on a synagogue, you will meet disaster, but will eventually rebuild your fortunes with renewed splendor.[cycling]"
"a"	"syringe"	"[one of]To dream of a syringe, denotes that false alarm of the gravity of a relative's condition will reach you.[or]To see a broken one, foretells you are approaching a period of ill health or worry over slight mistakes in business.[cycling]"
"a"	"tailor"	"[one of]To dream of a tailor, denotes that worries will arise on account of some journey to be made.[or]To have a misunderstanding with one, shows that you will be disappointed in the outcome of some scheme.[or]For one to take your measure, denotes that you will have quarrels and disagreements.[cycling]"
"a"	"tambourine"	"[one of]To dream of a tambourine, signifies you will have enjoyment in some unusual event which will soon take place.[cycling]"
"a"	"tank"	"[one of]To dream of a tank, foretells you will be prosperous and satisfied beyond your expectations.[or]To see a leaking tank, denotes loss in your affairs.[cycling]"
"a"	"tannery"	"[one of]To dream of a tannery, denotes contagion and other illness.[or]Loss in trade is portended.[or]To dream that you are a tanner, denotes that you will have to engage in work which is not to your taste, but there will be others dependent upon you.[or]To buy leather from a tannery, foretells that you will be successful in your undertakings, but will not make many friends.[cycling]"
"a"	"target"	"[one of]To dream of a target, foretells you will have some affair demanding your attention from other more pleasant ones.[or]For a young woman to think she is a target, denotes her reputation is in danger through the envy of friendly associates.[cycling]"
"a"	"telephone"	"[one of]To dream of a telephone, foretells you will meet strangers who will harass and bewilder you in your affairs.[or]For a woman to dream of talking over one, denotes she will have much jealous rivalry, but will overcome all evil influences.[or]If she cannot hear well in conversing over one, she is threatened with evil gossip, and the loss of a lover.[cycling]"
"a"	"telescope"	"[one of]To dream of a telescope, portends unfavorable seasons for love and domestic affairs, and business will be changeable and uncertain.[or]To look at planets and stars through one, portends for you journeys which will afford you much pleasure, but later cause you much financial loss.[or]To see a broken telescope, or one not in use, signifies that matters will go out of the ordinary with you, and trouble may be expected.[cycling]"
"a"	"thaw"	"[one of]To dream of a thaw and walking in splashy snow foretells trouble and losses: if a young fellow dreams that he walks through splashy snow to go a courting it is a sign that he will quarrel with his sweetheart.[cycling]"
"a"	"tiger"	"[one of]To dream of a tiger advancing towards you, you will be tormented and persecuted by enemies.[or]If it attacks you, failure will bury you in gloom.[or]If you succeed in warding it off, or killing it, you will be extremely successful in all your undertakings.[or]To see one running away from you, is a sign that you will overcome opposition, and rise to high positions.[or]To see them in cages, foretells that you will foil your adversaries.[or]To see rugs of tiger skins, denotes that you are in the way to enjoy luxurious ease and pleasure.[cycling]"
"a"	"turquoise"	"[one of]To dream of a torquoise,{sic} foretells you are soon to realize some desire which will greatly please your relatives.[or]For a woman to have one stolen, foretells she will meet with crosses in love.[or]If she comes by it dishonestly, she must suffer for yielding to hasty susceptibility in love.[cycling]"
"a"	"tragedy"	"[one of]To dream of a tragedy, foretells misunderstandings and grievious disappointments.[or]To dream that you are implicated in a tragedy, portends that a calamity will plunge you into sorrow and peril.[cycling]"
"a"	"triangle"	"[one of]To dream of a triangle, foretells separation from friends, and love affairs will terminate in disagreements.[cycling]"
"a"	"trowel"	"[one of]To dream of a trowel, denotes you will experience reaction in unfavorable business, and will vanquish poverty.[or]To see one rusty or broken, unavoidable ill luck is fast approaching you.[cycling]"
"a"	"trumpet"	"[one of]To dream of a trumpet, denotes that something of unusual interest is about to befall you.[or]To blow a trumpet, signifies that you will gain your wishes.[cycling]"
"a"	"tub"	"[one of]To dream of a tub is a bad omen: if it be filled with water you have evil to fear; an empty tub signifies trouble; and to run against one sorrow.[cycling]"
"an"	"urinal"	"[one of]To dream of a urinal, disorder will predominate in your home.[cycling]"
"a"	"vapor bath"	"[one of]To dream of a vapor bath, you will have fretful people for companions, unless you dream of emerging from one, and then you will find that your cares will be temporary.[cycling]"
"a"	"vase"	"[one of]To dream of a vase, denotes that you will enjoy sweetest pleasure and contentment in the home life.[or]To drink from a vase, you will soon thrill with the delights of stolen love.[or]To see a broken vase, foretells early sorrow.[or]For a young woman to receive one, signifies that she will soon obtain her dearest wish.[cycling]"
"a"	"vault"	"[one of]To dream of a vault, denotes bereavement and other misfortune.[or]To see a vault for valuables, signifies your fortune will surprise many, as your circumstances will appear to be meagre.[or]To see the doors of a vault open, implies loss and treachery of people whom you trust.[cycling]"
"a"	"ventriloquist"	"[one of]To dream of a ventriloquist, denotes that some treasonable affair is going to prove detrimental to your interest.[or]If you think yourself one, you will not conduct yourself honorably towards people who trust you.[or]For a young woman to dream she is mystified by the voice of a ventriloquist, foretells that she will be deceived into illicit adventures.[cycling]"
"a"	"vicar"	"[one of]To dream of a vicar, foretells that you will do foolish things while furious with jealousy and envy.[or]For a young woman to dream she marries a vicar, foretells that she will fail to awake reciprocal affection in the man she desires, and will live a spinster, or marry to keep from being one.[cycling]"
"a"	"vineyard"	"[one of]To dream of a vineyard, denotes favorable speculations and auspicious love-making.[or]To visit a vineyard which is not well-kept and filled with bad odors, denotes disappointment will overshadow your most sanguine anticipations.[cycling]"
"a"	"viper"	"[one of]To dream of a viper, foretells that calamities are threatening you.[or]To dream that a many-hued viper, and capable of throwing itself into many pieces, or unjointing itself, attacks you, denotes that your enemies are bent on your ruin and will work unitedly, yet apart, to displace you.[cycling]"
"a"	"virgin"	"[one of]To dream of a virgin, denotes that you will have comparative luck in your speculations.[or]For a married woman to dream that she is a virgin, foretells that she will suffer remorse over her past, and the future will hold no promise of better things.[or]For a young woman to dream that she is no longer a virgin, foretells that she will run great risk of losing her reputation by being indiscreet with her male friends.[or]For a man to dream of illicit association with a virgin, denotes that he will fail to accomplish an enterprise, and much worry will be caused him by the appeals of people.[or]His aspirations will be foiled through unwarranted associations.[cycling]"
"a"	"wagon"	"[one of]To dream of a wagon, denotes that you will be unhappily mated, and many troubles will prematurely age you.[or]To drive one down a hill, is ominous of proceedings which will fill you with disquiet, and will cause you loss.[or]To drive one up hill, improves your worldly affairs.[or]To drive a heavily loaded wagon, denotes that duty will hold you in a moral position, despite your efforts to throw her off.[or]To drive into muddy water, is a gruesome prognostication, bringing you into a vortex of unhappiness and fearful foreboding.[or]To see a covered wagon, foretells that you will be encompassed by mysterious treachery, which will retard your advancement.[or]For a young woman to dream that she drives a wagon near a dangerous embankment, portends that she will be driven into an illicit entanglement, which will fill her with terror, lest she be openly discovered and ostracised.[or]If she drives across a clear stream of water, she will enjoy adventure without bringing opprobrium upon herself.[or]A broken wagon represents distress and failure.[cycling]"
"a"	"waif"	"[one of]To dream of a waif, denotes personal difficulties, and especial ill-luck in business.[cycling]"
"a"	"waiter"	"[one of]To dream of a waiter, signifies you will be pleasantly entertained by a friend.[or]To see one cross or disorderly, means offensive people will thrust themselves upon your hospitality.[cycling]"
"a"	"warehouse"	"[one of]To dream of a warehouse, denotes for you a successful enterprise.[or]To see an empty one, is a sign that you will be cheated and foiled in some plan which you have given much thought and maneuvering.[cycling]"
"a"	"wash-bowl"	"[one of]To dream of a wash-bowl, signifies that new cares will interest you, and afford much enjoyment to others.[or]To bathe your face and hands in a bowl of clear water, denotes that you will soon consummate passionate wishes which will bind you closely to some one who interested you, but before passion enveloped you.[or]If the bowl is soiled, or broken, you will rue an illicit engagement, which will give others pain, and afford you small pleasure.[cycling]"
"a"	"cathedral"	"[one of]To dream of a wast cathedral with its domes rising into space, denotes that you will be possessed with an envious nature and unhappy longings for the unattainable, both mental and physical; but if you enter you will be elevated in life, having for your companions the learned and wise.[cycling]"
"a"	"watch"	"[one of]To dream of a watch, denotes you will be prosperous in well-directed speculations.[or]To look at the time of one, your efforts will be defeated by rivalry.[or]To break one, there will be distress and loss menacing you.[or]To drop the crystal of one, foretells carelessness, or unpleasant companionship.[or]For a woman to lose one, signifies domestic disturbances will produce unhappiness.[or]To imagine you steal one, you will have a violent enemy who will attack your reputation.[or]To make a present of one, denotes you will suffer your interest to decline in the pursuance of undignified recreations.[cycling]"
"a"	"water lily"	"[one of]To dream of a water lily, or to see them growing, foretells there will be a close commingling of prosperity and sorrow or bereavement.[cycling]"
"a"	"waterfall"	"[one of]To dream of a waterfall, foretells that you will secure your wildest desire, and fortune will be exceedingly favorable to your progress.[cycling]"
"a"	"wedge"	"[one of]To dream of a wedge, denotes you will have trouble in some business arrangements which will be the cause of your separation from relatives.[or]Separation of lovers or friends may also be implied.[cycling]"
"a"	"whetstone"	"[one of]To dream of a whetstone, is significant of sharp worries and close attention is needed in your own affairs, if you avoid difficulties.[or]You are likely to be forced into an uncomfortable journey.[cycling]"
"a"	"whip"	"[one of]To dream of a whip, signifies unhappy dissensions and unfortunate and formidable friendships.[cycling]"
"a"	"whirlpool"	"[one of]To dream of a whirlpool, denotes that great danger is imminent in your business, and, unless you are extremely careful, your reputation will be seriously blackened by some disgraceful intrigue.[cycling]"
"a"	"white moth"	"[one of]To dream of a white moth, foretells unavoidable sickness, though you will be tempted to accuse yourself or some other with wrong-doing, which you think causes the complaint.[or]For a woman to see one flying around in the room at night, forebodes unrequited wishes and disposition which will effect the enjoyment of other people.[or]To see a moth flying and finally settling upon something, or disappearing totally, foreshadows death of friends or relatives.[cycling]"
"a"	"swan"	"[one of]To dream of a white swan signifies riches; a black one domestic sorrow.[or]Its song denotes death.[cycling]"
"a"	"wine-cellar"	"[one of]To dream of a wine-cellar, foretells superior amusements or pleasure will come in your way, to be disposed of at your bidding.[cycling]"
"a"	"witch"	"[one of]To dream of a witch foretells that you will leave your home and sojourn among strangers: if the witch attempts to injure you it denotes that you will be dependent upon strangers for your support.[or]No intelligent person believes in witches yet a great many dream of them and the above is the horoscope of such a dream.[cycling]"
"a"	"wizard"	"[one of]To dream of a wizard, denotes you are going to have a big family, which will cause you much inconvenience as well as displeasure.[or]For young people, this dream implies loss and broken engagements.[cycling]"
"a"	"wolf"	"[one of]To dream of a wolf, shows that you have a thieving person in your employ, who will also betray secrets.[or]To kill one, denotes that you will defeat sly enemies who seek to overshadow you with disgrace.[or]To hear the howl of a wolf, discovers to you a secret alliance to defeat you in honest competition.[cycling]"
"a"	"wooden shoe"	"[one of]To dream of a wooden shoe, is significant of lonely wanderings and penniless circumstances.[or]Those in love will suffer from unfaithfulness.[cycling]"
"a"	"yankee"	"[one of]To dream of a Yankee, foretells that you will remain loyal and true to your promise and duty, but if you are not careful you will be outwitted in some transaction.[cycling]"
"a"	"yard stick"	"[one of]To dream of a yard stick, foretells much anxiety will possess you, though your affairs assume unusual activity.[cycling]"
"a"	"yew tree"	"[one of]To dream of a yew tree, is a forerunner of illness and disappointment.[or]If a young woman sits under one, she will have many fears to rend her over her fortune and the faithfulness of her lover.[or]If she sees her lover standing by one, she may expect to hear of his illness, or misfortune.[or]To admire one, she will estrange herself from her relatives by a mesalliance.[or]To visit a yew tree and find it dead and stripped of its foliage, predicts a sad death in your family.[or]Property will not console for this loss.[cycling]"
"a"	"yew tree"	"[one of]To dream of a yew tree, is an indication of the funeral of a very aged person, by whose death the dreamer will derive some benefit or protecting hand among the relations of the deceased person.[cycling]"
"a"	"kidt"	"[one of]To dream of a young and sportful kid implies the birth of a child.[or]A young girl who grants her lover too close intimacy before marriage should never dream of the innocent and harmless kid.[or]It is a good dream for married people who desire children.[cycling]"
"a"	"yule log"	"[one of]To dream of a yule log, foretells that your joyous anticipations will be realized by your attendance at great festivities.[cycling]"
"a"	"zebra"	"[one of]To dream of a zebra, denotes that you will be interested in varying and fleeting enterprises.[or]To see one wild in his native country, foretells that you will pursue a chimerical fancy which will return you unsatisfactory pleasure upon possession.[cycling]"
"an"	"absalom"	"[one of]To dream of absalom, is significant of distressing incidents.[or]You may unconsciously fall a victim to error, and penetrate some well beloved heart with keen anguish and pain over the committal of immoral actions and the outraging of innocence.[or]No flower of purity will ever be too sacred for you to breathe a passionate breath upon.[or]To dream of this, or any other disobedient character, is a warning against immoral tendencies.[or]A father is warned by this dream to be careful of his children.[cycling]"
"an"	"absence"	"[one of]To dream of absent persons signifies that they will soon return.[or]It also denotes success in business.[cycling]"
"an"	"abuse"	"[one of]To dream of abusing a person, means that you will be unfortunate in your affairs, losing good money through over-bearing persistency in business relations with others.[or]To feel yourself abused, you will be molested in your daily pursuits by the enmity of others.[or]For a young woman to dream that she hears abusive language, foretells that she will fall under the ban of some person's jealousy and envy.[or]If she uses the language herself, she will meet with unexpected rebuffs, that may fill her with mortification and remorse for her past unworthy conduct toward friends.[cycling]"
"a"	"magic"	"[one of]To dream of accomplishing any design by magic, indicates pleasant surprises.[or]To see others practising this art, denotes profitable changes to all who have this dream.[or]To dream of seeing a magician, denotes much interesting travel to those concerned in the advancement of higher education, and profitable returns to the mercenary.[or]Magic here should not be confounded with sorcery or spiritism.[or]If the reader so interprets, he may expect the opposite to what is here forecast to follow.[or]True magic is the study of the higher truths of Nature.[cycling]"
"an"	"adam and eve"	"[one of]To dream of adam and eve, foretells that some eventful occasion will rob you of the hope of success in your affairs.[or]To see them in the garden,.[or]Adam dressed in his fig leaf, but.[or]Eve perfectly nude save for an Oriental colored serpent ornamenting her waist and abdomen, signifies that treachery and ill faith will combine to overthrow your fortune.[or]To see or hear.[or]Eve conversing with the serpent, foretells that artful women will reduce you to the loss of fortune and reputation.[cycling]"
"an"	"adamant"	"[one of]To dream of adamant, denotes that you will be troubled and defeated in some desire that you held as your life.[cycling]"
"an"	"advancement"	"[one of]To dream of advancing in any engagement, denotes your rapid ascendency to preferment and to the consummation of affairs of the heart.[or]To see others advancing, foretells that friends will hold positions of favor near you.[cycling]"
"an"	"age"	"[one of]To dream of age, portends failures in any kind of undertaking.[or]To dream of your own age, indicates that perversity of opinion will bring down upon you the indignation of relatives.[or]For a young woman to dream of being accused of being older than she is, denotes that she will fall into bad companionship, and her denial of stated things will be brought to scorn.[or]To see herself looking aged, intimates possible sickness, or unsatisfactory ventures.[or]If it is her lover she sees aged, she will be in danger of losing him.[cycling]"
"an"	"alabaster"	"[one of]To dream of alabaster, foretells success in marriage and all legitimate affairs.[or]To break an alabaster figure or vessel, denotes sorrow and repentence.[or]For a young woman to lose an alabaster box containing incense, signifies that she will lose her lover or property through carelessness of her reputation.[cycling]"
"an"	"alloy"	"[one of]To dream of alloy, denotes your business will vex you in its complications.[or]For a woman to dream of alloy, is significant of sorrow and trouble completely hiding pleasure.[cycling]"
"an"	"aluminum"	"[one of]To dream of aluminum, denotes contentment with any fortune, however small.[or]For a woman to see her aluminum ornaments or vessels tarnished, foretells strange and unexpected sorrow, and loss will befall her.[cycling]"
"an"	"ammunition"	"[one of]To dream of ammunition, foretells the undertaking of some work, which promises fruitful completion.[or]To dream your ammunition is exhausted, denotes fruitless struggles and endeavors.[cycling]"
"an"	"accident"	"[one of]To dream of an accident is a warning to avoid any mode of travel for a short period, as you are threatened with loss of life.[or]For an accident to befall stock, denotes that you will struggle with all your might to gain some object and then see some friend lose property of the same value in aiding your cause.[cycling]"
"an"	"oldwoman"	"[one of]To dream of an aged woman is generally a good omen as it shadows forth domestic happiness: to a married woman such a dream foretells the birth of a child: to a young girl that she will have an offer of marriage.[cycling]"
"an"	"album"	"[one of]To dream of an album, denotes you will have success and true friends.[or]For a young woman to dream of looking at photographs in an album, foretells that she will soon have a new lover who will be very agreeable to her.[cycling]"
"an"	"alley"	"[one of]To dream of an alley, denotes your fortune will not be so pleasing or promising as formerly.[or]Many vexing cares will present themselves to you.[or]For a young woman to wander through an alley after dark, warns her of disreputable friendships and a stigma on her character.[cycling]"
"an"	"alligator"	"[one of]To dream of an alligator, unless you kill it, is unfavorable to all persons connected with the dream.[or]It is a dream of caution.[cycling]"
"an"	"almanac"	"[one of]To dream of an almanac, means variable fortunes and illusive pleasures.[or]To be studying the signs, foretells that you will be harassed by small matters taking up your time.[cycling]"
"an"	"altar"	"[one of]To dream of an altar betokens gladness and affection in love.[cycling]"
"an"	"anchor"	"[one of]To dream of an anchor is favorable to sailors, if seas are calm.[or]To others it portends separation from friends, change of residence, and foreign travel.[or]Sweethearts are soon to quarrel if either sees an anchor.[cycling]"
"an"	"apron"	"[one of]To dream of an apron, signifies a zigzag course, for a young woman.[or]For a school girl to dream that her apron is loosened, or torn, implies bad lessons, and lectures in propriety from parents and teachers.[cycling]"
"an"	"assassin"	"[one of]To dream of an assassin is a warning not to be neglected.[or]Shun all pretending friends, lend no money, be ever on your guard, and you may escape destruction, which is planned for your ruin.[cycling]"
"an"	"asylum"	"[one of]To dream of an asylum, denotes sickness and unlucky dealings, which cannot be overcome without great mental struggle.[cycling]"
"an"	"auction"	"[one of]To dream of an auction in a general way, is good.[or]If you hear the auctioneer crying his sales, it means bright prospects and fair treatment from business ventures.[or]To dream of buying at an auction, signifies close deals to tradesmen, and good luck in live stock to the farmer.[or]Plenty, to the housewife is the omen for women.[or]If there is a feeling of regret about the dream, you are warned to be careful of your business affairs.[cycling]"
"an"	"earthquake"	"[one of]To dream of an earthquake, warns you that your affairs are about to take a great change.[or]If you see many houses tumble into ruins, then it will be much for the better.[cycling]"
"an"	"echo"	"[one of]To dream of an echo, portends that distressful times are upon you.[or]Your sickness may lose you your employment, and friends will desert you in time of need.[cycling]"
"an"	"eel"	"[one of]To dream of an eel is good if you can maintain your grip on him.[or]Otherwise fortune will be fleeting.[or]To see an eel in clear water, denotes, for a woman, new but evanescent pleasures.[or]To see a dead eel, signifies that you will overcome your most maliciously inclined enemies.[or]To lovers, the dream denotes an end to long and hazardous courtship by marriage.[cycling]"
"an"	"elephant"	"[one of]To dream of an elephant is a very fortunate dream for it denotes an acquirement of riches: if you are in love it foretells a speedy marriage with your sweetheart and many children chiefly boys who will distinguish themselves by their learning.[cycling]"
"an"	"elf"	"[one of]To dream of an elf signifies a happy return of one long absent; presents of value may be expected after this dream, which also signifies marriage, with wealth, position and happiness.[cycling]"
"an"	"emerald"	"[one of]To dream of an emerald, you will inherit property concerning which there will be some trouble with others.[or]For a lover to see an emerald or emeralds on the person of his affianced, warns him that he is about to be discarded for some wealthier suitor.[or]To dream that you buy an emerald, signifies unfortunate dealings.[cycling]"
"a"	"kegt"	"[one of]To dream of an empty one is a sign you will soon leave home; a keg of small fish or oysters denotes the receipt of money; a keg of spirits of any kind promises poverty; a keg of powder foretells misfortune; a keg of paint predicts compliments to be paid you.[cycling]"
"an"	"engine"	"[one of]To dream of an engine, denotes you will encounter grave difficulties and journeys, but you will have substantial friends to uphold you.[or]Disabled engines stand for misfortune and loss of relatives.[cycling]"
"an"	"entertainment"	"[one of]To dream of an entertainment where there is music and dancing, you will have pleasant tidings of the absent, and enjoy health and prosperity.[or]To the young, this is a dream of many and varied pleasures and the high regard of friends.[cycling]"
"an"	"epidemic"	"[one of]To dream of an epidemic, signifies prostration of mental faculties and worry from distasteful tasks.[or]Contagion among relatives or friends is foretold by dreams of this nature.[cycling]"
"an"	"illumination"	"[one of]To dream of an illumination augurs success in life and much happiness; if the light begins to disappear sorrow and many tears will be your portion.[cycling]"
"an"	"image"	"[one of]To dream of an image or statue, signifies children, and the will and affections of the dreamer.[cycling]"
"an"	"increase"	"[one of]To dream of an increase in your family, may denote failure in some of your plans, and success to another.[or]To dream of an increase in your business, signifies that you will overcome existing troubles.[cycling]"
"a"	"fakir"	"[one of]To dream of an Indian fakir, denotes uncommon activity and phenomenal changes in your life.[or]Such dreams may sometimes be of gloomy import.[cycling]"
"an"	"injury"	"[one of]To dream of an injury being done you, signifies that an unfortunate occurrence will soon grieve and vex you.[cycling]"
"an"	"inn"	"[one of]To dream of an inn, denotes prosperity and pleasures, if the inn is commodious and well furnished.[or]To be at a dilapidated and ill kept inn, denotes poor success, or mournful tasks, or unhappy journeys.[cycling]"
"an"	"inquest"	"[one of]To dream of an inquest, foretells you will be unfortunate in your friendships.[cycling]"
"an"	"inquisition"	"[one of]To dream of an inquisition, bespeaks for you an endless round of trouble and great disappointment.[or]If you are brought before an inquisition on a charge of wilfulness, you will be unable to defend yourself from malicious slander.[cycling]"
"an"	"interpreter"	"[one of]To dream of an interpreter, denotes you will undertake affairs which will fail in profit.[cycling]"
"an"	"inventor"	"[one of]To dream of an inventor, foretells you will soon achieve some unique work which will add honor to your name.[or]To dream that you are inventing something, or feel interested in some invention, denotes you will aspire to fortune and will be successful in your designs.[cycling]"
"an"	"orang-utang"	"[one of]To dream of an orang-utang, denotes that some person is falsely using your influence to further selfish schemes.[or]For a young woman, it portends an unfaithful lover.[cycling]"
"an"	"ostrich"	"[one of]To dream of an ostrich, denotes that you will secretly amass wealth, but at the same time maintain degrading intrigues with women.[or]To catch one, your resources will enable you to enjoy travel and extensive knowledge.[cycling]"
"an"	"overcoat"	"[one of]To dream of an overcoat, denotes you will suffer from contrariness, exhibited by others.[or]To borrow one, foretells you will be unfortunate through mistakes made by strangers.[or]If you see or are wearing a handsome new overcoat, you will be exceedingly fortunate in realizing your wishes.[cycling]"
"a"	"party"	"[one of]To dream of an unknown party of men assaulting you for your money or valuables, denotes that you will have enemies banded together against you.[or]If you escape uninjured, you will overcome any opposition, either in business or love.[or]To dream of attending a party of any kind for pleasure, you will find that life has much good, unless the party is an inharmonious one.[cycling]"
"an"	"urn"	"[one of]To dream of an urn, foretells you will prosper in some respects, and in others disfavor will be apparent.[or]To see broken urns, unhappiness will confront you.[cycling]"
"an"	"oil"	"[one of]To dream of anointing with oil, foretells events in which you will be the particular moving power.[or]Quantities of oil, prognosticates excesses in pleasurable enterprises.[or]For a man to dream that he deals in oil, denotes unsuccessful love making, as he will expect unusual concessions.[or]For a woman to dream that she is anointed with oil, shows that she will be open to indiscreet advances.[cycling]"
"an"	"absence"	"[one of]To dream of any absent friends,.[or]Good news of them, or ill, portends;.[or]But if at thy bedside they seem,.[or]Their deaths, perhaps, may solve thy dream.[cycling]"
"a"	"reptile"	"[one of]To dream of any animal that is called a reptile such as snakes toads alligators and the like is a sign of a quarrel: if you imagine you are bitten it shows that you will come out second best or badly injured either in person or reputation.[or]If a girl dreams of a reptile let her look sharp that her lover don’t play her false.[cycling]"
"a"	"sweet taste"	"[one of]To dream of any kind of a sweet taste in your mouth, denotes you will be praised for your pleasing conversation and calm demeanor in a time of commotion and distress.[or]To dream that you are trying to get rid of a sweet taste, foretells that you will oppress and deride your friends, and will incur their displeasure.[cycling]"
"a"	"vermin"	"[one of]To dream of any kind of vermin is ominous of ill-luck and enemies especially if they are in the house or near the fireplace; but if out of the house they are unimportant.[cycling]"
"a"	"secret order"	"[one of]To dream of any secret order, denotes a sensitive and excited organism, and the owner should cultivate practical and unselfish ideas and they may soon have opportunities for honest pleasures, and desired literary distinctions.[or]There is a vision of selfish and designing friendships for one who joins a secret order.[or]Young women should heed the counsel of their guardians, lest they fall into discreditable habits after this dream.[or]If a young woman meets the head of the order, she should oppose with energy and moral rectitude against allurements that are set brilliantly and prominently before those of her sex.[or]For her to think her mother has joined the order, and she is using her best efforts to have her mother repudiate her vows, denotes that she will be full of love for her parents, yet will wring their hearts with anguish by thoughtless disobedience.[or]To see or hear that the leader is dead, foretells severe strains, and trials will eventually end in comparative good.[cycling]"
"a"	"mountain"	"[one of]To dream of approaching beautiful smooth-looking mountains dressed in verdure denotes thrift and happiness and that you will rise in the world: if the mountains look steep rugged and rocky it foreshadows difficulties and danger which you may overcome by energy: to dream of successfully climbing a mountain is a sure sign that some honor awaits you or that you will make a good deal of money: difficulties in climbing show troubles and vexations in getting your honors or your money.[cycling]"
"a"	"pistol"	"[one of]To dream of arming yourself with a pistol foretells that you will lose _caste_ and perhaps become poor: if a girl dreams that her lover carries a pistol she may be sure that he is below her in social life and therefore an unpropitious or unsuitable match.[cycling]"
"an"	"asceticism"	"[one of]To dream of asceticism, denotes that you will cultivate strange principles and views, rendering yourself fascinating to strangers, but repulsive to friends.[cycling]"
"a"	"credit"	"[one of]To dream of asking for credit, denotes that you will have cause to worry, although you may be inclined sometimes to think things look bright.[or]To credit another, warns you to be careful of your affairs, as you are likely to trust those who will eventually work you harm.[cycling]"
"a"	"pardon"	"[one of]To dream of asking pardon for an offence is a bad omen under any circumstances as it foretells humiliation and disgrace: for a criminal to imagine in his dream that the.[or]Governor has pardoned him is a sign that he will not only not be pardoned but that he will suffer much remorse and unhappiness in his imprisonment.[cycling]"
"a"	"criminal"	"[one of]To dream of associating with a person who has committed a crime, denotes that you will be harassed with unscrupulous persons, who will try to use your friendship for their own advancement.[or]To see a criminal fleeing from justice, denotes that you will come into the possession of the secrets of others, and will therefore be in danger, for they will fear that you will betray them, and consequently will seek your removal.[cycling]"
"a"	"nobility"	"[one of]To dream of associating with the nobility, denotes that your aspirations are not of the right nature, as you prefer show and pleasures to the higher development of the mind.[or]For a young woman to dream of the nobility, foretells that she will choose a lover for his outward appearance, instead of wisely accepting the man of merit for her protector.[cycling]"
"a"	"bacon"	"[one of]To dream of bacon denotes the death of some friend or relation and that enemies will endeavor to do you mischief.[or]In love, it denotes disappointment and discontent.[cycling]"
"a"	"bacon"	"[one of]To dream of bacon or pork denotes the death of some friend or relation and that enemies will endeavor to do you a mischief; in love it denotes a disappointment of some kind.[cycling]"
"a"	"banana"	"[one of]To dream of bananas, foretells that you will be mated to an uninteresting and an unloved companion.[or]To eat them, foretells a tiresome venture in business, and self-inflicted duty.[or]To see them decaying, you are soon to fall into some disagreeable enterprise.[or]To trade in them, non-productive interests will accumulate around you.[cycling]"
"a"	"baptism"	"[one of]To dream of baptism, signifies that your character needs strengthening by the practice of temperance in advocating your opinions to the disparagement of your friends.[or]To dream that you are an applicant, signifies that you will humiliate your inward self for public favor.[or]To dream that you see.[or]John the.[or]Baptist baptizing.[or]Christ in the.[or]Jordan, denotes that you will have a desperate mental struggle between yielding yourself to labor in meagre capacity for the sustenance of others, or follow desires which might lead you into wealth and exclusiveness.[or]To see the.[or][or]Ghost descending on.[or]Christ, is significant of resignation to duty and abnegation of self.[or]If you are being baptized with the.[or][or]Ghost and fire, means that you will be thrown into a state of terror over being discovered in some lustful engagement.[cycling]"
"a"	"baste"	"[one of]To dream of basting meats while cooking, denotes you will undermine your own expectations by folly and selfishness.[or]For a woman to baste her sewing, omens much vacation owing to her extravagance.[cycling]"
"a"	"bat"	"[one of]To dream of bats is very inauspicious.[cycling]"
"a"	"christ"	"[one of]To dream of beholding.[or]Christ, the young child, worshiped by the wise men, denotes many peaceful days, full of wealth and knowledge, abundant with joy, and content.[or]If in the garden of the.[or]Gethsemane, sorrowing adversity will fill your soul, great longings for change and absent objects of love will be felt.[or]To see him in the temple scourging the traders, denotes that evil enemies will be defeated and honest endeavors will prevail.[cycling]"
"a"	"distance"	"[one of]To dream of being a long way from your residence, denotes that you will make a journey soon in which you may meet many strangers who will be instrumental in changing life from good to bad.[or]To dream of friends at a distance, denotes slight disappointments.[or]To dream of distance, signifies travel and a long journey.[or]To see men plowing with oxen at a distance, across broad fields, denotes advancing prosperity and honor.[or]For a man to see strange women in the twilight, at a distance, and throwing kisses to him, foretells that he will enter into an engagement with a new acquaintance, which will result in unhappy exposures.[cycling]"
"a"	"thief"	"[one of]To dream of being a thief and that you are pursued by officers, is a sign that you will meet reverses in business, and your social relations will be unpleasant.[or]If you pursue or capture a thief, you will overcome your enemies.[cycling]"
"a"	"dropsy"	"[one of]To dream of being afflicted with the dropsy, denotes illness for a time, but from which you will recover with renewed vigor.[or]To see others thus afflicted, denotes that you will hear from the absent shortly, and have tidings of their good health.[cycling]"
"a"	"quinsy"	"[one of]To dream of being afflicted with this disease, denotes discouraging employments.[or]To see others with it, sickness will cause you much anxiety.[cycling]"
"a"	"club"	"[one of]To dream of being approached by a person bearing a club, denotes that you will be assailed by your adversaries, but you will overcome them and be unusually happy and prosperous; but if you club any one, you will undergo a rough and profitless journey.[cycling]"
"a"	"concert"	"[one of]To dream of being at a concert foretells the enjoyment of good health; to the sick recovery.[cycling]"
"a"	"festival"	"[one of]To dream of being at a festival, denotes indifference to the cold realities of life, and a love for those pleasures that make one old before his time.[or]You will never want, but will be largely dependent on others.[cycling]"
"a"	"soda fountain"	"[one of]To dream of being at a soda fountain, denotes pleasure and profit after many exasperating experiences.[or]To treat others to this and other delectable iced drinks; you will be rewarded in your efforts, though the outlook appears full of contradictions.[or]Inharmonious environments, and desired results will be forthcoming.[cycling]"
"a"	"gale"	"[one of]To dream of being caught in a gale, signifies business losses and troubles for working people.[cycling]"
"a"	"wolf"	"[one of]To dream of being chased by one of these animals foretells that you will be cheated in a trade or bargain: if a girl dreams of being frightened by a wolf it shows that her lover is a bad man and she had better discard him; if she has no lover some black-hearted fellow will try to make her acquaintance.[cycling]"
"a"	"rubber"	"[one of]To dream of being clothed in rubber garments, is a sign that you will have honors conferred upon you because of your steady and unchanging stand of purity and morality.[or]If the garments are ragged or torn, you should be cautious in your conduct, as scandal is ready to attack your reputation.[or]To dream of using ``rubber'' as a slang term, foretells that you will be easy to please in your choice of pleasure and companions.[or]If you find that your limbs will stretch like rubber, it is a sign that illness is threatening you, and you are likely to use deceit in your wooing and business.[or]To dream of rubber goods, denotes that your affairs will be conducted on a secret basis, and your friends will fail to understand your conduct in many instances.[cycling]"
"a"	"gauze"	"[one of]To dream of being dressed in gauze, denotes uncertain fortune.[or]For a lover to see his sweetheart clothed in filmy material, suggests his ability to influence her for good.[cycling]"
"a"	"dumb"	"[one of]To dream of being dumb, indicates your inability to persuade others into your mode of thinking, and using them for your profit by your glibness of tongue.[or]To the dumb, it denotes false friends.[cycling]"
"a"	"faction"	"[one of]To dream of being engaged in faction or sedition, denotes wealth by indirect ways.[cycling]"
"a"	"fame"	"[one of]To dream of being famous, denotes disappointed aspirations.[or]To dream of famous people, portends your rise from obscurity to places of honor.[cycling]"
"a"	"feeble"	"[one of]To dream of being feeble, denotes unhealthy occupation and mental worry.[or]Seek to make a change for yourself after this dream.[cycling]"
"a"	"negro"	"[one of]To dream of being frightened or assaulted by a negro is a good sign as it denotes safety: if the negro comes towards you in a pleasant and agreeable way it shows that you will meet with a loss or be robbed: to see a grinning pleasant-looking negro in your dream forebodes trouble through the conduct of a dependent.[cycling]"
"a"	"homesick"	"[one of]To dream of being homesick, foretells you will lose fortunate opportunities to enjoy travels of interest and pleasant visits.[cycling]"
"a"	"hungry"	"[one of]To dream of being hungry foretells that you will soon engage in some new enterprise which will prove successful.[or]Hungry dreams are excellent omens to lovers as they denote energy and success.[or]If a girl dreams that a gentleman comes to see her who is hungry it is a sign that he will woo her in such an earnest and affectionate manner as to win her heart.[cycling]"
"a"	"disaster"	"[one of]To dream of being in any disaster from public conveyance, you are in danger of losing property or of being maimed from some malarious disease.[or]For a young woman to dream of a disaster in which she is a participant, foretells that she will mourn the loss of her lover by death or desertion.[or]To dream of a disaster at sea, denotes unhappiness to sailors and loss of their gains.[or]To others, it signifies loss by death; but if you dream that you are rescued, you will be placed in trying situations, but will come out unscathed.[or]To dream of a railway wreck in which you are not a participant, you will eventually be interested in some accident because of some relative or friend being hurt, or you will have trouble of a business character.[cycling]"
"a"	"jew"	"[one of]To dream of being in company with a Jew, signifies untiring ambition and an irrepressible longing after wealth and high position, which will be realized to a very small extent.[or]To have transactions with a Jew, you will prosper legally in important affairs.[or]For a young woman to dream of a Jew, omens that she will mistake flattery for truth, and find that she is only a companion for pleasure.[or]For a man to dream of a Jewess, denotes that his desires run parallel with voluptuousness and easy comfort.[or]He should constitute himself woman's defender.[or]For a Gentile to dream of Jews, signifies worldly cares and profit from dealing with them.[or]To argue with them, your reputation is endangered from a business standpoint.[cycling]"
"a"	"harlot"	"[one of]To dream of being in the company of a harlot, denotes ill-chosen pleasures and trouble in your social circles, and business will suffer depression.[or]If you marry one, life will be threatened by an enemy.[cycling]"
"a"	"deck"	"[one of]To dream of being on a ship and that a storm is raging, great disasters and unfortunate alliances will overtake you; but if the sea is calm and the light distinct, your way is clear to success.[or]For lovers, this dream augurs happiness.[cycling]"
"a"	"veranda"	"[one of]To dream of being on a veranda, denotes that you are to be successful in some affair which is giving you anxiety.[or]For a young woman to be with her lover on a veranda, denotes her early and happy marriage.[or]To see an old veranda, denotes the decline of hopes, and disappointment in business and love.[cycling]"
"a"	"monster"	"[one of]To dream of being pursued by a monster, denotes that sorrow and misfortune hold prominent places in your immediate future.[or]To slay a monster, denotes that you will successfully cope with enemies and rise to eminent positions.[cycling]"
"a"	"nightmare"	"[one of]To dream of being ridden by the nightmare is a sign that a woman so dreaming, shall be domineered over by a fool.[cycling]"
"a"	"cart"	"[one of]To dream of being tied to a cart to draw like a horse denotes servitude and pain; but to dream that you are carried in a cart the contrary.[cycling]"
"a"	"cart"	"[one of]To dream of being tied to a cart, to draw like an horse or an ox, denotes servitude and pain to everybody; but to dream that you are carried in a cart or coach, the contrary.[cycling]"
"an"	"enchantment"	"[one of]To dream of being under the spell of enchantment, denotes that if you are not careful you will be exposed to some evil in the form of pleasure.[or]The young should heed the benevolent advice of their elders.[or]To resist enchantment, foretells that you will be much sought after for your wise counsels and your liberality.[or]To dream of trying to enchant others, portends that you will fall into evil.[cycling]"
"a"	"pest"	"[one of]To dream of being worried over a pest of any nature, foretells that disturbing elements will prevail in your immediate future.[or]To see others thus worried, denotes that you will be annoyed by some displeasing development.[cycling]"
"a"	"nose"	"[one of]To dream of big-nosed people is generally a good omen as such persons are usually smart and energetic.[or]To dream of snub noses is a sign of a quarrel or that you will be abused by somebody.[cycling]"
"a"	"bobbin"	"[one of]To dream of bobbins, denotes that important work will devolve on you, and your interests will be adversely affected if you are negligent in dispatching the same work.[cycling]"
"a"	"bomb shell"	"[one of]To dream of bomb shells, foretells anger and disputes, ending in law suits.[or]Many displeasing incident{s?} follow this dream.[cycling]"
"a"	"puzzle"	"[one of]To dream of bothering your brains with a puzzle foretells frivolity; if you succeed you will do something that works to your disadvantage: if you imagine that the puzzle puzzles you it is a sign that some silly person will do you an unintentional injury.[cycling]"
"a"	"brandy"	"[one of]To dream of brandy, foretells that while you may reach heights of distinction and wealth, you will lack that innate refinement which wins true friendship from people whom you most wish to please.[cycling]"
"a"	"bread"	"[one of]To dream of bread is an excellent sign.[or]If you see a good deal the better the dream.[or]It foretells good fortune to either man or woman.[or]To lovers it predicts that they will make a good match and be well off if not rich.[or]To farmers it promises full and abundant crops.[cycling]"
"a"	"breast"	"[one of]To dream of breasts denotes great gain and profit to men; but to a woman losses.[or]If a young woman dreams that her breasts are full of milk it signifies she is near her marriage.[cycling]"
"a"	"lightning"	"[one of]To dream of bright and vivid white lightning denotes that you will soon go on a pleasant trip or journey: blueish silver forked lightning foretells good crops and excellent success in business; red forked lightning the same but attended with calamity or the death of relatives by violence.[cycling]"
"a"	"brimstone"	"[one of]To dream of brimstone, foretells that discreditable dealings will lose you many friends.[or]if you fail to rectify the mistakes you are making.[or]To see fires of brimstone, denotes you will be threatened with loss by contagion in your vicinity.[cycling]"
"a"	"jewelry"	"[one of]To dream of broken jewelry, denotes keen disappointment in attaining one's highest desires.[or]If the jewelry be cankered, trusted friends will fail you, and business cares will be on you.[cycling]"
"a"	"promise"	"[one of]To dream of broken promises on the part of a friend is a sign that he will confer a benefit on you: if a girl dreams that her lover has broken his promise to marry it foreshadows a speedy performance of the ceremony.[cycling]"
"a"	"broom"	"[one of]To dream of brooms, denotes thrift and rapid improvement in your fortune, if the brooms are new.[or]If they are seen in use, you will lose in speculation.[or]For a woman to lose a broom, foretells that she will prove a disagreeable and slovenly wife and housekeeper.[cycling]"
"a"	"buckle"	"[one of]To dream of buckles, foretells that you will be beset with invitations to places of pleasure, and your affairs will be in danger of chaotic confusion.[cycling]"
"a"	"house"	"[one of]To dream of building a house is a good omen; in love, that your sweetheart is good-tempered and faithful, and will make you very happy; to dream you see a house on fire, foretells hasty news.[or]If it be your own house that is destroyed, the news will be bad.[or]If your enemy’s house, it will be good.[cycling]"
"a"	"house"	"[one of]To dream of building a house, you will make wise changes in your present affairs.[or]To dream that you own an elegant house, denotes that you will soon leave your home for a better, and fortune will be kind to you.[or]Old and dilapidated houses, denote failure in business or any effort, and declining health.[cycling]"
"a"	"limekiln"	"[one of]To dream of burning lime in a kiln or of seeing a kiln in full blast is a sign of health and abundant crops; but to see a dilapidated and empty limekiln in your dream is the reverse of this as far as the crops are concerned.[cycling]"
"a"	"burr"	"[one of]To dream of burrs, denotes that you will struggle to free self from some unpleasant burden, and will seek a change of surroundings.[cycling]"
"a"	"quaker"	"[one of]To dream of business intercourse with genuine broad-brims is a sign you will make a bad bargain.[or]If in your dream you see a concourse of quakers it foretells that you will not be fortunate in business matters.[or]This omen is supposed to be predicated on the fact that the.[or]Quakers monopolize all the good chances when they are around.[cycling]"
"a"	"liquor"	"[one of]To dream of buying liquor, denotes selfish usurpation of property upon which you have no legal claim.[or]If you sell it, you will be criticised for niggardly benevolence.[or]To drink some, you will come into doubtful possession of wealth, but your generosity will draw around you convivial friends, and women will seek to entrance and hold you.[or]To see liquor in barrels, denotes prosperity, but unfavorable tendency toward making home pleasant.[or]If in bottles, fortune will appear in a very tangible form.[or]For a woman to dream of handling, or drinking liquor, foretells for her a happy.[or]Bohemian kind of existence.[or]She will be good natured but shallow minded.[or]To treat others, she will be generous to rivals, and the indifference of lovers or husband will not seriously offset her pleasures or contentment.[cycling]"
"a"	"land"	"[one of]To dream of buying or inheriting land is an excellent omen as it foretells health and wealth; but to sell land in your dream denotes sickness and poverty.[or]If a young man dreams of buying land it is a sign he will marry a rich wife.[cycling]"
"a"	"cabbage"	"[one of]To dream of cabbage signifies very bad news from abroad.[cycling]"
"a"	"watchman"	"[one of]To dream of calling in one gives confidence: to see a person taken to prison by a watchman shows that you must be careful in conducting your business.[or]If the watchman take hold of you it is a very good sign.[or]To see many watchmen together signifies the loss of money.[cycling]"
"a"	"calomel"	"[one of]To dream of calomel shows some person is seeking to deceive and injure you through the unconscious abetting of friends.[or]For a young woman to dream of taking it, foretells that she will be victimized through the artful designing of persons whom she trusts.[or]If it is applied externally, she will close her eyes to deceit in order to enjoy a short season of pleasure.[cycling]"
"a"	"camp"	"[one of]To dream of camping in the open air, you may expect a change in your affairs, also prepare to make a long and wearisome journey.[or]To see a camping settlement, many of your companions will remove to new estates and your own prospects will appear gloomy.[or]For a young woman to dream that she is in a camp, denotes that her lover will have trouble in getting her to name a day for their wedding, and that he will prove a kind husband.[or]If in a military camp she will marry the first time she has a chance.[or]A married woman after dreaming of being in a soldier's camp is in danger of having her husband's name sullied, and divorce courts may be her destination.[cycling]"
"a"	"carrion"	"[one of]To dream of carrion, signifies sadness.[cycling]"
"a"	"carrot"	"[one of]To dream of carrots, portends prosperity and health.[or]For a young woman to eat them, denotes that she will contract an early marriage and be the mother of several hardy children.[cycling]"
"a"	"lantern"	"[one of]To dream of carrying a lantern in a dark night is a good sign provided you have no difficulty in finding your way for it shows that you will easily accomplish some fortunate object you may have in view; if you stumble or have difficulty in finding your way with the lantern it denotes trouble and vexation though success will be achieved at last.[cycling]"
"an"	"umbrella"	"[one of]To dream of carrying an umbrella, denotes that trouble and annoyances will beset you.[or]To see others carrying them, foretells that you will be appealed to for aid by charity.[or]To borrow one, you will have a misunderstanding, perhaps, with a warm friend.[or]To lend one, portends injury from false friends.[or]To lose one, denotes trouble with some one who holds your confidence.[or]To see one torn to pieces, or broken, foretells that you will be misrepresented and maligned.[or]To carry a leaky one, denotes that pain and displeasure will be felt by you towards your sweetheart or companions.[or]To carry a new umbrella over you in a clear shower, or sunshine, omens exquisite pleasure and prosperity.[cycling]"
"a"	"cartridge"	"[one of]To dream of cartridges, foretells unhappy quarrels and dissensions.[or]Some untoward fate threatens you or some one closely allied to you.[or]If they are empty, there will be foolish variances in your associations.[cycling]"
"a"	"castor oil"	"[one of]To dream of castor oil, denotes that you will seek to overthrow a friend who is secretly abetting your advancement.[cycling]"
"a"	"castoria"	"[one of]To dream of castoria, denotes that you will fail to discharge some important duty, and your fortune will seemingly decline to low stages.[cycling]"
"a"	"horse"	"[one of]To dream of catching a horse to bridle and saddle, or harness it, you will see a great improvement in business of all kinds, and people of all callings will prosper.[or]If you fail to catch it, fortune will play you false.[or]To see spotted horses, foretells that various enterprises will bring you profit.[or]To dream of having a horse shod, your success is assured.[or]For a woman, this dream omens a good and faithful husband.[or]To dream that you shoe a horse, denotes that you will endeavor to and perhaps make doubtful property your own.[or]To dream of race horses, denotes that you will be surfeited with fast living, but to the farmer this dream denotes prosperity.[or]To dream that you ride a horse in a race, you will be prosperous and enjoy life.[or]To dream of killing a horse, you will injure your friends through selfishness.[or]To mount a horse bareback, you will gain wealth and ease by hard struggles.[or]To ride bareback in company with men, you will have honest people to aid you, and your success will be merited.[or]If in company with women, your desires will be loose, and your prosperity will not be so abundant as might be if women did not fill your heart.[or]To curry a horse, your business interests will not be neglected for frivolous pleasures.[or]To dream of trimming a horse's mane, or tail, denotes that you will be a good financier or farmer.[or]Literary people will be painstaking in their work and others will look after their interest with solicitude.[or]To dream of horses, you will amass wealth and enjoy life to its fullest extent.[or]To see horses pulling vehicles, denotes wealth with some incumbrance, and love will find obstacles.[or]If you are riding up a hill and the horse falls but you gain the top, you will win fortune, though you will have to struggle against enemies and jealousy.[or]If both the horse and you get to the top, your rise will be phenomenal, but substantial.[or]For a young girl to dream that she rides a black horse, denotes that she should be dealt with by wise authority.[or]Some wishes will be gratified at an unexpected time.[or]Black in horses, signifies postponements in anticipations.[cycling]"
"a"	"fish"	"[one of]To dream of catching fish is a sign of excellent good fortune particularly if you haul up large ones; if the fish fall off your hook it predicts troublesome fortune.[or]If you dream of fishing without catching any it shows that you will fail in some undertaking or speculation; and to a lover it is a sign that he will get the mitten.[or]To dream that you see an abundance of fish foretells the receipt of money or success in collecting it.[cycling]"
"a"	"woodchuck"	"[one of]To dream of catching one of these animals is a sign that you will be robbed and that the thief will be detected: if you imagine you kill the woodchuck you will probably recover your stolen property.[cycling]"
"a"	"trout"	"[one of]To dream of catching trout is an excellent omen as it foretells that you will get money—the larger the trout the more cash you will receive.[or]It is stated in some of the books that to newly married people such a dream foretells the birth of a child but.[or]I have been unable to verify this because most young married people will have children whether they dream of trout or not.[cycling]"
"a"	"cellery"	"[one of]To dream of cellery is a good omen it portends success in business and love.[cycling]"
"a"	"charcoal"	"[one of]To dream of charcoal unlighted, denotes miserable situations and bleak unhappiness.[or]If it is burning with glowing coals, there is prospects of great enhancement of fortune, and possession of unalloyed joys.[cycling]"
"a"	"fox"	"[one of]To dream of chasing a fox, denotes that you are en gaging in doubtful speculations and risky love affairs.[or]If you see a fox slyly coming into your yard, beware of envious friendships; your reputation is being slyly assailed.[or]To kill a fox, denotes that you will win in every engagement.[cycling]"
"a"	"cheese"	"[one of]To dream of cheese is not in vain.[or]In trade you will profit gain.[cycling]"
"a"	"chocolate"	"[one of]To dream of chocolate signifies trouble brought about by gossiping.[cycling]"
"a"	"chocolate"	"[one of]To dream of chocolate, denotes you will provide abundantly for those who are dependent on you.[or]To see chocolate candy, indicates agreeable companions and employments.[or]If sour, illness or other disappointments will follow.[or]To drink chocolate, foretells you will prosper after a short period of unfavorable reverses.[cycling]"
"a"	"church"	"[one of]To dream of church is portentous of evil.[or]If you are in a church during divine service, you will be engaged in a lawsuit, or some other quarrel that will very near ruin you.[or]If you are in love, your sweetheart is unfaithful, and prefers another.[or]If you expect a place, it forebodes disappointment.[or]If you are in trade, you will never thrive in your present situation.[cycling]"
"a"	"cider"	"[one of]To dream of cider, denotes fortune may be won by you if your time is not squandered upon material pleasure.[or]To see people drinking it, you will be under the influence of unfaithful friends.[cycling]"
"a"	"claret cup and punch"	"[one of]To dream of claret cup or punch, foretells that you will be much pleased with the attention shown you by new acquaintances.[cycling]"
"a"	"clay"	"[one of]To dream of clay, denotes isolation of interest and probable insolvency.[or]To dig in a clay bank, foretells you will submit to extraordinary demands of enemies.[or]If you dig in an ash bank and find clay, unfortunate surprises will combat progressive enterprises or new work.[or]Your efforts are likely to be misdirected after this dream.[or]Women will find this dream unfavorable in love, social and business states, and misrepresentations will overwhelm them.[cycling]"
"a"	"grub"	"[one of]To dream of clean-looking white fat grubs is a sign of good crops to farmers but to dream of black or dirty looking grubs is the reverse.[or]For a girl to dream of grubs is a bad sign as it puts her in peril of losing her virtue; but to a married woman it is a good sign for the reason that she will soon be in the family way.[cycling]"
"a"	"garret"	"[one of]To dream of climbing to a garret, denotes your inclination to run after theories while leaving the cold realities of life to others less able to bear them than yourself.[or]To the poor, this dream is an omen of easier circumstances.[or]To a woman, it denotes that her vanity and sefishness{sic} should be curbed.[cycling]"
"a"	"fence"	"[one of]To dream of climbing to the top of a fence, denotes that success will crown your efforts.[or]To fall from a fence, signifies that you will undertake a project for which you are incapable, and you will see your efforts come to naught.[or]To be seated on a fence with others, and have it fall under you, denotes an accident in which some person will be badly injured.[or]To dream that you climb through a fence, signifies that you will use means not altogether legitimate to reach your desires.[or]To throw the fence down and walk into the other side, indicates that you will, by enterprise and energy, overcome the stubbornest barriers between you and success.[or]To see stock jumping a fence, if into your enclosure, you will receive aid from unexpected sources; if out of your lot, loss in trade and other affairs may follow.[or]To dream of building a fence, denotes that you are, by economy and industry, laying a foundation for future wealth.[or]For a young woman, this dream denotes success in love affairs; or the reverse, if she dreams of the fence falling, or that she falls from it.[cycling]"
"a"	"cocoa"	"[one of]To dream of cocoa, denotes you will cultivate distasteful friends for your own advancement and pleasure.[cycling]"
"a"	"coffee"	"[one of]To dream of coffee signifies loss of reputation.[or]For a young girl to have such a dream predicts the loss of her virtue.[cycling]"
"a"	"coke"	"[one of]To dream of coke, denotes affliction and discord will enter your near future.[cycling]"
"a"	"judge"	"[one of]To dream of coming before a judge, signifies that disputes will be settled by legal proceedings.[or]Business or divorce cases may assume gigantic proportions.[or]To have the case decided in your favor, denotes a successful termination to the suit; if decided against you, then you are the aggressor and you should seek to right injustice.[cycling]"
"an"	"income"	"[one of]To dream of coming into the possession of your income, denotes that you may deceive some one and cause trouble to your family and friends.[or]To dream that some of your family inherits an income, predicts success for you.[or]For a woman to dream of losing her income, signifies disappointments in life.[or]To dream that your income is insufficient to support you, denotes trouble to relatives or friends.[or]To dream of a portion of your income remaining, signifies that you will be very successful for a short time, but you may expect more than you receive.[cycling]"
"a"	"hide"	"[one of]To dream of concealing anything by hiding it or putting it in an out-of-the-way place is a sign that some one will reveal a secret that you have told.[or]It is a bad omen for lovers to dream of hiding things as it predicts that their intimacy will be talked about as suspicious.[cycling]"
"an"	"oculist"	"[one of]To dream of consulting an oculist, denotes that you will be dissatisfied with your progress in life, and will use artificial means of advancement.[cycling]"
"a"	"copying"	"[one of]To dream of copying, denotes unfavorable workings of well tried plans.[or]For a young woman to dream that she is copying a letter, denotes she will be prejudiced into error by her love for a certain class of people.[cycling]"
"a"	"coral"	"[one of]To dream of coral, is momentous of enduring friend ship which will know no weariness in alleviating your trouble.[or]Colored coral is meant in this dream.[or]White coral, foretells unfaithfulness and warning of love.[cycling]"
"a"	"counter"	"[one of]To dream of counters, foretells that active interest will debar idleness from infecting your life with unhealthful desires.[or]To dream of empty and soiled counters, foretells unfortunate engagements which will bring great uneasiness of mind lest your interest will be wholly swept away.[cycling]"
"a"	"foot-log"	"[one of]To dream of crossing a clear stream of water on a foot-log, denotes pleasant employment and profit.[or]If the water is thick and muddy, it indicates loss and temporary disturbance.[or]For a woman this dream indicates either a quarrelsome husband, or one of mild temper and regular habits, as the water is muddy or clear.[or]To fall from a foot-log into clear water, signifies short widowhood terminating in an agreeable marriage.[or]If the water is not clear, gloomy prospects.[cycling]"
"a"	"ferry"	"[one of]To dream of crossing a ferry, signifies that indecision in an important matter will make you the laughing-stock of your friends.[cycling]"
"a"	"river"	"[one of]To dream of crossing a large and clear river foretells a splendid fortune: if the water is muddy or riled it predicts difficulties but they will be overcome provided you get safe over the river without accident.[or]If a girl dreams this it is a sign she will travel somewhere and get a rich husband.[cycling]"
"a"	"baby"	"[one of]To dream of crying babies, is indicative of ill health and disappointments.[or]A bright, clean baby, denotes love requited, and many warm friends.[or]Walking alone, it is a sure sign of independence and a total ignoring of smaller spirits.[or]If a woman dream she is nursing a baby, she will be deceived by the one she trusts most.[or]It is a bad sign to dream that you take your baby if sick with fever.[or]You will have many sorrows of mind.[cycling]"
"a"	"crystal"	"[one of]To dream of crystal in any form, is a fatal sign of coming depression either in social relations or business transactions.[or]Electrical storms often attend this dream, doing damage to town and country.[or]For a woman to dream of seeing a dining-room furnished in crystal, even to the chairs, she will have cause to believe that those whom she holds in high regard no longer deserve this distinction, but she will find out that there were others in the crystal-furnished room, who were implicated also in this sinister dream.[cycling]"
"a"	"jig"	"[one of]To dream of dancing a jig with a lady is a sign she is in love with you or is pleased with you; and if you like her you may go in at once for her favor with much confidence.[or]The omen is the same to a girl who dreams of jigging with a young man.[cycling]"
"a"	"quadrille"	"[one of]To dream of dancing a quadrille, foretells that some pleasant engagement will occupy your time.[cycling]"
"a"	"polka"	"[one of]To dream of dancing the polka, denotes pleasant occupations.[cycling]"
"a"	"dark"	"[one of]To dream of darkness overtaking you on a journey, augurs ill for any work you may attempt, unless the sun breaks through before the journey ends, then faults will be overcome.[or]To lose your friend, or child, in the darkness, portends many provocations to wrath.[or]Try to remain under control after dreaming of darkness, for trials in business and love will beset you.[cycling]"
"a"	"david"	"[one of]To dream of David, of Bible fame, denotes divisions in domestic circles, and unsettled affairs, will tax heavily your nerve force.[cycling]"
"a"	"field"	"[one of]To dream of dead corn or stubble fields, indicates to the dreamer dreary prospects for the future.[or]To see green fields, or ripe with corn or grain, denotes great abundance and happiness to all classes.[or]To see newly plowed fields, denotes early rise in wealth and fortunate advancement to places of honor.[or]To see fields freshly harrowed and ready for planting, denotes that you are soon to benefit by your endeavor and long struggles for success.[cycling]"
"a"	"fort"	"[one of]To dream of defending a fort, signifies your honor and possessions will be attacked, and you will have great worry over the matter.[or]To dream that you attack a fort and take it, denotes victory over your worst enemy, and fortunate engagements.[cycling]"
"a"	"javelin"	"[one of]To dream of defending yourself with a javelin, your most private affairs will be searched into to establish claims of dishonesty, and you will prove your innocence after much wrangling.[or]If you are pierced by a javelin, enemies will succeed in giving you trouble.[or]To see others carrying javelins, your interests are threatened.[cycling]"
"a"	"dice"	"[one of]To dream of dice, is indicative of unfortunate speculations, and consequent misery and despair.[or]It also foretells contagious sickness.[or]For a girl to dream that she sees her lover throwing dice, indicates his unworthiness.[cycling]"
"a"	"digging"	"[one of]To dream of digging in clean and healthy ground is a sign of thrift and good luck generally: if the ground be dirty or wet it shows trouble: if you are digging for gold and find large and rich lumps it shows you’ll have some good luck but if the product is meagre or if you don’t find any it foretells disappointment.[or]If you lose any of your tools it is a sign of a quarrel.[cycling]"
"a"	"digging"	"[one of]To dream of digging, denotes that you will never be in want, but life will be an uphill affair.[or]To dig a hole and find any glittering substance, denotes a favorable turn in fortune; but to dig and open up a vast area of hollow mist, you will be harrassed with real misfortunes and be filled with gloomy forebodings.[or]Water filling the hole that you dig, denotes that in spite of your most strenuous efforts things will not bend to your will.[cycling]"
"a"	"dirt"	"[one of]To dream of dirt signifies sickness and dishonor.[or]To dream you fall in the dirt, signifies that you shall be treacherously dealt with.[cycling]"
"a"	"dirt"	"[one of]To dream of dirty dirt or mud signifies that some one will speak ill of you.[or]If it is clean sand or soil and you do not get befouled with it it is a sign of thrift and good fortune.[or]If some one throws dirt on you it foretells that you will be abused.[cycling]"
"an"	"aura"	"[one of]To dream of discussing any subject relating to aura, denotes that you will reach states of mental unrest, and work to discover the power which influences you from within.[cycling]"
"a"	"dividend"	"[one of]To dream of dividends, augments successful speculations or prosperous harvests.[or]To fail in securing hoped-for dividends, proclaims failure in management or love affairs.[cycling]"
"a"	"diving"	"[one of]To dream of diving in clear water, denotes a favorable termination of some embarrassment.[or]If the water is muddy, you will suffer anxiety at the turn your affairs seem to be taking.[or]To see others diving, indicates pleasant companions.[or]For lovers to dream of diving, denotes the consummation of happy dreams and passionate love.[cycling]"
"a"	"crochet work"	"[one of]To dream of doing crochet work, foretells your entanglement in some silly affair growing out of a too great curiosity about other people's business.[or]Beware of talking too frankly with over-confidential women.[cycling]"
"a"	"pension"	"[one of]To dream of drawing a pension, foretells that you will be aided in your labors by friends.[or]To fail in your application for a pension, denotes that you will lose in an undertaking and suffer the loss of friendships.[cycling]"
"a"	"prize"	"[one of]To dream of drawing a prize in the lottery is a sign of poverty and misery: if you dream that you bought a lottery ticket with a majority of odd numbers on it you may perchance be successful with those numbers but even numbers are worthless in dreams.[or]To dream of getting prizes in any way is a bad omen.[cycling]"
"a"	"cork"	"[one of]To dream of drawing corks at a banquet, signifies that you will soon enter a state of prosperity, in which you will revel in happiness of the most select kind.[or]To dream of medicine corks, denotes sickness and wasted energies.[or]To dream of seeing a fishing cork resting on clear water, denotes success.[or]If water is disturbed you will be annoyed by unprincipled persons.[or]To dream that you are corking bottles, denotes a well organized business and system in your living.[or]For a young woman to dream of drawing champagne corks, indicates she will have a gay and handsome lover who will lavish much attention and money on her.[or]She should look well to her reputation and listen to the warning of parents after this dream.[cycling]"
"a"	"claret"	"[one of]To dream of drinking claret, denotes you will come under the influence of ennobling association.[or]To dream of seeing broken bottles of claret, portends you will be induced to commit immoralities by the false persuasions of deceitful persons.[cycling]"
"a"	"coffee"	"[one of]To dream of drinking coffee, denotes the disapproval of friends toward your marriage intentions.[or]If married, disagreements and frequent quarrels are implied.[or]To dream of dealing in coffee, portends business failures.[or]If selling, sure loss.[or]Buying it, you may with ease retain your credit.[or]For a young woman to see or handle coffee she will be made a by-word if she is not discreet in her actions.[or]To dream of roasting coffee, for a young woman it denotes escape from evil by luckily marrying a stranger.[or]To see ground coffee, foretells successful struggles with adversity.[or]Parched coffee, warns you of the evil attentions of strangers.[or]Green coffee, denotes you have bold enemies who will show you no quarter, but will fight for your overthrow.[cycling]"
"a"	"gin"	"[one of]To dream of drinking gin, forebodes short life and many changes will happen very suddenly, which will be chiefly very pleasant, but that they will end with dissatisfaction.[cycling]"
"a"	"grog"	"[one of]To dream of drinking grog foretells poverty or disgrace or both.[or]If you dream of drinking toddy that tastes very pleasant and agreeable it shows that something will occur which will make you miserable.[cycling]"
"a"	"gruel"	"[one of]To dream of drinking gruel is a good sign if you are sick as it shows a speedy recovery; but if you are well it is a sign that some one will overreach you in a bargain or that you will do some foolish act.[cycling]"
"a"	"milk"	"[one of]To dream of drinking milk, denotes abundant harvest to the farmer and pleasure in the home; for a traveler, it foretells a fortunate voyage.[or]This is a very propitious dream for women.[or]To see milk in large quantities, signifies riches and health.[or]To dream of dealing in milk commercially, denotes great increase in fortune.[or]To give milk away, shows that you will be too benevolent for the good of your own fortune.[or]To spill milk, denotes that you will experience a slight loss and suffer temporary unhappiness at the hands of friends.[or]To dream of impure milk, denotes that you will be tormented with petty troubles.[or]To dream of sour milk, denotes that you will be disturbed over the distress of friends.[or]To dream of trying unsuccessfully to drink milk, signifies that you will be in danger of losing something of value or the friendship of a highly esteemed person.[or]To dream of hot milk, foretells a struggle, but the final winning of riches and desires.[or]To dream of bathing in milk, denotes pleasures and companionships of congenial friends.[cycling]"
"a"	"mineral water"	"[one of]To dream of drinking mineral water, foretells fortune will favor your efforts, and you will enjoy your opportunities to satisfy your cravings for certain pleasures.[cycling]"
"a"	"rum"	"[one of]To dream of drinking rum, foretells that you will have wealth, but will lack moral refinement, as you will lean to gross pleasures.[or]See other intoxicating drinks.[cycling]"
"a"	"tea"	"[one of]To dream of drinking tea or being present at a tea-party is a sign of thrift and domestic happiness: a girl who dreams of meeting her lover at such a party or of drinking tea with him may be sure that he’s all right and she can close her matrimonial bargain with him at once without any risk.[cycling]"
"a"	"punch"	"[one of]To dream of drinking the concoction called punch, denotes that you will prefer selfish pleasures to honorable distinction and morality.[or]To dream that you are punching any person with a club or fist, denotes quarrels and recriminations.[cycling]"
"a"	"vinegar"	"[one of]To dream of drinking vinegar, denotes that you will be exasperated and worried into assenting to some engagement which will fill you with evil foreboding.[or]To use vinegar on vegetables, foretells a deepening of already distressing affairs.[or]To dream of vinegar at all times, denotes inharmonious and unfavorable aspects.[cycling]"
"a"	"wine"	"[one of]To dream of drinking wine is a sign of poverty: if a lover dreams that his sweetheart treats him to a glass of wine it foretells that she will be an unthrifty wife.[cycling]"
"a"	"wine"	"[one of]To dream of drinking wine, forebodes joy and consequent friendships.[or]To dream of breaking bottles of wine, foretells that your love and passion will border on excess.[or]To see barrels of wine, prognosticates great luxury.[or]To pour it from one vessel into another, signifies that your enjoyments will be varied and you will journey to many notable places.[or]To dream of dealing in wine denotes that your occupation will be remunerative.[or]For a young woman to dream of drinking wine, indicates she will marry a wealthy gentleman, but withal honorable.[cycling]"
"a"	"driving"	"[one of]To dream of driving a carriage, signifies unjust criticism of your seeming extravagance.[or]You will be compelled to do things which appear undignified.[or]To dream of driving a public cab, denotes menial labor, with little chance for advancement.[or]If it is a wagon, you will remain in poverty and unfortunate circumstances for some time.[or]If you are driven in these conveyances by others, you will profit by superior knowledge of the world, and will always find some path through difficulties.[or]If you are a man, you will, in affairs with women, drive your wishes to a speedy consummation.[or]If a woman, you will hold men's hearts at low value after succeeding in getting a hold on them.[or]Cab or.[cycling]"
"a"	"chariot"	"[one of]To dream of driving a chariot drawn by wolves, leopards, dogs, tigers, or such like beasts, is only good to such as have great enemies.[or]To dream to be drawn in a chair by men is good.[cycling]"
"a"	"lamp"	"[one of]To dream of dropping or breaking a lighted lamp denotes disappointment.[or]If in your dream you see the bright light of a lamp at a distance from you in the dark and you approach it it shows that you will either have good luck or will be invited to visit somewhere and meet an agreeable person of the opposite sex.[cycling]"
"a"	"drowning"	"[one of]To dream of drowning, denotes loss of property and life; but if you are rescued, you will rise from your present position to one of wealth and honor.[or]To see others drowning, and you go to their relief, signifies that you will aid your friend to high places, and will bring deserved happiness to yourself.[or]For a young woman to see her sweetheart drowned, denotes her bereavement by death.[cycling]"
"a"	"dust"	"[one of]To dream of dust covering you, denotes that you will be slightly injured in business by the failure of others.[or]For a young woman, this denotes that she will be set aside by her lover for a newer flame.[or]If you free yourself of the dust by using judicious measures, you will clear up the loss.[cycling]"
"a"	"dying"	"[one of]To dream of dying, foretells that you are threatened with evil from a source that has contributed to your former advancement and enjoyment.[or]To see others dying, forebodes general ill luck to you and to your friends.[or]To dream that you are going to die, denotes that unfortunate inattention to your affairs will depreciate their value.[or]Illness threatens to damage you also.[or]To see animals in the throes of death, denotes escape from evil influences if the animal be wild or savage.[or]It is an unlucky dream to see domestic animals dying or in agony.[cycling]"
"an"	"eating"	"[one of]To dream of eating alone, signifies loss and melancholy spirits.[or]To eat with others, denotes personal gain, cheerful environments and prosperous undertakings.[or]If your daughter carries away the platter of meat before you are done eating, it foretells that you will have trouble and vexation from those beneath you or dependent upon you.[or]The same would apply to a waiter or waitress.[or]See other subjects similar.[cycling]"
"a"	"bacon"	"[one of]To dream of eating bacon is good, if some one is eating with you and hands are clean.[or]Rancid bacon, is dulness of perception and unsatisfactory states will worry you.[or]To dream of curing bacon is bad, if not clear of salt and smoke.[or]If clear, it is good.[cycling]"
"a"	"broth"	"[one of]To dream of eating broth is a good sign and signifies profit and gain.[cycling]"
"a"	"broth"	"[one of]To dream of eating broths or soups is a good sign and denotes profit and gain.[cycling]"
"a"	"cheese"	"[one of]To dream of eating cheese, denotes great disappointments and sorrow.[or]No good of any nature can be hoped for.[or]Cheese is generally a bad dream.[cycling]"
"a"	"butter"	"[one of]To dream of eating fresh, golden butter, is a sign of good health and plans well carried out; it will bring unto you possessions, wealth and knowledge.[or]To eat rancid butter, denotes a competency acquired through struggles of manual labor.[or]To sell butter, denotes small gain.[cycling]"
"a"	"gravy"	"[one of]To dream of eating gravy, portends failing health and disappointing business.[cycling]"
"a"	"hominy"	"[one of]To dream of eating hominy with a relish is a sign that you will marry below your station in life or else you will entertain a new acquaintance who is much below you in position who will eventually command your esteem.[or]To an educated young girl such a dream predicts a runaway match.[cycling]"
"a"	"cauliflower"	"[one of]To dream of eating it, you will be taken to task for neglect of duty.[or]To see it growing, your prospects will brighten after a period of loss.[or]For a young woman to see this vegetable in a garden, denotes that she will marry to please her parents and not herself.[cycling]"
"a"	"jam"	"[one of]To dream of eating jam, if pure, denotes pleasant surprises and journeys.[or]To dream of making jam, foretells to a woman a happy home and appreciative friends.[cycling]"
"a"	"jelly"	"[one of]To dream of eating jelly, many pleasant interruptions will take place.[or]For a woman to dream of making jelly, signifies she will enjoy pleasant reunions with friends.[cycling]"
"a"	"lettuce"	"[one of]To dream of eating lettuce is a sign of health and happiness provided that it looks green and nice and tastes good; wilted or wormy lettuce shadows forth vexation and trouble.[cycling]"
"a"	"macaroni"	"[one of]To dream of eating macaroni, denotes small losses.[or]To see it in large quantities, denotes that you will save money by the strictest economy.[or]For a young woman, this dream means that a stranger will enter her life.[cycling]"
"a"	"marmalade"	"[one of]To dream of eating marmalade, denotes sickness and much dissatisfaction.[or]For a young woman to dream of making it, denotes unhappy domestic associations.[cycling]"
"an"	"oatmeal"	"[one of]To dream of eating oatmeal, signifies the enjoyment of worthily earned fortune.[or]For a young woman to dream of preparing it for the table, denotes that she will soon preside over the destiny of others.[cycling]"
"a"	"pancake"	"[one of]To dream of eating pancakes, denotes that you will have excellent success in all enterprises undertaken at this time.[or]To cook them, denotes that you will be economical and thrifty in your home.[cycling]"
"a"	"rice"	"[one of]To dream of eating rice denotes health: if you imagine that you see large quantities of rice it foretells to one who does not live in a rice country a successful and pleasant journey; and to those who live there it predicts gain and riches.[cycling]"
"a"	"rice"	"[one of]To dream of eating rice, denotes abundance of instruction.[cycling]"
"a"	"salad"	"[one of]To dream of eating salad, foretells sickness and disagreeable people around you.[or]For a young woman to dream of making it, is a sign that her lover will be changeable and quarrelsome.[cycling]"
"a"	"venison"	"[one of]To dream of eating venison is a sign that you will travel: if you imagine you see large saddles of venison in market it foretells a journey for business purposes which will be profitable.[cycling]"
"an"	"electricity"	"[one of]To dream of electricity, denotes there will be sudden changes about you, which will not afford you either advancement or pleasure.[or]If you are shocked by it you will face a deplorable danger.[or]To see live electrical wire, foretells that enemies will disturb your plans, which have given you much anxiety in forming.[or]To dream that you can send a package or yourself out over a wire with the same rapidity that a message can be sent, denotes you will finally overcome obstacles and be able to use your enemies' plans to advance yourself.[cycling]"
"an"	"elopement"	"[one of]To dream of eloping is unfavorable.[or]To the married, it denotes that you hold places which you are unworthy to fill, and if your ways are not rectified your reputation will be at stake.[or]To the unmarried, it foretells disappointments in love and the unfaithfulness of men.[or]To dream that your lover has eloped with some one else, denotes his or her unfaithfulness.[or]To dream of your friend eloping with one whom you do not approve, denotes that you will soon hear of them contracting a disagreeable marriage.[cycling]"
"an"	"embrace"	"[one of]To dream of embracing relatives is a warning of treachery; if friends disappointments; if one unknown embrace you you will travel; the embrace of a woman brings good luck.[cycling]"
"an"	"embrace"	"[one of]To dream of embracing your husband or wife, as the case may be, in a sorrowing or indifferent way, denotes that you will have dissensions and accusations in your family, also that sickness is threatened.[or]To embrace relatives, signifies their sickness and unhappiness.[or]For lovers to dream of embracing, foretells quarrels and disagreements arising from infidelity.[or]If these dreams take place under auspicious conditions, the reverse may be expected.[or]If you embrace a stranger, it signifies that you will have an unwelcome guest.[cycling]"
"a"	"jar"	"[one of]To dream of empty jars, denotes impoverishment and distress.[or]To see them full, you will be successful.[or]If you buy jars, your success will be precarious and your burden will be heavy.[or]To see broken jars, distressing sickness or deep disappointment awaits you.[cycling]"
"a"	"combat"	"[one of]To dream of engaging in combat, you will find yourself seeking to ingratiate your affections into the life and love of some one whom you know to be another's, and you will run great risks of losing your good reputation in business.[or]It denotes struggles to keep on firm ground.[or]For a young woman to dream of seeing combatants, signifies that she will have choice between lovers, both of whom love her and would face death for her.[cycling]"
"a"	"door"	"[one of]To dream of entering a door, denotes slander, and enemies from whom you are trying in vain to escape.[or]This is the same of any door, except the door of your childhood home.[or]If it is this door you dream of entering, your days will be filled with plenty and congeniality.[or]To dream of entering a door at night through the rain, denotes, to women, unpardonable escapades; to a man, it is significant of a drawing on his resources by unwarranted vice, and also foretells assignations.[or]To see others go through a doorway, denotes unsuccessful attempts to get your affairs into a paying condition.[or]It also means changes to farmers and the political world.[or]To an author, it foretells that the reading public will reprove his way of stating facts by refusing to read his later works.[or]To dream that you attempt to close a door, and it falls from its hinges, injuring some one, denotes that malignant evil threatens your friend through your unintentionally wrong advice.[or]If you see another attempt to lock a door, and it falls from its hinges, you will have knowledge of some friend's misfortune and be powerless to aid him.[cycling]"
"a"	"bulldog"	"[one of]To dream of entering strange premises and have a bulldog attack you, you will be in danger of transgressing the laws of your country by using perjury to obtain your desires.[or]If one meets you in a friendly way, you will rise in life, regardless of adverse criticisms and seditious interference of enemies.[cycling]"
"a"	"malice"	"[one of]To dream of entertaining malice for any person, denotes that you will stand low in the opinion of friends because of a disagreeable temper.[or]Seek to control your passion.[or]If you dream of persons maliciously using you, an enemy in friendly garb is working you harm.[cycling]"
"an"	"escape"	"[one of]To dream of escape from injury or accidents, is usually favorable.[or]If you escape from some place of confinement, it signifies your rise in the world from close application to business.[or]To escape from any contagion, denotes your good health and prosperity.[or]If you try to escape and fail, you will suffer from the design of enemies, who will slander and defraud you.[cycling]"
"an"	"explosion"	"[one of]To dream of explosions, portends that disapproving actions of those connected with you will cause you transient displeasure and loss, and that business will also displease you.[or]To think your face, or the face of others, is blackened or mutilated, signifies you will be accused of indiscretion which will be unjust, though circumstances may convict you.[or]To see the air filled with smoke and de'bris, denotes unusual dissatisfaction in business circles and much social antagonism.[or]To think you are enveloped in the flames, or are up in the air where you have been blown by an explosion, foretells that unworthy friends will infringe on your rights and will abuse your confidence.[or]Young women should be careful of associates of the opposite sex after a dream of this character.[cycling]"
"a"	"fainting"	"[one of]To dream of fainting, signifies illness in your family and unpleasant news of the absent.[or]If a young woman dreams of fainting, it denotes that she will fall into ill health and experience disappointment from her careless way of living.[cycling]"
"a"	"ditch"	"[one of]To dream of falling in a ditch, denotes degradation and personal loss; but if you jump over it, you will live down any suspicion of wrong-doing.[cycling]"
"a"	"pit"	"[one of]To dream of falling into a pit, shows that in some way heavy misfortune is about to attend you; that your sweetheart is false, and prefers another.[or]To a sailor, it forebodes some sad disaster at the next port you touch at.[or]To dream you are in a pit, and that you climb out of it, foreshows that you will have many enemies and experience much trouble, but that you will overcome them, marry well, and become rich; to sailors, it denotes that they will experience shipwreck, and be cast on a foreign shore, where they will be hospitably received, and marry rich and handsome wives and live at ease.[cycling]"
"a"	"rat-trap"	"[one of]To dream of falling into a rat-trap, denotes that you will be victimized and robbed of some valuable object.[or]To see an empty one, foretells the absence of slander or competition.[or]A broken one, denotes that you will be rid of unpleasant associations.[or]To set one, you will be made aware of the designs of enemies, but the warning will enable you to outwit them.[cycling]"
"a"	"knee"	"[one of]To dream of falling on the knees denotes misfortune in business.[or]To see a woman’s knees good luck and marriage to the girl of your choice.[or]For a woman to see a man’s knee shows that she will have many male children.[cycling]"
"a"	"fast"	"[one of]To dream of fasting or going without food until you are very hungry is a sign of a quarrel; but it foretells success in love and business.[cycling]"
"a"	"lazy"	"[one of]To dream of feeling lazy, or acting so, denotes you will make a mistake in the formation of enterprises, and will suffer keen disappointment.[or]For a young woman to think her lover is lazy, foretells she will have bad luck in securing admiration.[or]Her actions will discourage men who mean marriage.[cycling]"
"a"	"flame"	"[one of]To dream of fighting flames, foretells that you will have to put forth your best efforts and energy if you are successful in amassing wealth.[cycling]"
"a"	"figure"	"[one of]To dream of figures, indicates great mental distress and wrong.[or]You will be the loser in a big deal if not careful of your actions and conversation.[cycling]"
"a"	"pocket-book"	"[one of]To dream of finding a pocket-book full of money is a sign of riches but if it contains no money it foretells a disappointment: if you dream you lose your pocket-book it foreshadows success in business.[cycling]"
"a"	"purse"	"[one of]To dream of finding a purse, is a very favorable omen.[or]It denotes great happiness, and unlooked for prosperity.[or]In love, it is the sure token of a speedy marriage, and of being dearly beloved by the object of your affection.[or]To dream you lose your purse, shows the loss of a friend.[or]In other respects, it denotes that some pleasant adventure is about to happen to you, by which you will be the gainer; to the sailor, it denotes the loss of his sweetheart whilst at sea.[cycling]"
"a"	"purse"	"[one of]To dream of finding an empty purse shadows forth disappointment; if the purse has plenty of money in it your luck will be excellent—the more money the better fortune: if it has in it large gold pieces or large bills you will become rich either by marriage or inheritance.[cycling]"
"a"	"money"	"[one of]To dream of finding money is an excellent omen as it foretells that you will soon get some: if in your dream you see bank bills of a large denomination or large gold pieces the sign is similar: to see small pieces of money is not so good though it is a pretty fair dream.[or]To dream of receiving money is a good omen; in love it foretells marriage and children.[or]To dream you lose money is a proof you will be unsuccessful in some favorite pursuit.[cycling]"
"a"	"money"	"[one of]To dream of finding money, denotes small worries, but much happiness.[or]Changes will follow.[or]To pay out money, denotes misfortune.[or]To receive gold, great prosperity and unalloyed pleasures.[or]To lose money, you will experience unhappy hours in the home and affairs will appear gloomy.[or]To count your money and find a deficit, you will be worried in making payments.[or]To dream that you steal money, denotes that you are in danger and should guard your actions.[or]To save money, augurs wealth and comfort.[or]To dream that you swallow money, portends that you are likely to become mercenary.[or]To look upon a quantity of money, denotes that prosperity and happiness are within your reach.[or]To dream you find a roll of currency, and a young woman claims it, foretells you will lose in some enterprise by the interference of some female friend.[or]The dreamer will find that he is spending his money unwisely and is living beyond his means.[or]It is a dream of caution.[or]Beware lest the innocent fancies of your brain make a place for your money before payday.[cycling]"
"a"	"gunt"	"[one of]To dream of firing a gun or hearing the report of a gun denotes strife: if you imagine some friend fires it it shows that there.[or]Will be a difficulty with him.[or]If you dream of killing a bird squirrel or other animal by shooting it it foretells that you will act rashly in some quarrel.[or]For a lover to dream of firing a gun is a sign he will have trouble with his sweetheart.[cycling]"
"a"	"flambeau"	"[one of]To dream of flambeaux, is a sign of trouble, excitement and distress.[or]To the merchant, losses at sea; to the mechanic, want of employment; to lovers, deceit and treachery.[cycling]"
"a"	"flight"	"[one of]To dream of flight, signifies disgrace and unpleasant news of the absent.[or]For a young woman to dream of flight, indicates that she has not kept her character above reproach, and her lover will throw her aside.[or]To see anything fleeing from you, denotes that you will be victorious in any contention.[cycling]"
"a"	"floating"	"[one of]To dream of floating, denotes that you will victoriously overcome obstacles which are seemingly overwhelming you.[or]If the water is muddy your victories will not be gratifying.[cycling]"
"a"	"flour"	"[one of]To dream of flour, denotes a frugal but happy life.[or]For a young woman to dream that she sees flour on herself, denotes that she will be ruled by her husband, and that her life will be full of pleasant cares.[or]To dream of dealing in flour, denotes hazardous speculations.[cycling]"
"a"	"fly-paper"	"[one of]To dream of fly-paper, signifies ill health and disrupted friendships.[cycling]"
"a"	"kite"	"[one of]To dream of flying a kite is a sign that you will soon write a letter to some friend or acquaintance.[or]For a girl to dream of seeing a kite in the air predicts that she will receive a letter from a young man—whether a lover or not is uncertain.[cycling]"
"a"	"kite"	"[one of]To dream of flying a kite, denotes a great show of wealth, or business, but with little true soundness to it all.[or]To see the kite thrown upon the ground, foretells disappointment and failure.[or]To dream of making a kite, you will speculate largely on small means and seek to win the one you love by misrepresentations.[or]To see children flying kites, denotes pleasant and light occupation.[or]If the kite ascends beyond the vision high hopes and aspirations will resolve themselves into disappointments and loss.[cycling]"
"a"	"flying"	"[one of]To dream of flying high through a space, denotes marital calamities.[or]To fly low, almost to the ground, indicates sickness and uneasy states from which the dreamer will recover.[or]To fly over muddy water, warns you to keep close with your private affairs, as enemies are watching to enthrall you.[or]To fly over broken places, signifies ill luck and gloomy surroundings.[or]If you notice green trees and vegetation below you in flying, you will suffer temporary embarrassment, but will have a flood of prosperity upon you.[or]To dream of seeing the sun while flying, signifies useless worries, as your affairs will succeed despite your fears of evil.[or]To dream of flying through the firmament passing the moon and other planets; foretells famine, wars, and troubles of all kinds.[or]To dream that you fly with black wings, portends bitter disappointments.[or]To fall while flying, signifies your downfall.[or]If you wake while falling, you will succeed in reinstating yourself.[or]For a young man to dream that he is flying with white wings above green foliage, foretells advancement in business, and he will also be successful in love.[or]If he dreams this often it is a sign of increasing prosperity and the fulfilment of desires.[or]If the trees appear barren or dead, there will be obstacles to combat in obtaining desires.[or]He will get along, but his work will bring small results.[or]For a woman to dream of flying from one city to another, and alighting on church spires, foretells she will have much to contend against in the way of false persuasions and declarations of love.[or]She will be threatened with a disastrous season of ill health, and the death of some one near to her may follow.[or]For a young woman to dream that she is shot at while flying, denotes enemies will endeavor to restrain her advancement into higher spheres of usefulness and prosperity.[cycling]"
"a"	"partnership"	"[one of]To dream of forming a partnership with a man, denotes uncertain and fluctuating money affairs.[or]If your partner be a woman, you will engage in some enterprise which you will endeavor to keep hidden from friends.[or]To dissolve an unpleasant partnership, denotes that things will arrange themselves agreeable to your desires; but if the partnership was pleasant, there will be disquieting news and disagreeable turns in your affairs.[cycling]"
"a"	"friend"	"[one of]To dream of friends being well and happy, denotes pleasant tidings of them, or you will soon see them or some of their relatives.[or]To see your friend troubled and haggard, sickness or distress is upon them.[or]To see your friends dark-colored, denotes unusual sickness or trouble to you or to them.[or]To see them take the form of animals, signifies that enemies will separate you from your closest relations.[or]To see your friend who dresses in somber colors in flaming red, foretells that unpleasant things will transpire, causing you anxiety if not loss, and that friends will be implicated.[or]To dream you see a friend standing like a statue on a hill, denotes you will advance beyond present pursuits, but will retain former impressions of justice and knowledge, seeking these through every change.[or]If the figure below be low, you will ignore your friends of former days in your future advancement.[or]If it is on a plane or level with you, you will fail in your ambition to reach other spheres.[or]If you seem to be going from it, you will force yourself to seek a change in spite of friendly ties or self-admonition.[or]To dream you see a friend with a white cloth tied over his face, denotes that you will be injured by some person who will endeavor to keep up friendly relations with you.[or]To dream that you are shaking hands with a person who has wronged you, and he is taking his departure and looks sad, foretells you will have differences with a close friend and alienation will perhaps follow.[or]You are most assuredly nearing loss of some character.[cycling]"
"a"	"fruit"	"[one of]To dream of fruit which is ripe and fair to look upon is an excellent omen as it foretells the most perfect success in all worldly matters: if the fruit is green or defective it indicates trouble with your success.[or]If you dream of eating fruit that proves to be sour or rotten it shows disappointment: if a young girl dreams this it is a sign that her lover will deceive her.[cycling]"
"a"	"pail"	"[one of]To dream of full pails of milk, is a sign of fair prospects and pleasant associations.[or]An empty pail is a sign of famine, or bad crops.[or]For a young woman to be carrying a pail, denotes household employment.[cycling]"
"a"	"furt"	"[one of]To dream of fur signifies much good; it denotes that your sweetheart is kind and true and that if you marry you will be very happy; it denotes to the merchant a good establishment in business to the sailor a profitable voyage.[cycling]"
"a"	"gaiter"	"[one of]To dream of gaiters, foretells pleasant amusements and rivalries.[cycling]"
"a"	"gambling"	"[one of]To dream of gambling is a sign of poverty and disgrace.[or]If in your dream you see others gamble and do not engage in it yourself it shows that some of your friends or relatives will have a reverse of fortune and become poor.[cycling]"
"a"	"game"	"[one of]To dream of game, either shooting or killing or by other means, denotes fortunate undertakings; but selfish motions; if you fail to take game on a hunt, it denotes bad management and loss.[cycling]"
"a"	"gasoline"	"[one of]To dream of gasoline, denotes you have a competency coming to you through a struggling source.[cycling]"
"a"	"cowslip"	"[one of]To dream of gathering cowslips, portends unhappy ending of seemingly close and warm friendships; but seeing them growing, denotes a limited competency for lovers.[or]This is a sinister dream.[or]To see them in full bloom, denotes a crisis in your affairs.[or]The breaking up of happy homes may follow this dream.[cycling]"
"a"	"saffron"	"[one of]To dream of gathering saffron or of drinking a decoction of the herb is a sign of health and wealth: if the flowers that you gather look clear and healthy it foretells that you will get just so much gold.[cycling]"
"a"	"portrait"	"[one of]To dream of gazing upon the portrait of some beautiful person, denotes that, while you enjoy pleasure, you can but feel the disquieting and treacherousness of such joys.[or]Your general affairs will suffer loss after dreaming of portraits.[or]Photographs, and.[cycling]"
"a"	"goose"	"[one of]To dream of geese is a forerunner of good; expect to see a long-absent friend.[or]They denote success and riches to the dreamer in the furtherance of his pursuits.[or]In love, they augur speedy marriage and fidelity in your sweetheart.[cycling]"
"a"	"mud"	"[one of]To dream of getting covered with mud by having it splashed over you is a sign that you will be belied and talked about.[cycling]"
"a"	"furniture"	"[one of]To dream of getting new furniture that pleases you, is good.[or]If it seems not to please, the dream is a bad one.[or]To be pleased with furniture, denotes health, happiness and prosperity.[or]To display furniture, denotes trouble, perhaps a death or a funeral.[cycling]"
"a"	"party"	"[one of]To dream of giving a large and sumptuous party to your friends is a sign of losses and poverty: if you imagine you go to such a party it foretells that you will be asked to assist some one in distress.[cycling]"
"a"	"childbed"	"[one of]To dream of giving child birth, denotes fortunate circumstances and safe delivery of a handsome child.[or]For an unmarried woman to dream of being in childbed, denotes unhappy changes from honor to evil and low estates.[cycling]"
"a"	"goat"	"[one of]To dream of goats wandering around a farm, is significant of seasonable weather and a fine yield of crops.[or]To see them otherwise, denotes cautious dealings and a steady increase of wealth.[or]If a billy goat butts you, beware that enemies do not get possession of your secrets or business plans.[or]For a woman to dream of riding a billy goat, denotes that she will be held in disrepute because of her coarse and ill-bred conduct.[or]If a woman dreams that she drinks goat's milk, she will marry for money and will not be disappointed.[cycling]"
"an"	"emperor"	"[one of]To dream of going abroad and meeting the emperor of a nation in your travels, denotes that you will make a long journey, which will bring neither pleasure nor much knowledge.[cycling]"
"a"	"tunnel"	"[one of]To dream of going through a tunnel is bad for those in business and in love.[or]To see a train coming towards you while in a tunnel, foretells ill health and change in occupation.[or]To pass through a tunnel in a car, denotes unsatisfactory business, and much unpleasant and expensive travel.[or]To see a tunnel caving in, portends failure and malignant enemies.[or]To look into one, denotes that you will soon be compelled to face a desperate issue.[cycling]"
"a"	"mire"	"[one of]To dream of going through mire, indicates that your dearest wishes and plans will receive a temporary check by the intervention of unusual changes in your surroundings.[cycling]"
"a"	"wake"	"[one of]To dream of going to a wake where drinking and howling is going on is a sign of poverty and misery: if a girl dreams this it foretells her speedy marriage with a man who will turn out to be a miserable drunkard.[or]If a young man dreams of seeing his sweetheart at a wake he had better back out from the bargain as she will never be of much account and may become a drunkard.[cycling]"
"a"	"seat"	"[one of]To dream of going to sea in a ship or steamer is a sign that you will be fortunate in money matters: storms and perils at sea foretell difficulties which may be overcome: if you dream you are seasick it denotes continued health.[or]If a girl dreams of going to sea and having a pleasant voyage she will marry rich and love her husband; but storms and perils point to quarrels with him.[cycling]"
"an"	"opera"	"[one of]To dream of going to the opera is a sign you will travel: if you hear a new singer that delights you it foretells that you will make a new acquaintance on some journey: if an engaged young lady dreams of the opera her wedding journey is thus shadowed forth.[cycling]"
"a"	"hill"	"[one of]To dream of going up a hill is a sign you will rise in the world and of going down hill the reverse; if in your dream you seem to be approaching a smooth high hill it shows that you will shortly have a piece of good fortune; but if the hill be rugged and stony it foretells difficulties in connection with the good fortune.[cycling]"
"a"	"ladder"	"[one of]To dream of going up a ladder signifies that you will be a person of some consequence yet poor: if you imagine you are in danger of falling it shows that a person who envies your position will attempt to injure you; if you dream of going down a ladder it particularly denotes poverty though it may allude to some misfortune that will overtake you.[cycling]"
"a"	"steeple"	"[one of]To dream of going up to the top of a steeple and looking off at a distance is a sign that you will increase your property or effects: if a girl dreams this it foretells that she will marry above her present position.[cycling]"
"a"	"scaffold"	"[one of]To dream of going upon a high scaffold shows that you will rise in the world: if in your dream you imagine that you fall from a scaffold or from any high place it shadows forth a misfortune that will make you poorer: a girl who dreams of climbing upon a scaffold will positively marry a rich man or one of distinction who is far above her in position.[cycling]"
"a"	"tower"	"[one of]To dream of going upon a high tower and looking off on a beautiful landscape foretells that you will acquire land either by purchase or inheritance: if you look off upon the water it is a sign of a journey by sea during which you will acquire riches: if birds are flying around the tower they foretell so many troubles.[cycling]"
"a"	"goldfish"	"[one of]To dream of goldfish, is a prognostic of many successful and pleasant adventures.[or]For a young woman, this dream is indicative of a wealthy union with a pleasing man.[or]If the fish are sick or dead, heavy disappointments will fall upon her.[cycling]"
"a"	"gravel"	"[one of]To dream of gravel, denotes unfruitful schemes and enterprises.[or]If you see gravel mixed with dirt, it foretells you will unfortunately speculate and lose good property.[cycling]"
"a"	"dish"	"[one of]To dream of handling dishes, denotes good fortune; but if from any cause they should be broken, this signifies that fortune will be short-lived for you.[or]To see shelves of polished dishes, denotes success in marriage.[or]To dream of dishes, is prognostic of coming success and gain, and you will be able to fully appreciate your good luck.[or]Soiled dishes, represent dissatisfaction and an unpromising future.[cycling]"
"an"	"oar"	"[one of]To dream of handling oars, portends disappointments for you, inasmuch as you will sacrifice your own pleasure for the comfort of others.[or]To lose an oar, denotes vain efforts to carry out designs satisfactorily.[or]A broken oar represents interruption in some anticipated pleasure.[cycling]"
"a"	"harvest"	"[one of]To dream of harvest time, is a forerunner of prosperity and pleasure.[or]If the harvest yields are abundant, the indications are good for country and state, as political machinery will grind to advance all conditions.[or]A poor harvest is a sign of small profits.[cycling]"
"a"	"hatching"	"[one of]To dream of hatching fowls of any kind is a sign of thrift; if you imagine in your dream that a hen comes off with a very large brood of chickens it shadows forth so much cash to be made by you in some bargain.[cycling]"
"a"	"sword"	"[one of]To dream of having a sword is a sign of poverty: if you dream of seeing a man flourish one of these weapons it foretells you will make a loss.[or]A young girl who imagines her lover wears a sword had better give up all ideas of silks and satins and learn how to cook and wash for she will be a poor man’s wife.[cycling]"
"an"	"orange"	"[one of]To dream of having an abundance of oranges shadows forth that you will get just so much yellow gold: if you dream of eating them it promises you health: if you give them to friends it foretells that you will be honored and esteemed: if a girl dreams that her lover presents her with fine-looking oranges he will undoubtedly bring her a fortune when she marries.[cycling]"
"a"	"yellow"	"[one of]To dream of having any yellow article presented to you is a sign you will get gold: if a girl dreams that her lover gives her yellow flowers it foretells that she will marry rich.[cycling]"
"a"	"flux"	"[one of]To dream of having flux, or thinking that you are thus afflicted, denotes desperate or fatal illness will overtake you or some member of your family.[or]To see others thus afflicted, implies disappointment in carrying out some enterprise through the neglect of others.[or]Inharmonious states will vex you.[cycling]"
"a"	"jelly"	"[one of]To dream of having pots of jelly given to you or that you are eating jelly and that plenty of it is around is a sure sign of long life and good fortune generally; as many pots as are given to you or as you may have so many generations will you live to see.[or]The same rule applies to preserved fruits.[cycling]"
"a"	"quartan"	"[one of]To dream of having this complaint is good, particularly to a married person.[cycling]"
"a"	"scratch"	"[one of]To dream of having your face scratched is a sign that somebody has been disparaging your good looks: if a girl imagines in her dream that she has scratched herself with a pin it foretells that scandal is afloat relative to her conduct with her lover or some other gentleman.[cycling]"
"a"	"horoscope"	"[one of]To dream of having your horoscope drawn by an astrologist, foretells unexpected changes in affairs and a long journey; associations with a stranger will probably happen.[or]If the dreamer has the stars pointed out to him, as his fate is being read, he will find disappointments where fortune and pleasure seem to await him.[cycling]"
"a"	"portrait"	"[one of]To dream of having your portrait taken is a sign some one will compliment your good looks; but if you are dissatisfied and think it a bad likeness the compliment will run in a contrary direction and you will be called frightfully ugly-looking behind your back.[cycling]"
"a"	"head"	"[one of]To dream of heads in any way is a good omen: if you dream your own head is very large it shows that you will probably become distinguished; if you see a large-headed person in your dream it is a sign you will make the acquaintance of some one who will benefit you.[cycling]"
"a"	"cock-crowing"	"[one of]To dream of hearing a cock crowing in the morning, is significant of good.[or]If you be single, it denotes an early marriage and a luxurious home.[or]To hear one at night is despair, and cause for tears you will have.[or]To dream of seeing cocks fight, you will leave your family because of quarrels and infidelity.[or]This dream usually announces some unexpected and sorrowful events.[or]The cock warned the.[or]Peter when he was about to perjure himself.[or]It may also warn you in a dream when the meshes of the world are swaying you from ``the straight line'' of spiritual wisdom.[cycling]"
"a"	"duet"	"[one of]To dream of hearing a duet played, denotes a peaceful and even existence for lovers.[or]No quarrels, as is customary in this sort of thing.[or]Business people carry on a mild rivalry.[or]To musical people, this denotes competition and wrangling for superiority.[or]To hear a duet sung, is unpleasant tidings from the absent; but this will not last, as some new pleasure will displace the unpleasantness.[cycling]"
"a"	"fife"	"[one of]To dream of hearing a fife, denotes that there will be an unexpected call on you to defend your honor, or that of some person near to you.[or]To dream that you play one yourself, indicates that whatever else may be said of you, your reputation will remain intact.[or]If a woman has this dream, she will have a soldier husband.[cycling]"
"a"	"text"	"[one of]To dream of hearing a minister reading his text, denotes that quarrels will lead to separation with some friend.[or]To dream that you are in a dispute about a text, foretells unfortunate adventures for you.[or]If you try to recall a text, you will meet with unexpected difficulties.[or]If you are repeating and pondering over one, you will have great obstacles to overcome if you gain your desires.[cycling]"
"a"	"tocsin"	"[one of]To dream of hearing a tocsin sounded, augurs a strife from which you will come victorious.[or]For a woman, this is a warning of separation from her husband or lover.[cycling]"
"a"	"music"	"[one of]To dream of hearing harmonious music, omens pleasure and prosperity.[or]Discordant music foretells troubles with unruly children, and unhappiness in the household.[cycling]"
"a"	"hissing"	"[one of]To dream of hearing hissing noises such as steam makes or of geese hissing is a sign of shame.[or]If a girl dreams this it foretells that she will do something she is ashamed of: to a man it is a sign he will do an undignified act or one that will injure his prospects.[cycling]"
"a"	"flute"	"[one of]To dream of hearing notes from a flute, signifies a pleasant meeting with friends from a distance, and profitable engagements.[or]For a young woman to dream of playing a flute, denotes that she will fall in love because of her lover's engaging manners.[cycling]"
"a"	"piano"	"[one of]To dream of hearing pleasant and lively tunes on the piano is a sign of thrift and domestic happiness; but if you dream of buying or that any one presents you with a piano it foreshadows poverty; it is a bad omen for a girl to dream she has got a new piano.[cycling]"
"a"	"music"	"[one of]To dream of hearing strains of sweet music denotes joy and happiness.[or]If a girl who has a lover dreams this he will surprise her either with a splendid present or with an invitation to go somewhere where she will be delighted and enjoy herself much.[cycling]"
"a"	"gramophone"	"[one of]To dream of hearing the gramophone, foretells the advent of some new and pleasing comrade who will lend himself willingly to advance your enjoyment.[or]If it is broken, some fateful occurrence will thwart and defeat delights that you hold in anticipation.[cycling]"
"a"	"sea"	"[one of]To dream of hearing the lonely sighing of the sea, foretells that you will be fated to spend a weary and unfruitful life devoid of love and comradeship.[or]Dreams of the sea, prognosticate unfulfilled anticipations, while pleasures of a material form are enjoyed, there is an inward craving for pleasure that flesh cannot requite.[or]For a young woman to dream that she glides swiftly over the sea with her lover, there will come to her sweet fruition of maidenly hopes, and joy will stand guard at the door of the consummation of changeless vows.[cycling]"
"an"	"accordion"	"[one of]To dream of hearing the music of an accordion, denotes that you will engage in amusement which will win you from sadness and retrospection.[or]You will by this means be enabled to take up your burden more cheerfully.[or]For a young woman to dream that she is playing an accordion, portends that she will win her lover by some sad occurrence; but, notwithstanding which, the same will confer lasting happiness upon her union.[or]If the accordion gets out of tune, she will be saddened by the illness or trouble of her lover.[cycling]"
"an"	"organ"	"[one of]To dream of hearing the solemn and enchanting music of a church organ is a sad omen to young girls as it foretells their early death: if a gentleman dreams this it points to the death of some young girl in whom he takes an interest and perhaps to his sweetheart if he has one.[or]To imagine you hear some lively tune on a street organ isalso a bad omen as it foretells that you will soon attend a funeral.[cycling]"
"a"	"thunder"	"[one of]To dream of hearing thunder, foretells you will soon be threatened with reverses in your business.[or]To be in a thunder shower, denotes trouble and grief are close to you.[or]To hear the terrific peals of thunder, which make the earth quake, portends great loss and disappointment.[cycling]"
"a"	"voice"	"[one of]To dream of hearing voices, denotes pleasant reconciliations, if they are calm and pleasing; high-pitched and angry voices, signify disappointments and unfavorable situations.[or]To hear weeping voices, shows that sudden anger will cause you to inflict injury upon a friend.[or]If you hear the voice of God, you will make a noble effort to rise higher in unselfish and honorable principles, and will justly hold the admiration of high-minded people.[or]For a mother to hear the voice of her child, is a sign of approaching misery, perplexity and grievous doubts.[or]To hear the voice of distress, or a warning one calling to you, implies your own serious misfortune or that of some one close to you.[or]If the voice is recognized, it is often ominous of accident or illness, which may eliminate death or loss.[cycling]"
"a"	"heaven"	"[one of]To dream of heaven, and that you are there, signifies grandeur and glory.[cycling]"
"a"	"thunder"	"[one of]To dream of heavy thunder denotes large crops to farmers: to tradesmen mechanics or speculators it foretells a big business or a successful speculation: if you are terrified by thunder so much the better.[cycling]"
"a"	"hemp"	"[one of]To dream of hemp, denotes you will be successful in all undertakings, especially large engagements.[or]For a young woman to dream that some accident befalls her through cultivating hemp, foretells the fatal quarrel and separation from her friend.[cycling]"
"a"	"hen"	"[one of]To dream of hens, denotes pleasant family reunions with added members.[cycling]"
"a"	"high tide"	"[one of]To dream of high tide is indicative of favorable progression in your affairs.[cycling]"
"a"	"hissing"	"[one of]To dream of hissing persons, is an omen that you will be displeased beyond endurance at the discourteous treatment shown you while among newly made acquaintances.[or]If they hiss you, you will be threatened with the loss of a friend.[cycling]"
"a"	"torch"	"[one of]To dream of holding a burning torch in the hand, is a good sign to those that are young, for it signifies they shall enjoy their loves, accomplish their designs, overcome their enemies, and gain honor and good from all persons.[or]To dream you see a torch extinguished or darkened, signifies sadness, sickness and poverty.[cycling]"
"a"	"hominy"	"[one of]To dream of hominy, denotes pleasant love-making will furnish you interesting recreation from absorbing study and planning for future progression.[cycling]"
"a"	"hornet"	"[one of]To dream of hornets, shows you will have to do with people who will assault and discredit you.[cycling]"
"a"	"horseradish"	"[one of]To dream of horseradish, foretells pleasant associations with intellectual and congenial people.[or]Fortune is also expressed in this dream.[cycling]"
"a"	"hyssop"	"[one of]To dream of hyssop, denotes you will have grave charges preferred against you; and, if a woman, your reputation will be endangered.[cycling]"
"an"	"ice"	"[one of]To dream of ice is a favorable omen.[or]To the lover it shows your sweetheart is of an amiable temper and faithful.[or]To dream you are sliding or skating on the ice, denotes that you will pursue some unprofitable concern and be much worried by your engagements.[cycling]"
"an"	"ice"	"[one of]To dream of ice, betokens much distress, and evil-minded persons will seek to injure you in your best work.[or]To see ice floating in a stream of clear water, denotes that your happiness will be interrupted by ill-tempered and jealous friends.[or]To dream that you walk on ice, you risk much solid comfort and respect for evanescent joys.[or]For a young woman to walk on ice, is a warning that only a thin veil hides her from shame.[or]To see icicles on the eaves of houses, denotes misery and want of comfort.[or]Ill health is foreboded.[or]To see icicles on the fence, denotes suffering bodily and mentally.[or]To see them on trees, despondent hopes will grow gloomier.[or]To see them on evergreens, a bright future will be overcast with the shadow of doubtful honors.[or]To dream that you make ice, you will make a failure of your life through egotism and selfishness.[or]Eating ice, foretells sickness.[or]If you drink ice-water, you will bring ill health from dissipation.[or]Bathing in ice-water, anticipated pleasures will be interrupted with an unforeseen event.[cycling]"
"an"	"imitation"	"[one of]To dream of imitations, means that persons are working to deceive you.[or]For a young woman to dream some one is imitating her lover or herself, foretells she will be imposed upon, and will suffer for the faults of others.[cycling]"
"a"	"husbandry"	"[one of]To dream of implements in husbandry has a variety of interpretations: to dream of a plough denotes success in life and a good marriage; to dream of a yoke is unfavorable unless it be broken; to dream of a team death in a family to dream of a scythe signifies sickness.[cycling]"
"an"	"inauguration"	"[one of]To dream of inauguration, denotes you will rise to higher position than you have yet enjoyed.[or]For a young woman to be disappointed in attending an inauguration, predicts she will fail to obtain her wishes.[cycling]"
"an"	"incest"	"[one of]To dream of incestuous practices, denotes you will fall from honorable places, and will also suffer loss in business.[cycling]"
"an"	"incoherent"	"[one of]To dream of incoherency, usually denotes extreme nervousness and excitement through the oppression of changing events.[cycling]"
"an"	"india rubber"	"[one of]To dream of India rubber, denotes unfavorable changes in your affairs.[or]If you stretch it, you will try to establish a greater business than you can support.[cycling]"
"an"	"indifference"	"[one of]To dream of indifference, signifies pleasant companions for a very short time.[or]For a young woman to dream that her sweetheart is indifferent to her, signifies that he may not prove his affections in the most appropriate way.[or]To dream that she is indifferent to him, means that she will prove untrue to him.[cycling]"
"an"	"indigestion"	"[one of]To dream of indigestion, indicates unhealthy and gloomy surroundings.[cycling]"
"an"	"indigo"	"[one of]To dream of indigo denotes to a female that she will cross the ocean.[or]When she dreams of putting the indigo in water and it gives no color she may be assured she will arrive in.[or]But to embrace the water in the usual way no such thing will come to pass.[cycling]"
"a"	"perfume"	"[one of]To dream of inhaling perfume, is an augury of happy incidents.[or]For you to perfume your garments and person, denotes that you will seek and obtain adulation.[or]Being oppressed by it to intoxication, denotes that excesses in joy will impair your mental qualities.[or]To spill perfume, denotes that you will lose something which affords you pleasure.[or]To break a bottle of perfume, foretells that your most cherished wishes and desires will end disastrously, even while they promise a happy culmination.[or]To dream that you are distilling perfume, denotes that your employments and associations will be of the pleasantest character.[or]For a young woman to dream of perfuming her bath, foretells ecstatic happenings.[or]If she receives it as a gift from a man, she will experience fascinating, but dangerous pleasures.[cycling]"
"an"	"odor"	"[one of]To dream of inhaling sweet odors, is a sign of a beautiful woman ministering to your daily life, and successful financiering.[or]To smell disgusting odors, foretells unpleasant disagreements and unreliable servants.[cycling]"
"a"	"lawt"	"[one of]To dream of instituting a suit at law or entering a criminal complaint against any one shows that some enemy will injure you pecuniarily or that you will lose money by speculation or trade; if you dream you are sued or prosecuted criminally the sign is the reverse; you will probably receive money unexpectedly or be uncommonly successful in your pursuits.[cycling]"
"an"	"intermarry"	"[one of]To dream of intermarrying, denotes quarrels and contentions which will precipitate you into trouble and loss.[cycling]"
"an"	"intoxication"	"[one of]To dream of intoxication, denotes that you are cultivating your desires for illicit pleasures.[cycling]"
"an"	"invalid"	"[one of]To dream of invalids, is a sign of displeasing companions interfering with your interest.[or]To think you are one, portends you are threatened with displeasing circumstances.[cycling]"
"an"	"iron"	"[one of]To dream of iron, is a harsh omen of distress.[or]To feel an iron weight bearing you down, signifies mental perplexities and material losses.[or]To strike with iron, denotes selfishness and cruelty to those dependent upon you.[or]To dream that you manufacture iron, denotes that you will use unjust means to accumulate wealth.[or]To sell iron, you will have doubtful success, and your friends will not be of noble character.[or]To see old, rusty iron, signifies poverty and disappointment.[or]To dream that the price of iron goes down, you will realize that fortune is a very unsafe factor in your life.[or]If iron advances, you will see a gleam of hope in a dark prospectus.[or]To see red-hot iron in your dreams, denotes failure for you by misapplied energy.[cycling]"
"an"	"ivory"	"[one of]To dream of ivory signifies that you will be very successful in business.[or]To the single it is a sign they will soon fall in love and be fortunate in their courtship.[or]To the married it denotes domestic happiness.[cycling]"
"an"	"ivory"	"[one of]To dream of ivory, is favorable to the fortune of the dreamer.[or]To see huge pieces of ivory being carried, denotes financial success and pleasures unalloyed.[cycling]"
"a"	"jessamine"	"[one of]To dream of jessamine, denotes you are approximating some exquisite pleasure, but which will be fleeting.[cycling]"
"an"	"oddfellow"	"[one of]To dream of joining a society of this order foretells sickness and distress: if you are already an Odd.[or]Fellow and dream of strife in the.[or]Lodge and that you are in danger of being turned out it is a sign that you will attain a higher station in life by riches or honors.[cycling]"
"a"	"jollity"	"[one of]To dream of jollity, feasts and merry-making, is a good and prosperous dream, and promiseth to the dreamer great preferment.[cycling]"
"a"	"joy"	"[one of]To dream of joy and festivity, is a token of good for such as would marry, or it betokens enjoyment for those fond of society.[or]To the sad and fearful it announces absence of heaviness and fear.[cycling]"
"a"	"calendar"	"[one of]To dream of keeping a calendar, indicates that you will be very orderly and systematic in habits throughout the year.[or]To see a calendar, denotes disappointment in your calculations.[cycling]"
"a"	"ledger"	"[one of]To dream of keeping a ledger, you will have perplexities and disappointing conditions to combat.[or]To dream that you make wrong entries on your ledger, you will have small disputes and a slight loss will befall you.[or]To put a ledger into a safe, you will be able to protect your rights under adverse circumstances.[or]To get your ledger misplaced, your interests will go awry through neglect of duty.[or]To dream that your ledger gets destroyed by fire, you will suffer through the carelessness of friends.[or]To dream that you have a woman to keep your ledger, you will lose money trying to combine pleasure with business.[or]For a young woman to dream of ledgers, denotes she will have a solid business man to make her a proposal of marriage.[or]To dream that your ledger has worthless accounts, denotes bad management and losses; but if the accounts are good, then your business will assume improved conditions.[cycling]"
"a"	"key"	"[one of]To dream of keys, denotes unexpected changes.[or]If the keys are lost, unpleasant adventures will affect you.[or]To find keys, brings domestic peace and brisk turns to business.[or]Broken keys, portends separation either through death or jealousy.[or]For a young woman to dream of losing the key to any personal ornament, denotes she will have quarrels with her lover, and will suffer much disquiet therefrom.[or]If she dreams of unlocking a door with a key, she will have a new lover and have over-confidence in him.[or]If she locks a door with a key, she will be successful in selecting a husband.[or]If she gives the key away, she will fail to use judgment in conversation and darken her own reputation.[cycling]"
"a"	"mouse"	"[one of]To dream of killing a mouse is a sign you will detect a thief in stealing from you: if in your dream you see a mouse or a number of mice it foretells that you will soon have thieves in the house.[or]For a girl to dream that she pets a mouse shows that she will have a light-fingered or dishonest lover.[cycling]"
"a"	"lamb"	"[one of]To dream of lambs frolicing{sic} in green pastures, betokens chaste friendships and joys.[or]Bounteous and profitable crops to the farmers, and increase of possessions for others.[or]To see a dead lamb, signifies sadness and desolation.[or]Blood showing on the white fleece of a lamb, denotes that innocent ones will suffer from betrayal through the wrong doing of others.[or]A lost lamb, denotes that wayward people will be under your influence, and you should be careful of your conduct.[or]To see lamb skins, denotes comfort and pleasure usurped from others.[or]To slaughter a lamb for domestic uses, prosperity will be gained through the sacrifice of pleasure and contentment.[or]To eat lamb chops, denotes illness, and much anxiety over the welfare of children.[or]To see lambs taking nourishment from their mothers, denotes happiness through pleasant and intelligent home companions, and many lovable and beautiful children.[or]To dream that dogs, or wolves devour lambs, innocent people will suffer at the hands of insinuating and designing villains.[or]To hear the bleating of lambs, your generosity will be appealed to.[or]To see them in a winter storm, or rain, denotes disappointment in expected enjoyment and betterment of fortune.[or]To own lambs in your dreams, signifies that your environments will be pleasant and profitable.[or]If you carry lambs in your arms, you will be encumbered with happy cares upon which you will lavish a wealth of devotion, and no expense will be regretted in responding to appeals from the objects of your affection.[or]To shear lambs, shows that you will be cold and mercenary.[or]You will be honest, but inhumane.[or]For a woman to dream that she is peeling the skin from a lamb, and while doing so, she discovers that it is her child, denotes that she will cause others sorrow which will also rebound to her grief and loss.[cycling]"
"a"	"land"	"[one of]To dream of land, when it appears fertile, omens good; but if sterile and rocky, failure and dispondency is prognosticated.[or]To see land from the ocean, denotes that vast avenues of prosperity and happiness will disclose themselves to you.[cycling]"
"a"	"lard"	"[one of]To dream of lard, signifies a rise in fortune will soon gratify you.[or]For a woman to find her hand in melted lard, foretells her disappointment in attempting to rise in social circles.[cycling]"
"a"	"sheep"	"[one of]To dream of large flocks of sheep is a sign of thrift and abundance particularly to farmers to whom the omen promises large crops: if many of the sheep have young lambs it foretells domestic happiness and an excellent crop of children.[cycling]"
"a"	"laundry"	"[one of]To dream of laundering clothes, denotes struggles, but a final victory in winning fortune.[or]If the clothes are done satisfactorily, then your endeavors will bring complete happiness.[or]If they come out the reverse, your fortune will fail to procure pleasure.[or]To see pretty girls at this work, you will seek pleasure out of your rank.[or]If a laundryman calls at your house, you are in danger of sickness, or of losing something very valuable.[or]To see laundry wagons, portends rivalry and contention.[cycling]"
"a"	"lead"	"[one of]To dream of lead denotes sickness but to dream of leaden bullets good news.[or]If you dream you are wounded by a leaden bullet it is a sign you will be successful in love.[cycling]"
"a"	"lead"	"[one of]To dream of lead, foretells poor success in any engagement.[or]A lead mine, indicates that your friends will look with suspicion on your money making.[or]Your sweetheart will surprise you with her deceit and ill temper.[or]To dream of lead ore, foretells distress and accidents.[or]Business will assume a gloomy cast.[or]To hunt for lead, denotes discontentment, and a constant changing of employment.[or]To melt lead, foretells that by impatience you will bring failure upon yourself and others.[cycling]"
"a"	"leather"	"[one of]To dream of leather, denotes successful business and favorable engagements with women.[or]You will go into lucky speculations if you dream that you are dressed in leather.[or]Ornaments of leather, denotes faithfulness in love and to the home.[or]Piles of leather, denotes fortune and happiness.[or]To deal in leather, signifies no change in the disposition of your engagements is necessary for successful accumulation of wealth.[cycling]"
"a"	"lechery"	"[one of]To dream of lechery, denotes to the dreamer a spell of sickness.[cycling]"
"a"	"cage"	"[one of]To dream of letting birds out of a cage denotes a speedy marriage.[or]To a person in business it denotes success, and to a farmer it denotes good crops.[cycling]"
"a"	"cage"	"[one of]To dream of letting birds out of a cage is a sign that you will lose something.[or]If a young girl dreams this it predicts a loss of her chastity.[cycling]"
"a"	"lice"	"[one of]To dream of lice denotes sickness and poverty.[cycling]"
"a"	"wax taper"	"[one of]To dream of lighting wax tapers, denotes that some pleasing occurrence will bring you into association with friends long absent.[or]To blow them out, signals disappointing times, and sickness will forestall expected opportunities of meeting distinguished friends.[cycling]"
"a"	"lightning"	"[one of]To dream of lightning without tempest, and falling near, without touching the body, signifies change of place.[or]If a man dreams he saw lightning fall below him, it will hinder his traveling.[or]But if you dream that you are all burned and consumed with lightning, it is death to the dreamer.[cycling]"
"a"	"lime"	"[one of]To dream of lime, foretells that disaster will prostrate you for a time, but you will revive to greater and richer prosperity than before.[cycling]"
"a"	"lyre"	"[one of]To dream of listening to the music of a lyre, foretells chaste pleasures and congenial companionship.[or]Business will run smoothly.[or]For a young woman to dream of playing on one, denotes that she will enjoy the undivided affection of a worthy man.[cycling]"
"a"	"hotel"	"[one of]To dream of living in a hotel, denotes ease and profit.[or]To visit women in a hotel, your life will be rather on a dissolute order.[or]To dream of seeing a fine hotel, indicates wealth and travel.[or]If you dream that you are the proprietor of a hotel, you will earn all the fortune you will ever possess.[or]To work in a hotel, you could find a more remunerative employment than what you have.[or]To dream of hunting a hotel, you will be baffled in your search for wealth and happiness.[cycling]"
"a"	"lizard"	"[one of]To dream of lizards is a sign you have secret enemies who will injure you if they can.[or]If a girl dreams this it shows that some one will question her virtue.[cycling]"
"a"	"lizard"	"[one of]To dream of lizards, foretells attacks upon you by enemies.[or]If you kill a lizard, you will regain your lost reputation or fortune; but if it should escape, you will meet vexations and crosses in love and business.[or]For a woman to dream that a lizard crawls up her skirt, or scratches her, she will have much misfortune and sorrow.[or]Her husband will be a victim to invalidism and she will be left a widow, and little sustenance will be eked out by her own labors.[cycling]"
"a"	"locust"	"[one of]To dream of locusts, foretells discrepancies will be found in your business, for which you will worry and suffer.[or]For a woman, this dream foretells she will bestow her affections upon ungenerous people.[cycling]"
"a"	"tempest"	"[one of]To dream of long-continuing and great tempests signifies affliction troubles dangers losses and perils; to the poor repose.[cycling]"
"a"	"thermometer"	"[one of]To dream of looking at a thermometer, denotes unsatisfactory business, and disagreements in the home.[or]To see a broken one, foreshadows illness.[or]If the mercury seems to be falling, your affairs will assume a distressing shape.[or]If it is rising, you will be able to throw off bad conditions in your business.[cycling]"
"a"	"well"	"[one of]To dream of looking into a deep well is a sign you will find a treasure: if you dream of falling into a deep well it foretells your death: if you imagine you draw clear water from a well and drink it you will surely have good fortune of some kind.[cycling]"
"a"	"map"	"[one of]To dream of looking over a map is a sign of an agreeable surprise by the arrival of some dear friend from a distance.[or]If a girl dreams this when her lover is away he will return unexpectedly.[cycling]"
"a"	"telescope"	"[one of]To dream of looking through a telescope at a distance over farm lands is a sign you will either purchase a farm or inherit one: if you dream of looking at the stars it shows that you will rise in the world—if at the moon and you are delighted with the view it predicts for you great riches.[cycling]"
"a"	"hat"	"[one of]To dream of losing your hat, you may expect unsatisfactory business and failure of persons to keep important engagements.[or]For a man to dream that he wears a new hat, predicts change of place and business, which will be very much to his advantage.[or]For a woman to dream that she wears a fine new hat, denotes the attainment of wealth, and she will be the object of much admiration.[or]For the wind to blow your hat off, denotes sudden changes in affairs, and somewhat for the worse.[cycling]"
"a"	"love"	"[one of]To dream of loving any object, denotes satisfaction with your present environments.[or]To dream that the love of others fills you with happy forebodings, successful affairs will give you contentment and freedom from the anxious cares of life.[or]If you find that your love fails, or is not reciprocated, you will become despondent over some conflicting question arising in your mind as to whether it is best to change your mode of living or to marry and trust fortune for the future advancement of your state.[or]For a husband or wife to dream that their companion is loving, foretells great happiness around the hearthstone, and bright children will contribute to the sunshine of the home.[or]To dream of the love of parents, foretells uprightness in character and a continual progress toward fortune and elevation.[or]The love of animals, indicates contentment with what you possess, though you may not think so.[or]For a time, fortune will crown you.[cycling]"
"a"	"luggage"	"[one of]To dream of luggage, denotes unpleasant cares.[or]You will be encumbered with people who will prove distasteful to you.[or]If you are carrying your own luggage, you will be so full of your own distresses that you will be blinded to the sorrows of others.[or]To lose your luggage, denotes some unfortunate speculation or family dissensions.[or]To the unmarried, it foretells broken engagements.[cycling]"
"a"	"lumber"	"[one of]To dream of lumber, denotes many difficult tasks and but little remuneration or pleasure.[or]To see piles of lumber burning, indicates profit from an unexpected source.[or]To dream of sawing lumber, denotes unwise transactions and unhappiness.[cycling]"
"a"	"machinery"	"[one of]To dream of machinery, denotes you will undertake some project which will give great anxiety, but which will finally result in good for you.[or]To see old machinery, foretells enemies will overcome in your strivings to build up your fortune.[or]To become entangled in machinery, foretells loss in your business, and much unhappiness will follow.[or]Loss from bad deals generally follows this dream.[cycling]"
"a"	"pedestrian"	"[one of]To dream of making a long journey on foot, betokens great hardships, false friends, loss of money, unhappy marriage connections and final retirement from the world.[cycling]"
"a"	"campaign"	"[one of]To dream of making a political one, signifies your opposition to approved ways of conducting business, and you will set up original plans for yourself regardless of enemies' working against you.[or]Those in power will lose.[or]If it is a religious people conducting a campaign against sin, it denotes that you will be called upon to contribute from your private means to sustain charitable institutions.[or]For a woman to dream that she is interested in a campaign against fallen women, denotes that she will surmount obstacles and prove courageous in time of need.[cycling]"
"a"	"wager"	"[one of]To dream of making a wager, signifies that you will resort to dishonest means to forward your schemes.[or]If you lose a wager, you will sustain injury from base connections with those out of your social sphere.[or]To win one, reinstates you in favor with fortune.[or]If you are not able to put up a wager, you will be discouraged and prostrated by the adverseness of circumstances.[cycling]"
"a"	"candy"	"[one of]To dream of making candy, denotes profit accruing from industry.[or]To dream of eating crisp, new candy, implies social pleasures and much love-making among the young and old.[or]Sour candy is a sign of illness or that disgusting annoyances will grow out of confidences too long kept.[or]To receive a box of bonbons, signifies to a young person that he or she will be the recipient of much adulation.[or]It generally means prosperity.[or]If you send a box you will make a proposition, but will meet with disappointment.[cycling]"
"a"	"sausage"	"[one of]To dream of making sausage, denotes that you will be successful in many undertakings.[or]To eat them, you will have a humble, but pleasant home.[cycling]"
"a"	"punch"	"[one of]To dream of making this beverage or of drinking it is a sign of poverty or disgrace; if a girl dreams that her lover treats her to punch she had better discard him at once as he will undoubtedly turn out to be a poor and shiftless fellow.[cycling]"
"a"	"will"	"[one of]To dream of making your will is a sign of long life and good fortune generally: if you imagine that you make your will to give a legacy to a lady it foretells to a man that he will marry.[cycling]"
"a"	"malt"	"[one of]To dream of malt, betokens a pleasant existence and riches that will advance your station.[or]To dream of taking malted drinks, denotes that you will interest yourself in some dangerous affair, but will reap much benefit therefrom.[cycling]"
"a"	"manuscript"	"[one of]To dream of manuscript in an unfinished state, forebodes disappointment.[or]If finished and clearly written, great hopes will be realized.[or]If you are at work on manuscript, you will have many fears for some cherished hope, but if you keep the blurs out of your work you will succeed in your undertakings.[or]If it is rejected by the publishers, you will be hopeless for a time, but eventually your most sanguine desires will become a reality.[or]If you lose it, you will be subjected to disappointment.[or]If you see it burn, some work of your own will bring you profit and much elevation.[cycling]"
"a"	"statue"	"[one of]To dream of marble statues is a sign of advancement; those who imagine that they see beautiful statuary will be sure to rise above their present position in society.[cycling]"
"a"	"march"	"[one of]To dream of marching to the strains of music, indicates that you are ambitious to become a soldier or a public official, but you should consider all things well before making final decision.[or]For women to dream of seeing men marching, foretells their inclination for men in public positions.[or]They should be careful of their reputations, should they be thrown much with men.[cycling]"
"a"	"martyr"	"[one of]To dream of martyrs, denotes that false friends, domestic unhappiness and losses in affairs which concern you most.[or]To dream that you are a martyr, signifies the separation from friends, and enemies will slander you.[cycling]"
"a"	"match"	"[one of]To dream of matches, denotes prosperity and change when least expected.[or]To strike a match in the dark, unexpected news and fortune is foreboded.[cycling]"
"a"	"matting"	"[one of]To dream of matting, foretells pleasant prospects and cheerful news from the absent.[or]If it is old or torn, you will have vexing things come before you.[cycling]"
"a"	"meadow"	"[one of]To dream of meadows, predicts happy reunions under bright promises of future prosperity.[cycling]"
"a"	"medal"	"[one of]To dream of medals, denotes honors gained by application and industry.[or]To lose a medal, denotes misfortune through the unfaithfulness of others.[cycling]"
"a"	"medicine"	"[one of]To dream of medicine, if pleasant to the taste, a trouble will come to you, but in a short time it will work for your good; but if you take disgusting medicine, you will suffer a protracted illness or some deep sorrow or loss will overcome you.[or]To give medicine to others, denotes that you will work to injure some one who trusted you.[cycling]"
"a"	"lawyer"	"[one of]To dream of meeting a lawyer brings bad tidings; if you speak to him you will lose some property; if you hear some one speaking in his favor you will meet with some misfortune.[cycling]"
"an"	"unknown"	"[one of]To dream of meeting unknown persons, foretells change for good, or bad as the person is good looking, or ugly, or deformed.[or]To feel that you are unknown, denotes that strange things will cast a shadow of ill luck over you.[cycling]"
"a"	"melon"	"[one of]To dream of melons, denotes ill health and unfortunate ventures in business.[or]To eat them, signifies that hasty action will cause you anxiety.[or]To see them growing on green vines, denotes that present troubles will result in good fortune for you.[cycling]"
"a"	"mercury"	"[one of]To dream of mercury, is significant of unhappy changes through the constant oppression of enemies.[or]For a woman to be suffering from mercurial poison, foretells she will be deserted by and separated from her family.[cycling]"
"a"	"mice"	"[one of]To dream of mice, denotes prosperity, success in love, and a happy marriage.[or]For a married woman to dream of mice, it is a token that she will be with child shortly and that the fruit of her womb will become very rich and powerful.[cycling]"
"a"	"mice"	"[one of]To dream of mice, foretells domestic troubles and the insincerity of friends.[or]Business affairs will assume a discouraging tone.[or]To kill mice, denotes that you will conquer your enemies.[or]To let them escape you, is significant of doubtful struggles.[or]For a young woman to dream of mice, warns her of secret enemies, and that deception is being practised upon her.[or]If she should see a mouse in her clothing, it is a sign of scandal in which she will figure.[cycling]"
"a"	"pail"	"[one of]To dream of milking in a dirty pail, is not a good sign.[cycling]"
"a"	"mineral"	"[one of]To dream of minerals, denotes your present unpromising outlook will grow directly brighter.[or]To walk over mineral land, signifies distress, from which you will escape and be bettered in your surroundings.[cycling]"
"a"	"mistletoe"	"[one of]To dream of mistletoe, foretells happiness and great rejoicing.[or]To the young, it omens many pleasant pastimes.[or]If seen with unpromising signs, disappointment will displace pleasure or fortune.[cycling]"
"a"	"moth"	"[one of]To dream of moth is a sign some one is robbing you it also predicts slander by a supposed friend.[or]To dream you see a moth burn its wings in a flame signifies that an enemy will die.[cycling]"
"a"	"musk"	"[one of]To dream of musk, foretells unexpected occasions of joy, and lovers will agree and cease to be unfaithful.[cycling]"
"a"	"mustard"	"[one of]To dream of mustard or mustard seed is a bad omen and foretells sickness and perhaps death.[or]To dream you eat mustard is a sign your sweetheart or lover is false to you.[or]To married persons this dream indicates domestic quarrels.[cycling]"
"a"	"myrtle"	"[one of]To dream of myrtle is a sign you will receive a declaration of love.[or]To the married it signifies domestic happiness.[cycling]"
"a"	"newspaper"	"[one of]To dream of newspapers, denotes that frauds will be detected in your dealings, and your reputation will likewise be affected.[or]To print a newspaper, you will have opportunities of making foreign journeys and friends.[or]Trying, but failing to read a newspaper, denotes that you will fail in some uncertain enterprise.[cycling]"
"an"	"obligation"	"[one of]To dream of obligating yourself in any incident, denotes that you will be fretted and worried by the thoughtless complaints of others.[or]If others obligate themselves to you, it portends that you will win the regard of acquaintances and friends.[cycling]"
"an"	"oilcloth"	"[one of]To dream of oilcloth is a warning that you will meet coldness and treachery.[or]To deal in it, denotes uncertain speculations.[cycling]"
"an"	"ointment"	"[one of]To dream of ointment, denotes that you will form friendships which will prove beneficial and pleasing to you.[or]For a young woman to dream that she makes ointment, denotes that she will be able to command her own affairs whether they be of a private or public character.[cycling]"
"a"	"coffin"	"[one of]To dream of one denotes the death of a friend or some near relation.[cycling]"
"a"	"coffin"	"[one of]To dream of one denotes the death of a friend or some near relation.[cycling]"
"a"	"telegraph"	"[one of]To dream of one denotes tidings from abroad in a short space of time and still more speedily if you think the telegraph is at work.[cycling]"
"a"	"family"	"[one of]To dream of one's family as harmonious and happy, is significant of health and easy circumstances; but if there is sickness or contentions, it forebodes gloom and disappointment.[cycling]"
"a"	"birth"	"[one of]To dream of one’s birth is good for him that is poor; but to him that is rich, this dream signifies that others shall rule over him against his will.[cycling]"
"an"	"opium"	"[one of]To dream of opium, signifies strangers will obstruct your chances of improving your fortune, by sly and seductive means.[cycling]"
"a"	"paper"	"[one of]To dream of paper is a good omen, but if it appears rumpled, it will give you much pain.[cycling]"
"a"	"parsley"	"[one of]To dream of parsley, denotes hard-earned success, usually the surroundings of the dreamer are healthful and lively.[or]To eat parsley, is a sign of good health, but the care of a large family will be your portion.[cycling]"
"a"	"garlic"	"[one of]To dream of passing through a garlic patch, denotes a rise from penury to prominence and wealth.[or]To a young woman, this denotes that she will marry from a sense of business, and love will not be considered.[or]To eat garlic in your dreams, denotes that you will take a sensible view of life and leave its ideals to take care of themselves.[cycling]"
"a"	"corn-field"	"[one of]To dream of passing through a green and luxurious corn-field, and seeing full ears hanging heavily, denotes great wealth for the farmer.[or]It denotes fine crops and rich harvest and harmony in the home.[or]To the young it promises much happiness and true friends, but to see the ears blasted, denotes disappointments and bereavements.[or]To see young corn newly ploughed, denotes favor with the powerful and coming success.[or]To see it ripe, denotes fame and wealth.[or]To see it cribbed, signifies that your highest desires will be realized.[or]To see shelled corn, denotes wealthy combines and unstinted favors.[or]To dream of eating green corn, denotes harmony among friends and happy unions for the young.[cycling]"
"a"	"pasteboard"	"[one of]To dream of pasteboard, denotes that unfaithful friends will deceive you concerning important matters.[or]To cut pasteboard, you will throw aside difficulties in your struggle to reach eminent positions.[cycling]"
"a"	"pastry"	"[one of]To dream of pastry, denotes that you will be deceived by some artful person.[or]To eat it, implies heartfelt friendships.[or]If a young woman dreams that she is cooking it, she will fail to deceive others as to her real intentions.[cycling]"
"a"	"rent"	"[one of]To dream of paying your rent foretells that you will get some money unexpectedly; but if you dream that you owe it without having the money to pay and are worried in consequence it foreshadows a loss of property.[cycling]"
"a"	"pencil"	"[one of]To dream of pencils, denotes favorable occupations.[or]For a young woman to write with one, foretells she will be fortunate in marriage, if she does not rub out words; in that case, she will be disappointed in her lover.[cycling]"
"a"	"penny"	"[one of]To dream of pennies, denotes unsatisfactory pursuits.[or]Business will suffer, and lovers and friends will complain of the smallness of affection.[or]To lose them, signifies small deference and failures.[or]To find them, denotes that prospects will advance to your improvement.[or]To count pennies, foretells that you will be business-like and economical.[cycling]"
"a"	"pepper"	"[one of]To dream of pepper burning your tongue, foretells that you will suffer from your acquaintances through your love of gossip.[or]To see red pepper growing, foretells for you a thrifty and an independent partner in the marriage state.[or]To see piles of red pepper pods, signifies that you will aggressively maintain your rights.[or]To grind black pepper, denotes that you will be victimized by the wiles of ingenious men or women.[or]To see it in stands on the table, omens sharp reproaches or quarrels.[or]For a young woman to put it on her food, foretells that she will be deceived by her friends.[cycling]"
"a"	"peppermint"	"[one of]To dream of peppermint, denotes pleasant entertainments and interesting affairs.[or]To see it growing, denotes that you will participate in some pleasure in which there will be a dash of romance.[or]To enjoy drinks in which there is an effusion of peppermint, denotes that you will enjoy assignations with some attractive and fascinating person.[or]To a young woman, this dream warns her against seductive pleasures.[cycling]"
"a"	"pewter"	"[one of]To dream of pewter, foretells straitened circumstances.[cycling]"
"a"	"pilgrim"	"[one of]To dream of pilgrims, denotes that you will go on an extended journey, leaving home and its dearest objects in the mistaken idea that it must be thus for their good.[or]To dream that you are a pilgrim, portends struggles with poverty and unsympathetic companions.[or]For a young woman to dream that a pilgrim approaches her, she will fall an easy dupe to deceit.[or]If he leaves her, she will awaken to her weakness of character and strive to strengthen independent thought.[cycling]"
"a"	"pineapple"	"[one of]To dream of pineapples, is exceedingly propitious.[or]Success will follow in the near future, if you gather pineapples or eat them.[or]To dream that you prick your fingers while preparing a pineapple for the table, you will experience considerable vexation over matters which will finally bring pleasure and success.[cycling]"
"a"	"pirate"	"[one of]To dream of pirates, denotes that you will be exposed to the evil designs of false friends.[or]To dream that you are a pirate, denotes that you will fall beneath the society of friends and former equals.[or]For a young woman to dream that her lover is a pirate, is a sign of his unworthiness and deceitfulness.[or]If she is captured by pirates, she will be induced to leave her home under false pretenses.[cycling]"
"a"	"backgammon"	"[one of]To dream of playing backgammon, denotes that you will, while visiting, meet with unfriendly hospitality, but will unconsciously win friendships which will endure much straining.[or]If you are defeated in the game, you will be unfortunate in bestowing your affections, and your affairs will remain in an unsettled condition.[cycling]"
"a"	"lute"	"[one of]To dream of playing on one, is auspicious of joyful news from absent friends.[or]Pleasant occupations follow the dreaming of hearing the music of a lute.[cycling]"
"a"	"perfumery"	"[one of]To dream of pleasant and delicate perfumes foreshadows sluttish habits in a woman: if a lover dreams of perfumes in connection with the beloved object it shows that when he marries he will find her to be a slut.[or]A girl who dreams this will be apt to have a shiftless lover.[cycling]"
"a"	"grove"	"[one of]To dream of pleasant and verdant groves or woods is an excellent sign as it foretells happiness and success: if the groves are barren of leaves it is the reverse and you will be poor and unhappy.[cycling]"
"a"	"pleasure"	"[one of]To dream of pleasure, denotes gain and personal enjoyment.[cycling]"
"a"	"polite"	"[one of]To dream of polite people is a sign that a stranger will visit or be introduced to you: if a girl dreams that her beau is stiff and formal in addressing her it foretells that she will soon have a new admirer.[cycling]"
"an"	"addition"	"[one of]To dream of pondering over addition, denotes that you will have a struggle to overcome difficult situations, which will soon prominently assume formidable shapes in your business transactions.[or]To find some error in addition, shows that you will be able to overcome enemies by fortunately discerning their intention before they have executed their design.[or]To add figures with a machine, foretells that you will have a powerful ally who will save you from much oppression.[or]If you fail to read the figures, you will lose fortune by blind speculation.[cycling]"
"a"	"porcelain"	"[one of]To dream of porcelain, signifies you will have favorable opportunities of progressing in your affairs.[or]To see it broken or soiled, denotes mistakes will be made which will cause grave offense.[cycling]"
"an"	"equipage"	"[one of]To dream of possessing one, signifies complete happiness, with the gratification of every wish, however extravagant.[cycling]"
"a"	"postage"	"[one of]To dream of postage stamps, denotes system and remuneration in business.[or]If you try to use cancelled stamps, you will fall into disrepute.[or]To receive stamps, signifies a rapid rise to distinction.[or]To see torn stamps, denotes that there are obstacles in your way.[cycling]"
"a"	"poor"	"[one of]To dream of poverty is a sign of good luck but if you imagine you are so poor as to be induced to beg it foretells that some one will either insult you or hurt your feelings but yet your luck will not be impaired.[cycling]"
"a"	"legerdemain"	"[one of]To dream of practising legerdemain, or seeing others doing so, signifies you will be placed in a position where your energy and power of planning will be called into strenuous play to extricate yourself.[cycling]"
"a"	"prayer"	"[one of]To dream of prayer or of joining in a prayer with others is a sign you will ask a favor of some one who will refuse you: if you dream of hearing prayers at church or in any public place it shows that you will be requested to do something which you will refuse to do and thereby make an enemy.[cycling]"
"a"	"patentright"	"[one of]To dream of procuring a patent for an invention of your own shows that you will never realize anything from it: if money is to be made by it some one else will get the benefit: if you dream of getting a patent for some other person it is a sign of good luck in a speculation.[cycling]"
"a"	"profanity"	"[one of]To dream of profanity, denotes that you will cultivate those traits which render you coarse and unfeeling toward your fellow man.[or]To dream that others use profanity, is a sign that you will be injured in some way, and probably insulted also.[cycling]"
"a"	"promenade"	"[one of]To dream of promenading, foretells that you will engage in energetic and profitable pursuits.[or]To see others promenading, signifies that you will have rivals in your pursuits.[cycling]"
"a"	"proud"	"[one of]To dream of proud people who disgust you foretells that you will rise in the world: a girl who dreams this of her lover will probably marry a rich or distinguished man.[cycling]"
"a"	"punishment"	"[one of]To dream of punishing a child foretells good fortune to the victim and honors to yourself.[or]For any one to dream of being punished by whipping is a sign they will rise in the world or be honored for some act.[cycling]"
"a"	"pup"	"[one of]To dream of pups, denotes that you will entertain the innocent and hapless, and thereby enjoy pleasure.[or]The dream also shows that friendships will grow stronger, and fortune will increase if the pups are healthful and well formed, and vice versa.[or]if they are lean and filthy.[cycling]"
"a"	"shirt"	"[one of]To dream of putting on your shirt, is a sign that you will estrange yourself from your sweetheart by your faithless conduct.[or]To lose your shirt, augurs disgrace in business or love.[or]A torn shirt, represents misfortune and miserable surroundings.[or]A soiled shirt, denotes that contagious diseases will confront you.[cycling]"
"a"	"putty"	"[one of]To dream of putty is a sign of poverty: puttying up holes foretells losses—the larger the hole the more extensive the loss.[or]If you are putting glass into a window with putty it foretells that you will soon remove into a meaner place than you now occupy.[cycling]"
"a"	"pyramid"	"[one of]To dream of pyramids, denotes that many changes will come to you.[or]If you scale them, you will journey along before you find the gratification of desires.[or]For the young woman, it prognosticates a husband who is in no sense congenial.[or]To dream that you are studying the mystery of the ancient pyramids, denotes that you will develop a love for the mysteries of nature, and you will become learned and polished.[cycling]"
"a"	"quarrel"	"[one of]To dream of quarreling with a stranger is a sign you will make a new friend or acquaintance; if you imagine that you quarrel with a friend it shows that you will soon have a pleasant and agreeable time with him: lovers who dream of quarrels will be apt to bill and coo harder than ever.[cycling]"
"a"	"quinine"	"[one of]To dream of quinine, denotes you will soon be possessed of great happiness, though your prospects for much wealth may be meager.[or]To take some, foretells improvement in health and energy.[or]You will also make new friends, who will lend you commercial aid.[cycling]"
"a"	"rabbit"	"[one of]To dream of rabbits, foretells favorable turns in conditions, and you will be more pleased with your gains than formerly.[or]To see white rabbits, denotes faithfulness in love, to the married or single.[or]To see rabbits frolicing about, denotes that children will contribute to your joys.[cycling]"
"a"	"flag"	"[one of]To dream of raising a flag signifies that your name will be widely known; to dream of seeing a flag floating, signifies good news.[cycling]"
"a"	"rat"	"[one of]To dream of rats, denotes that you will be deceived, and injured by your neighbors.[or]Quarrels with your companions is also foreboded.[or]To catch rats, means you will scorn the baseness of others, and worthily outstrip your enemies.[or]To kill one, denotes your victory in any contest.[cycling]"
"a"	"cipher"	"[one of]To dream of reading cipher, indicates that you are interested in literary researches, and by constant study you will become well acquainted with the habits and lives of the ancients.[cycling]"
"a"	"greek"	"[one of]To dream of reading.[or]Greek, denotes that your ideas will be discussed and finally accepted and put in practical use.[or]To fail to read it, denotes that technical difficulties are in your way.[cycling]"
"a"	"message"	"[one of]To dream of receiving a message, denotes that changes will take place in your affairs.[or]To dream of sending a message, denotes that you will be placed in unpleasant situations.[cycling]"
"a"	"present"	"[one of]To dream of receiving a present is usually a sign of disappointment; but if a married woman dreams that she is presented with fruit it shows that she will soon become pregnant: if a girl imagines she is presented by her lover with gold jewelry it predicts that he covets the possession of her person rather than her heart.[cycling]"
"a"	"reward"	"[one of]To dream of receiving a reward for any act which is a public benefit such as detecting a criminal is a sign that you will have honors conferred upon you: if you dream of getting a reward for finding money or other property it foreshadows good fortune and riches.[cycling]"
"a"	"commandment"	"[one of]To dream of receiving commands, foretells you will be unwisely influenced by persons of stronger will than your own.[or]To read or hear the.[or]Commandments read, denotes you will fall into errors from which you will hardly escape, even with the counsels of friends of wise and unerring judgment.[cycling]"
"a"	"money"	"[one of]To dream of receiving money, is a good omen.[or]In love, it foretells a speedy marriage and many children.[or]If you dream you lose money, it is a proof you will be deceived in love, and be unsuccessful in some favorite pursuit.[or]To dream you are paying money, foretells the birth of a son destined to cut a great figure in life.[cycling]"
"a"	"legacy"	"[one of]To dream of receiving one, denotes losing whatever you own that is in the hands of another, involving you in litigation, debt, unhappiness and trouble.[cycling]"
"a"	"couch"	"[one of]To dream of reclining on a couch, indicates that false hopes will be entertained.[or]You should be alert to every change of your affairs, for only in this way will your hopes be realized.[cycling]"
"a"	"cushion"	"[one of]To dream of reclining on silken cushions, foretells that your ease will be procured at the expense of others; but to see the cushions, denotes that you will prosper in business and love-making.[or]For a young woman to dream of making silken cushions, implies that she will be a bride before many months.[cycling]"
"a"	"grain"	"[one of]To dream of regular fields of ripe grain is a good omen as it is a sign of thrift: if the grain is broken down or imperfect it shows trouble with the thrift: if it is mouldy or mildewed you will experience losses.[or]An abundance of grain in bulk is likewise a sign of plenty; but scattered grain is the reverse of this.[cycling]"
"an"	"anecdote"	"[one of]To dream of relating an anecdote, signifies that you will greatly prefer gay companionship to that of intellect, and that your affairs will prove as unstable as yourself.[or]For a young woman to hear anecdotes related, denotes that she will be one of a merry party of pleasure-seekers.[cycling]"
"a"	"lord's prayer"	"[one of]To dream of repeating the.[or]Prayer, foretells that you are threatened with secret foes and will need the alliance and the support of friends to tide you over difficulties.[or]To hear others repeat it, denotes the danger of some friend.[cycling]"
"a"	"resuscitate"	"[one of]To dream of resuscitating a drowned person foretells that you will engage in some enterprise that attracts public attention: if the person thus brought to life is a female it shadows forth marriage with a lady of public fame.[cycling]"
"a"	"revenge"	"[one of]To dream of revenging an injury is a sign of disgrace: if in your dream you imagine that you have caused any one to be locked up in prison from motives of revenge it predicts that you yourself will be imprisoned for some degrading act.[cycling]"
"a"	"rhubarb"	"[one of]To dream of rhubarb growing, denotes that pleasant entertainments will occupy your time for a while.[or]To cook it, foretells spirited arguments in which you will lose a friend.[or]To eat it, denotes dissatisfaction with present employment.[cycling]"
"a"	"bicycle"	"[one of]To dream of riding a bicycle up hill, signifies bright prospects.[or]Riding it down hill, if the rider be a woman, calls for care regarding her good name and health; misfortune hovers near.[cycling]"
"a"	"mule"	"[one of]To dream of riding a mule or driving one is a sign of celibacy: gentlemen or ladies who dream this may safely calculate that they will live single for the rest of their lives unless some more vivid dream with a favorable omen should counterbalance the influence of this one.[or]If married people dream of mules it foretells that they willbe childless.[cycling]"
"a"	"gigt"	"[one of]To dream of riding alone in a gig denotes delay and that something you expected to happen will be put off: if you imagine you ride in a gig with your sweetheart it foretells that your marriage day will be postponed or will be far distant.[cycling]"
"an"	"elephant"	"[one of]To dream of riding an elephant, denotes that you will possess wealth of the most solid character, and honors which you will wear with dignity.[or]You will rule absolutely in all lines of your business affairs and your word will be law in the home.[or]To see many elephants, denotes tremendous prosperity.[or]One lone elephant, signifies you will live in a small but solid way.[or]To dream of feeding one, denotes that you will elevate yourself in your community by your kindness to those occupying places below you.[cycling]"
"a"	"cart"	"[one of]To dream of riding in a cart, ill luck and constant work will employ your time if you would keep supplies for your family.[or]To see a cart, denotes bad news from kindred or friends.[or]To dream of driving a cart, you will meet with merited success in business and other aspirations.[or]For lovers to ride together in a cart, they will be true in spite of the machinations of rivals.[cycling]"
"a"	"chariot"	"[one of]To dream of riding in a chariot, foretells that favorable opportunities will present themselves resulting in your good if rightly used by you.[or]To fall or see others fall from one, denotes displacement from high positions.[cycling]"
"a"	"coach"	"[one of]To dream of riding in a coach, denotes continued losses and depressions in business.[or]Driving one implies removal or business changes.[cycling]"
"a"	"stage-coach"	"[one of]To dream of riding in one signifies good luck in business: if you run after one you will be out of employment for a long season: to see one pass will rid you of troublesome friends.[or]If you are in a stage-coach and it turns over without injuring you you will be lucky in your speculations; if you dream you are killed by the fall.you must expect misfortune (_See.[or]Riding and.[cycling]"
"a"	"ride"	"[one of]To dream of riding is unlucky for business or pleasure.[or]Sickness often follows this dream.[or]If you ride slowly, you will have unsatisfactory results in your undertakings.[or]Swift riding sometimes means prosperity under hazardous conditions.[cycling]"
"a"	"riot"	"[one of]To dream of riots, foretells disappointing affairs.[or]To see a friend killed in a riot, you will have bad luck in all undertakings, and the death, or some serious illness, of some person will cause you distress.[cycling]"
"a"	"rose"	"[one of]To dream of roses is a sign of troubles: the old saying that every rose has its thorn is exemplified in such a dream because every rose you see brings along a trouble: dreaming of white roses signifies a marriage which will bring much vexation.[cycling]"
"a"	"rotten"	"[one of]To dream of rotten things of any kind foretells sickness and death: to imagine that you handle rotten eggs foreshadows disgrace.[cycling]"
"a"	"rubbish"	"[one of]To dream of rubbish, denotes that you will badly manage your affairs.[cycling]"
"a"	"run"	"[one of]To dream of running swift is a sign of good success in your undertakings; but if you stumble or fall it denotes accidents or misfortune: if you imagine that you see people run while you are still it foretells disappointment.[cycling]"
"a"	"rust"	"[one of]To dream of rust is a bad omen: rusty knives or tools of any kind denote the destruction of property: rusty pails or utensils are so many signs of poverty.[cycling]"
"a"	"rust"	"[one of]To dream of rust on articles, old pieces of tin, or iron, is significant of depression of your surroundings.[or]Sickness, decline in fortune and false friends are filling your sphere.[cycling]"
"a"	"saddle"	"[one of]To dream of saddles, foretells news of a pleasant nature, also unannounced visitors.[or]You are also, probably, to take a trip which will prove advantageous.[cycling]"
"a"	"sage"	"[one of]To dream of sage, foretells thrift and economy will be practised by your servants or family.[or]For a woman to think she has too much in her viands, omens she will regret useless extravagance in love as well as fortune.[cycling]"
"a"	"leeward"	"[one of]To dream of sailing leeward, denotes to the sailor a prosperous and merry voyage.[or]To others, a pleasant journey.[cycling]"
"a"	"sailor"	"[one of]To dream of sailors, portends long and exciting journeys.[or]For a young woman to dream of sailors, is ominous of a separation from her lover through a frivolous flirtation.[or]If she dreams that she is a sailor, she will indulge in some unmaidenly escapade, and be in danger of losing a faithful lover.[cycling]"
"a"	"saltpeter"	"[one of]To dream of saltpeter, denotes change in your living will add loss to some unconquerable grief.[cycling]"
"a"	"salve"	"[one of]To dream of salve, denotes you will prosper under adverse circumstances and convert enemies into friends.[cycling]"
"a"	"sand"	"[one of]To dream of sand, is indicative of famine and losses.[cycling]"
"a"	"sanskrit"	"[one of]To dream of Sanskrit, denotes that you will estrange yourself from friends in order to investigate hidden subjects, taking up those occupying the minds of cultured and progressive thinkers.[cycling]"
"a"	"sapphire"	"[one of]To dream of sapphire, is ominous of fortunate gain, and to woman, a wise selection in a lover.[cycling]"
"a"	"sardonyx"	"[one of]To dream of sardonyx, signifies gloomy surroundings will be cleared away by your energetic overthrow of poverty.[or]For a woman, this dream denotes an increase in her possessions, unless she loses or throws them away, then it might imply a disregard of opportunities to improve her condition.[cycling]"
"a"	"satan"	"[one of]To dream of Satan, foretells that you will have some dangerous adventures, and you will be forced to use strategy to keep up honorable appearances.[or]To dream that you kill him, foretells that you will desert wicked or immoral companions to live upon a higher plane.[or]If he comes to you under the guise of literature, it should be heeded as a warning against promiscuous friendships, and especially flatterers.[or]If he comes in the shape of wealth or power, you will fail to use your influence for harmony, or the elevation of others.[or]If he takes the form of music, you are likely to go down before his wiles.[or]If in the form of a fair woman, you will probably crush every kindly feeling you may have for the caresses of this moral monstrosity.[or]To feel that you are trying to shield yourself from satan, denotes that you will endeavor to throw off the bondage of selfish pleasure, and seek to give others their best deserts.[cycling]"
"a"	"sawdust"	"[one of]To dream of sawdust, signifies that grievous mistakes will cause you distress and quarreling in your home.[cycling]"
"a"	"prayer"	"[one of]To dream of saying prayers, or seeing others doing so, foretells you will be threatened with failure, which will take strenuous efforts to avert.[cycling]"
"a"	"scarcity"	"[one of]To dream of scarcity, foretells sorrow in the household and failing affairs.[cycling]"
"a"	"scarlet fever"	"[one of]To dream of scarlet fever, foretells you are in danger of sickness, or in the power of an enemy.[or]To dream a relative dies suddenly with it, foretells you will be overcome by villainous treachery.[cycling]"
"a"	"scum"	"[one of]To dream of scum, signifies disappointment will be experienced by you over social defeats.[cycling]"
"a"	"patent"	"[one of]To dream of securing a patent, denotes that you will be careful and painstaking with any task you set about to accomplish.[or]If you fail in securing your patent, you will suffer failure for the reason that you are engaging in enterprises for which you have no ability.[or]If you buy one, you will have occasion to make a tiresome and fruitless journey.[or]To see one, you will suffer unpleasantness from illness.[cycling]"
"a"	"seed"	"[one of]To dream of seed, foretells increasing prosperity, though present indications appear unfavorable.[cycling]"
"a"	"rattle"	"[one of]To dream of seeing a baby play with its rattle, omens peaceful contentment in the home, and enterprises will be honorable and full of gain.[or]To a young woman, it augurs an early marriage and tender cares of her own.[or]To give a baby a rattle, denotes unfortunate investments.[cycling]"
"a"	"bear"	"[one of]To dream of seeing a bear or bears is a sign you have one or more enemies; if a bear attacks you it predicts that you will overcome your enemy.[cycling]"
"a"	"beard"	"[one of]To dream of seeing a beard, denotes that some uncongenial person will oppose his will against yours, and there will be a fierce struggle for mastery, and you are likely to lose some money in the combat.[or]Gray beard, signifies hard luck and quarrels.[or]To see beard on women, foretells unpleasant associations and lingering illness.[or]For some one to pull your beard, denotes that you will run a narrow risk if you do not lose property.[or]To comb and admire it, shows that your vanity will grow with prosperity, making you detestable in the sight of many of your former companions.[or]For a young woman to admire a beard, intimates her desire to leave celibacy; but she is threatened with an unfortunate marriage.[cycling]"
"a"	"radish"	"[one of]To dream of seeing a bed of radishes growing, is an omen of good luck.[or]Your friends will be unusually kind, and your business will prosper.[or]If you eat them, you will suffer slightly through the thoughtlessness of some one near to you.[or]To see radishes, or plant them, denotes that your anticipations will be happily realized.[cycling]"
"a"	"blood stone"	"[one of]To dream of seeing a blood stone, denotes that you will be unfortunate in your engagements.[or]For a young woman to receive one as a gift, denotes she will suffer estrangement from one friend, but will, by this, gain one more worthy of her.[cycling]"
"a"	"boiler"	"[one of]To dream of seeing a boiler out of repair, signifies you will suffer from bad management or disappointment.[or]For a woman to dream that she goes into a cellar to see about a boiler foretells that sickness and losses will surround her.[cycling]"
"a"	"captain"	"[one of]To dream of seeing a captain of any company, denotes your noblest aspirations will be realized.[or]If a woman dreams that her lover is a captain, she will be much harassed in mind from jealousy and rivalry.[cycling]"
"a"	"cavern or cave"	"[one of]To dream of seeing a cavern yawning in the weird moonlight before you, many perplexities will assail you, and doubtful advancement because of adversaries.[or]Work and health is threatened.[or]To be in a cave foreshadows change.[or]You will probably be estranged from those who are very dear to you.[or]For a young woman to walk in a cave with her lover or friend, denotes she will fall in love with a villain and will suffer the loss of true friends.[cycling]"
"a"	"chair maker"	"[one of]To dream of seeing a chair maker, denotes that worry from apparently pleasant labor will confront you.[cycling]"
"a"	"church"	"[one of]To dream of seeing a church in the distance, denotes disappointment in pleasures long anticipated.[or]To enter one wrapt in gloom, you will participate in a funeral.[or]Dull prospects of better times are portended.[cycling]"
"a"	"sun"	"[one of]To dream of seeing a clear, shining sunrise, foretells joyous events and prosperity, which give delightful promises.[or]To see the sun at noontide, denotes the maturity of ambitions and signals unbounded satisfaction.[or]To see the sunset, is prognostic of joys and wealth passing their zenith, and warns you to care for your interests with renewed vigilance.[or]A sun shining through clouds, denotes that troubles and difficulties are losing hold on you, and prosperity is nearing you.[or]If the sun appears weird, or in an eclipse, there will be stormy and dangerous times, but these will eventually pass, leaving your business and domestic affairs in better forms than before.[cycling]"
"a"	"corkscrew"	"[one of]To dream of seeing a corkscrew, indicates an unsatisfied mind, and the dreamer should heed this as a warning to curb his desires, for it is likely they are on dangerous grounds.[or]To dream of breaking a corkscrew while using it, indicates to the dreamer perilous surroundings, and he should use force of will to abandon unhealthful inclinations.[cycling]"
"a"	"crew"	"[one of]To dream of seeing a crew getting ready to leave port, some unforseen{sic} circumstance will cause you to give up a journey from which you would have gained much.[or]To see a crew working to save a ship in a storm, denotes disaster on land and sea.[or]To the young, this dream bodes evil.[cycling]"
"a"	"crow"	"[one of]To dream of seeing a crow, betokens misfortune and grief.[or]To hear crows cawing, you will be influenced by others to make a bad disposal of property.[or]To a young man, it is indicative of his succumbing to the wiles of designing women.[cycling]"
"a"	"dance"	"[one of]To dream of seeing a crowd of merry children dancing, signifies to the married, loving, obedient and intelligent children and a cheerful and comfortable home.[or]To young people, it denotes easy tasks and many pleasures.[or]To see older people dancing, denotes a brighter outlook for business.[or]To dream of dancing yourself, some unexpected good fortune will come to you.[cycling]"
"a"	"damask rose"	"[one of]To dream of seeing a damask rosebush in full foliage and bloom, denotes that a wedding will soon take place in your family, and great hopes will be fulfilled.[or]For a lover to place this rose in your hair, foretells that you will be deceived.[or]If a woman receives a bouquet of damask roses in springtime, she will have a faithful lover; but if she received them in winter, she will cherish blasted hopes.[cycling]"
"a"	"fawn"	"[one of]To dream of seeing a fawn, denotes that you will have true and upright friends.[or]To the young, it indicates faithfulness in love.[or]To dream that a person fawns on you, or cajoles you, is a warning that enemies are about you in the guise of interested friends.[cycling]"
"a"	"crane"	"[one of]To dream of seeing a flight of cranes tending northward, indicates gloomy prospects for business.[or]To a woman, it is significant of disappointment; but to see them flying southward, prognosticates a joyful meeting of absent friends, and that lovers will remain faithful.[or]To see them fly to the ground, events of unusual moment are at hand.[cycling]"
"a"	"turkey"	"[one of]To dream of seeing a flock of turkeys denotes to a tradesman or a farmer that he will have a transaction which will bring him in a considerable sum in ready money: if a lover who is about to be married dreams of turkeys he will find that his sweetheart has got a marriage portion in ready money.[cycling]"
"a"	"flying machine"	"[one of]To dream of seeing a flying machine, foretells that you will make satisfactory progress in your future speculations.[or]To see one failing to work, foretells gloomy returns for much disturbing and worrisome planning.[cycling]"
"an"	"oak"	"[one of]To dream of seeing a forest of oaks, signifies great prosperity in all conditions of life.[or]To see an oak full of acorns, denotes increase and promotion.[or]If blasted oak, it denotes sudden and shocking surprises.[or]For sweethearts to dream of oaks, denotes that they will soon begin life together under favorable circumstances.[cycling]"
"a"	"furnace"	"[one of]To dream of seeing a furnace, indicates a quarrel which will cost you dear friends.[or]If you heat the furnace, you will be the only sufferer.[cycling]"
"a"	"hammer"	"[one of]To dream of seeing a hammer, denotes you will have some discouraging obstacles to overcome in order to establish firmly your fortune.[cycling]"
"a"	"helmet"	"[one of]To dream of seeing a helmet, denotes threatened misery and loss will be avoided by wise action.[cycling]"
"a"	"hoe"	"[one of]To dream of seeing a hoe, denotes that you will have no time for idle pleasures, as there will be others depending upon your work for subsistence.[or]To dream of using a hoe, you will enjoy freedom from poverty by directing your energy into safe channels.[or]For a woman to dream of hoeing, she will be independent of others, as she will be self-supporting.[or]For lovers, this dream is a sign of faithfulness.[or]To dream of a foe striking at you with a hoe, your interests will be threatened by enemies, but with caution you will keep aloof from real danger.[cycling]"
"a"	"juniper"	"[one of]To dream of seeing a juniper tree, portends happiness and wealth out of sorrow and depressed conditions.[or]For a young woman, this dreams omens a bright future after disappointing love affairs.[or]To the sick, this is an augury of speedy recovery.[or]To eat, or gather, the berries of a juniper tree, foretells trouble and sickness.[cycling]"
"a"	"lantern"	"[one of]To dream of seeing a lantern going before you in the darkness, signifies unexpected affluence.[or]If the lantern is suddenly lost to view, then your success will take an unfavorable turn.[or]To carry a lantern in your dreams, denotes that your benevolence will win you many friends.[or]If it goes out, you fail to gain the prominence you wish.[or]If you stumble and break it, you will seek to aid others, and in so doing lose your own station, or be disappointed in some undertaking.[or]To clean a lantern, signifies great possibilities are open to you.[or]To lose a lantern, means business depression, and disquiet in the home.[or]If you buy a lantern, it signifies fortunate deals.[or]For a young woman to dream that she lights her lover's lantern, foretells for her a worthy man, and a comfortable home.[or]If she blows it out, by her own imprudence she will lose a chance of getting married.[cycling]"
"a"	"building"	"[one of]To dream of seeing a large building is a sign that you will be introduced to some one with whom you will afterward become intimate.[or]To a young lady it predicts that she will have a new admirer.[cycling]"
"a"	"procession"	"[one of]To dream of seeing a long military or civic procession is a sign that some of your friends will come to poverty and ask your assistance; if you imagine that you are in such a procession yourself it foretells that you will either make a loss or be very short of money.[cycling]"
"a"	"mad dog"	"[one of]To dream of seeing a mad dog, denotes that enemies will make scurrilous attacks upon you and your friends, but if you succeed in killing the dog, you will overcome adverse opinions and prosper greatly in a financial way.[cycling]"
"an"	"oldman"	"[one of]To dream of seeing a man bowed down with age is a sign of good luck in business and to a politician it denotes advancement.[or]This is not a good dream for females for to them it denotes want.[cycling]"
"an"	"execution"	"[one of]To dream of seeing a man hanged denotes that some friend or relative will shortly come to good fortune.[or]If you dream that you yourself are going to be hanged you may safely calculate on good luck for that year: if you are in business you will be successful.[cycling]"
"a"	"mantilla"	"[one of]To dream of seeing a mantilla, denotes an unwise enterprise which will bring you into unfavorable notice.[cycling]"
"a"	"marmot"	"[one of]To dream of seeing a marmot, denotes that sly enemies are approaching you in the shape of fair women.[or]For a young woman to dream of a marmot, foretells that temptation will beset her in the future.[cycling]"
"a"	"minister"	"[one of]To dream of seeing a minister, denotes unfortunate changes and unpleasant journeys.[or]To hear a minister exhort, foretells that some designing person will influence you to evil.[or]To dream that you are a minister, denotes that you will usurp another's rights.[or]Preacher and.[cycling]"
"a"	"monk"	"[one of]To dream of seeing a monk, foretells dissensions in the family and unpleasant journeyings.[or]To a young woman, this dream signifies that gossip and deceit will be used against her.[or]To dream that you are a monk, denotes personal loss and illness.[cycling]"
"a"	"negro"	"[one of]To dream of seeing a negro standing on your green lawn, is a sign that while your immediate future seems filled with prosperity and sweetest joys, there will creep into it unavoidable discord, which will veil all brightness in gloom for a season.[or]To dream of seeing a burly negro, denotes formidable rivals in affection and business.[or]To see a mulatto, constant worries and friction with hirelings is foretold.[or]To dream of a difficulty with a negro, signifies your inability to overcome disagreeable surroundings.[or]It also denotes disappointments and ill fortune.[or]For a young woman to dream of a negro, she will be constrained to work for her own support, or be disappointed in her lover.[or]To dream of negro children, denotes many little anxieties and crosses.[or]For a young woman to dream of being held by a negro, portends for her many disagreeable duties.[or]She is likely to meet with and give displeasure.[or]She will quarrel with her dearest friends.[or]Sickness sometimes follows dreams of old negroes.[or]To see one nude, abject despair, and failure to cope with treachery may follow.[or]Enemies will work you signal harm, and bad news from the absent may be expected.[or]To meet with a trusty negro in a place where he ought not to be, foretells you will be deceived by some person in whom you placed great confidence.[or]You are likely to be much exasperated over the conduct of a servant or some person under your orders.[or]Delays and vexations may follow.[or]To think that you are preaching to negroes is a warning to protect your interest, as false friends are dealing surreptitiously with you.[or]To hear a negro preaching denotes you will be greatly worried over material matters and servants are giving cause for uneasiness.[cycling]"
"a"	"back"	"[one of]To dream of seeing a nude back, denotes loss of power.[or]Lending advice or money is dangerous.[or]Sickness often attends this dream.[or]To see a person turn and walk away from you, you may be sure envy and jealousy are working to your hurt.[or]To dream of your own back, bodes no good to the dreamer.[cycling]"
"a"	"packet"	"[one of]To dream of seeing a packet coming in, foretells that some pleasant recreation is in store for you.[or]To see one going out, you will experience slight losses and disappointments.[cycling]"
"a"	"piano"	"[one of]To dream of seeing a piano, denotes some joyful occasion.[or]To hear sweet and voluptuous harmony from a piano, signals success and health.[or]If discordant music is being played, you will have many exasperating matters to consider.[or]Sad and plaintive music, foretells sorrowful tidings.[or]To find your piano broken and out of tune, portends dissatisfaction with your own accomplishments and disappointment in the failure of your friends or children to win honors.[or]To see an old-fashioned piano, denotes that you have, in trying moments, neglected the advices and opportunities of the past, and are warned not to do so again.[or]For a young woman to dream that she is executing difficult, but entrancing music, she will succeed in winning an indifferent friend to be a most devoted and loyal lover.[cycling]"
"a"	"raft"	"[one of]To dream of seeing a raft foretells a journey—the longer the raft the more extensive the line of travel: if you dream of sailing on a raft it is a sign you will travel with good success in distant countries.[cycling]"
"a"	"poker"	"[one of]To dream of seeing a red hot poker, or fighting with one, signifies that you will meet trouble with combative energy.[or]To play at poker, warns you against evil company; and young women, especially, will lose their moral distinctiveness if they find themselves engaged in this game.[cycling]"
"a"	"roundabout"	"[one of]To dream of seeing a roundabout, denotes that you will struggle unsuccessfully to advance in fortune or love.[cycling]"
"a"	"safe"	"[one of]To dream of seeing a safe, denotes security from discouraging affairs of business and love.[or]To be trying to unlock a safe, you will be worried over the failure of your plans not reaching quick maturity.[or]To find a safe empty, denotes trouble.[cycling]"
"a"	"shark"	"[one of]To dream of seeing a shark in the water is an excellent omen as it foretells that you will escape a great danger that menaces you: if you dream of capturing the shark you will soon thereafter get a big lump of money.[or]Catching fish of any kind foretells money-getting.[cycling]"
"a"	"sheriff"	"[one of]To dream of seeing a sheriff, denotes that you will suffer great uneasiness over the uncertain changes which loom up before you.[or]To imagine that you are elected sheriff or feel interested in the office, denotes that you will participate in some affair which will afford you neither profit nor honor.[or]To escape arrest, you will be able to further engage in illicit affairs.[or]Bailiff and.[cycling]"
"a"	"ship"	"[one of]To dream of seeing a ship under full sail while you stand on the shore is a sign you will soon fall in love with a pretty girl who will favor your addresses; but if you see this ship while you are on the water in some other vessel it shows that your sweetheart will be jealous of you.[or]To dream of being shipwrecked and losing your property foretells good luck in business matters but quarrels in love affairs.[cycling]"
"a"	"skeleton"	"[one of]To dream of seeing a skeleton, is prognostic of illness, misunderstanding and injury at the hands of others, especially enemies.[or]To dream that you are a skeleton, is a sign that you are suffering under useless worry, and should cultivate a milder disposition.[or]If you imagine that one haunts you, there will soon come to you a shocking accident or death, or the trouble may take the form of financial disaster.[cycling]"
"a"	"thumb"	"[one of]To dream of seeing a thumb, foretells that you will be the favorite of artful persons and uncertain fortune.[or]If you are suffering from a sore thumb, you will lose in business, and your companions will prove disagreeable.[or]To dream that you have no thumb, implies destitution and loneliness.[or]If it seems unnaturally small, you will enjoy pleasure for a time.[or]If abnormally large, your success will be rapid and brilliant.[or]A soiled thumb indicates gratification of loose desires.[or]If the thumb has a very long nail, you are liable to fall into evil through seeking strange pleasures.[cycling]"
"a"	"toad"	"[one of]To dream of seeing a toad is a sign of a rain storm: if in your dream you see multitudes of small toads it foretells good crops to farmers and excellent luck to anybody: if a newly married woman dreams this it shadows forth that she will have as many smart children as she sees toads—three or four at a time perhaps—and if she don’t her husband will beget them elsewhere.[cycling]"
"a"	"tower"	"[one of]To dream of seeing a tower, denotes that you will aspire to high elevations.[or]If you climb one, you will succeed in your wishes, but if the tower crumbles as you descend, you will be disappointed in your hopes.[cycling]"
"a"	"tub"	"[one of]To dream of seeing a tub full of water, denotes domestic contentment.[or]An empty tub proclaims unhappiness and waning of fortune.[or]A broken tub, foretells family disagreements and quarrels.[cycling]"
"an"	"oakt"	"[one of]To dream of seeing a very large oak tree and of gathering acorns under it is a sign that some wealthy relative will leave you a fortune by will: if anybody dreams this who does not happen to have wealthy relations it may turn out that somebody else will take the liberty of making a will in his or her favor; if not a streak of good luck will come in some other way to make the matter right.[cycling]"
"a"	"throat"	"[one of]To dream of seeing a well-developed and graceful throat, portends a rise in position.[or]If you feel that your throat is sore, you will be deceived in your estimation of a friend, and will have anxiety over the discovery.[cycling]"
"a"	"wet-nurse"	"[one of]To dream of seeing a wet-nurse suckling a child is a sign of venery: to a married man it foretells that he will break his marriage vows; and to unmarried girls it denotes shame.[cycling]"
"a"	"whale"	"[one of]To dream of seeing a whale approaching a ship, denotes that you will have a struggle between duties, and will be threatened with loss of property.[or]If the whale is demolished, you will happily decide between right and inclination, and will encounter pleasing successes.[or]If you see a whale overturn a ship, you will be thrown into a whirlpool of disasters.[cycling]"
"a"	"companion"	"[one of]To dream of seeing a wife or husband, signifies small anxieties and probable sickness.[or]To dream of social companions, denotes light and frivolous pastimes will engage your attention hindering you from performing your duties.[cycling]"
"a"	"yoke"	"[one of]To dream of seeing a yoke, denotes that you will unwillingly conform to the customs and wishes of others.[or]To yoke oxen in your dreams, signifies that your judgment and counsels will be accepted submissively by those dependent upon you.[or]To fail to yoke them, you will be anxious over some prodigal friend.[cycling]"
"a"	"zebra"	"[one of]To dream of seeing a zebra is a sign of a quarrel: if you imagine that somebody presented you with one of these animals or that you have purchased it it foretells to a young man that he will marry a rich but quarrelsome wife and that she will be constantly annoying him by bragging of her property.[cycling]"
"an"	"acrobat"	"[one of]To dream of seeing acrobats, denotes that you will be prevented from carrying out hazardous schemes by the foolish fears of others.[or]To see yourself acrobating, you will have a sensation to answer for, and your existence will be made almost unendurable by the guying of your enemies.[or]To see women acrobating, denotes that your name will be maliciously and slanderously handled.[or]Also your business interests will be hindered.[or]For a young woman to dream that she sees acrobats in tights, signifies that she will court favor of men.[cycling]"
"an"	"adder"	"[one of]To dream of seeing an adder strike, and a friend, who is dead but seems to be lying down and breathing, rises partly to a sitting position when the adder strikes at him, and then both disappearing into some bushes nearby, denotes that you will be greatly distressed over the ill luck of friends, and a loss threatened to yourself.[or]For a young woman to see an adder, foretells a deceitful person is going to cause her trouble.[or]If it runs from her, she will be able to defend her character in attacks made on her.[cycling]"
"an"	"amateur"	"[one of]To dream of seeing an amateur actor on the stage, denotes that you will see your hopes pleasantly and satisfactorily fulfilled.[or]If they play a tragedy, evil will be disseminated through your happiness.[or]If there is an indistinctness or distorted images in the dream, you are likely to meet with quick and decided defeat in some enterprise apart from your regular business.[cycling]"
"an"	"archbishop"	"[one of]To dream of seeing an archbishop, foretells you will have many obstacles to resist in your attempt to master fortune or rise to public honor.[or]To see one in the every day dress of a common citizen, denotes you will have aid and encouragement from those in prominent positions and will succeed in your enterprises.[or]For a young woman to dream that an archbishop is kindly directing her, foretells she will be fortunate in forming her friendships.[cycling]"
"an"	"arm"	"[one of]To dream of seeing an arm amputated, means separation or divorce.[or]Mutual dissatisfaction will occur between husband and wife.[or]It is a dream of sinister import.[or]Beware of deceitfulness and fraud.[cycling]"
"an"	"execution"	"[one of]To dream of seeing an execution, signifies that you will suffer some misfortune from the carelessness of others.[or]To dream that you are about to be executed, and some miraculous intervention occurs, denotes that you will overthrow enemies and succeed in gaining wealth.[cycling]"
"an"	"eye"	"[one of]To dream of seeing an eye, warns you that watchful enemies are seeking the slightest chance to work injury to your business.[or]This dream indicates to a lover, that a rival will usurp him if he is not careful.[or]To dream of brown eyes, denotes deceit and perfidy.[or]To see blue eyes, denotes weakness in carrying out any intention.[or]To see gray eyes, denotes a love of flattery for the owner.[or]To dream of losing an eye, or that the eyes are sore, denotes trouble.[or]To see a one-eyed man, denotes that you will be threatened with loss and trouble, beside which all others will appear insignificant.[cycling]"
"an"	"old man, or woman"	"[one of]To dream of seeing an old man, or woman, denotes that unhappy cares will oppress you, if they appear otherwise than serene.[or]Men, and.[cycling]"
"a"	"metamorphose"	"[one of]To dream of seeing anything metamorphose, denotes that sudden changes will take place in your life, for good or bad, as the metamorphose was pleasant or frightful.[cycling]"
"a"	"beaver"	"[one of]To dream of seeing beavers, foretells that you will obtain comfortable circumstances by patient striving.[or]If you dream of killing them for their skins, you will be accused of fraud and improper conduct toward the innocent.[cycling]"
"a"	"nest"	"[one of]To dream of seeing birds' nests, denotes that you will be interested in an enterprise which will be prosperous.[or]For a young woman, this dream foretells change of abode.[or]To see an empty nest, indicates sorrow through the absence of a friend.[or]Hens' nests, foretells that you will be interested in domesticities, and children will be cheerful and obedient.[or]To dream of a nest filled with broken or bad eggs, portends disappointments and failure.[cycling]"
"a"	"cremate"	"[one of]To dream of seeing bodies cremated, denotes enemies will reduce your influence in business circles.[or]To think you are being cremated, portends distinct failure in enterprises, if you mind any but your own judgment in conducting them.[cycling]"
"a"	"canker"	"[one of]To dream of seeing canker on anything, is an omen of evil.[or]It foretells death and treacherous companions for the young.[or]Sorrow and loneliness to the aged.[or]Cankerous growths in the flesh, denote future distinctions either as head of State or stage life.[or]The last definition is not consistent with other parts of this book, but.[or]I let it stand, as.[or]I find it among my automatic writings.[cycling]"
"a"	"pasture"	"[one of]To dream of seeing cattle feeding in a green and rich pasture foretells thrift and wealth: if the grass is sun-burnt and only green in patches and the cattle look lean the sign is the reverse; and such a dream denotes short crops to farmers.[cycling]"
"a"	"chimney"	"[one of]To dream of seeing chimneys, denotes a very displeasing incident will occur in your life.[or]Hasty intelligence of sickness will be borne you.[or]A tumble down chimney, denotes sorrow and likely death in your family.[or]To see one overgrown with ivy or other vines, foretells that happiness will result from sorrow or loss of relatives.[or]To see a fire burning in a chimney, denotes much good is approaching you.[or]To hide in a chimney corner, denotes distress and doubt will assail you.[or]Business will appear gloomy.[or]For a young woman to dream that she is going down a chimney, foretells she will be guilty of some impropriety which will cause consternation among her associates.[or]To ascend a chimney, shows that she will escape trouble which will be planned for her.[cycling]"
"an"	"inundation"	"[one of]To dream of seeing cities or country submerged in dark, seething waters, denotes great misfortune and loss of life through some dreadful calamity.[or]To see human beings swept away in an inundation, portends bereavements and despair, making life gloomy and unprofitable.[or]To see a large area inundated with clear water, denotes profit and ease after seemingly hopeless struggles with fortune.[cycling]"
"a"	"crape"	"[one of]To dream of seeing crape hanging from a door, denotes that you will hear of the sudden death of some relative or friend.[or]To see a person dressed in crape, indicates that sorrow, other than death, will possess you.[or]It is bad for business and trade.[or]To the young, it implies lovers' disputes and separations.[cycling]"
"a"	"cream"	"[one of]To dream of seeing cream served, denotes that you will be associated with wealth if you are engaged in business other than farming.[or]To the farmer, it indicates fine crops and pleasant family relations.[or]To drink cream yourself, denotes immediate good fortune.[or]To lovers, this is a happy omen, as they will soon be united.[cycling]"
"a"	"feather"	"[one of]To dream of seeing feathers falling around you, denotes that your burdens in life will be light and easily borne.[or]To see eagle feathers, denotes that your aspirations will be realized.[or]To see chicken feathers, denotes small annoyances.[or]To dream of buying or selling geese or duck feathers, denotes thrift and fortune.[or]To dream of black feathers, denotes disappointments and unhappy amours.[or]For a woman to dream of seeing ostrich and other ornamental feathers, denotes that she will advance in society, but her ways of gaining favor will not bear imitating.[cycling]"
"a"	"flower"	"[one of]To dream of seeing flowers blooming in gardens, signifies pleasure and gain, if bright-hued and fresh; white denotes sadness.[or]Withered and dead flowers, signify disappointments and gloomy situations.[or]For a young woman to receive a bouquet of mixed flowers, foretells that she will have many admirers.[or]To see flowers blooming in barren soil without vestage of foliage, foretells you will have some grievous experience, but your energy and cheerfulness will enable you to climb through these to prominence and happiness.[or]``Held in slumber's soft embrace,.[or]She enters realms of flowery grace,.[or]Where tender love and fond caress,.[or]Bids her awake to happiness.[cycling]"
"a"	"fowl"	"[one of]To dream of seeing fowls, denotes temporary worry or illness.[or]For a woman to dream of fowls, indicates a short illness or disagreement with her friends.[cycling]"
"a"	"celery"	"[one of]To dream of seeing fresh, crisp stalks of celery, you will be prosperous and influential beyond your highest hopes.[or]To see it decaying, a death in your family will soon occur.[or]To eat it, boundless love and affection will be heaped upon you.[or]For a young woman to eat it with her lover, denotes she will come into rich possessions.[cycling]"
"a"	"dirt"	"[one of]To dream of seeing freshly stirred dirt around flowers or trees, denotes thrift and healthful conditions abound for the dreamer.[or]To see your clothes soiled with unclean dirt, you will be forced to save yourself from contagious diseases by leaving your home or submitting to the strictures of the law.[or]To dream that some one throws dirt upon you, denotes that enemies will try to injure your character.[cycling]"
"a"	"frost"	"[one of]To dream of seeing frost on a dark gloomy morning, signifies exile to a strange country, but your wanderings will end in peace.[or]To see frost on a small sunlit landscape, signifies gilded pleasures from which you will be glad to turn later in life, and by your exemplary conduct will succeed in making your circle forget past escapades.[or]To dream that you see a friend in a frost, denotes a love affair in which your rival will be worsted.[or]For a young woman, this dream signifies the absence of her lover and danger of his affections waning.[or]This dream is bad for all classes in business and love.[cycling]"
"a"	"fruit"	"[one of]To dream of seeing fruit ripening among its foliage, usually foretells to the dreamer a prosperous future.[or]Green fruit signifies disappointed efforts or hasty action.[or]For a young woman to dream of eating green fruit, indicates her degradation and loss of inheritance.[or]Eating fruit is unfavorable usually.[or]To buy or sell fruit, denotes much business, but not very remunerative.[or]To see or eat ripe fruit, signifies uncertain fortune and pleasure.[cycling]"
"a"	"grasshopper"	"[one of]To dream of seeing grasshoppers on green vegetables, denotes that enemies threaten your best interests.[or]If on withered grasses, ill health.[or]Disappointing business will be experienced.[or]If you see grasshoppers between you and the sun, it denotes that you will have a vexatious problem in your immediate business life to settle, but using caution it will adjust itself in your favor.[or]To call peoples' attention to the grasshoppers, shows that you are not discreet in dispatching your private business.[cycling]"
"a"	"ham"	"[one of]To dream of seeing hams, signifies you are in danger of being treacherously used.[or]To cut large slices of ham, denotes that all opposition will be successfully met by you.[or]To dress a ham, signifies you will be leniently treated by others.[or]To dream of dealing in hams, prosperity will come to you.[or]Also good health is foreboded.[or]To eat ham, you will lose something of great value.[or]To smell ham cooking, you will be benefited by the enterprises of others.[cycling]"
"a"	"herring"	"[one of]To dream of seeing herring, indicates a tight squeeze to escape financial embarrassment, but you will have success later.[cycling]"
"a"	"thaw"	"[one of]To dream of seeing ice thawing, foretells that some affair which has caused you much worry will soon give you profit and pleasure.[or]To see the ground thawing after a long freeze, foretells prosperous circumstances.[cycling]"
"an"	"intestine"	"[one of]To dream of seeing intestines, signifies you are about to be visited by a grave calamity, which will remove some friend.[or]To see your own intestines, denotes grave situations are closing around you; sickness of a nature to affect you in your daily communications with others threatens you.[or]Probable loss, with much displeasure, is also denoted.[or]If you think you lay them upon something, which turns out to be a radiator, and they begin to grow hot and make you very uncomfortable, and you ask others to assist you, and they refuse, it foretells unexpected calamity, which will probably come in the form of a desperate illness or a misfortune for which you will be censured by those formerly your friends.[or]You may have trouble in extricating yourself from an unpromising predicament.[cycling]"
"a"	"ghost"	"[one of]To dream of seeing it, signifies a marriage in the family.[or]If you dream it speaks, prepare to die.[cycling]"
"an"	"ivy"	"[one of]To dream of seeing ivy growing on trees or houses, predicts excellent health and increase of fortune.[or]Innumerable joys will succeed this dream.[or]To a young woman, it augurs many prized distinctions.[or]If she sees ivy clinging to the wall in the moonlight, she will have clandestine meetings with young men.[or]Withered ivy, denotes broken engagements and sadness.[cycling]"
"a"	"jasper"	"[one of]To dream of seeing jasper, is a happy omen, bringing success and love.[or]For a young woman to lose a jasper, is a sign of disagreement with her lover.[cycling]"
"a"	"logt"	"[one of]To dream of seeing large logs around is a sign that you will soon move into a new house; but if you imagine that you are splitting the logs it will spoil all this for it shows that you will want a house badly without being able to get one to your mind.[cycling]"
"a"	"lobster"	"[one of]To dream of seeing lobsters, denotes great favors, and riches will endow you.[or]If you eat them, you will sustain contamination by associating too freely with pleasure-seeking people.[or]If the lobsters are made into a salad, success will not change your generous nature, but you will enjoy to the fullest your ideas of pleasure.[or]To order a lobster, you will hold prominent positions and command many subordinates.[cycling]"
"a"	"manure"	"[one of]To dream of seeing manure, is a favorable omen.[or]Much good will follow the dream.[or]Farmers especially will feel a rise in fortune.[cycling]"
"a"	"mare"	"[one of]To dream of seeing mares in pastures, denotes success in business and congenial companions.[or]If the pasture is barren, it foretells poverty, but warm friends.[or]For a young woman, this omens a happy marriage and beautiful children.[cycling]"
"a"	"marigold"	"[one of]To dream of seeing marigolds, denotes contentment with frugality should be your aim.[cycling]"
"a"	"till"	"[one of]To dream of seeing money and valuables in a till, foretells coming success.[or]Your love affairs will be exceedingly favorable.[or]An empty one, denotes disappointed expectations.[cycling]"
"a"	"shoulder"	"[one of]To dream of seeing naked shoulders, foretells that happy changes will make you look upon the world in a different light than formerly.[or]To see your own shoulders appearing thin, denotes that you will depend upon the caprices of others for entertainment and pleasure.[cycling]"
"a"	"petticoat"	"[one of]To dream of seeing new petticoats, denotes that pride in your belongings will make you an object of raillery among your acquaintances.[or]To see them soiled or torn, portends that your reputation will be in great danger.[or]If a young woman dream that she wears silken, or clean, petticoats, it denotes that she will have a doting, but manly husband.[or]If she suddenly perceives that she has left off her petticoat in dressing, it portends much ill luck and disappointment.[or]To see her petticoat falling from its place while she is at some gathering, or while walking, she will have trouble in retaining her lover, and other disappointments may follow.[cycling]"
"a"	"tiger"	"[one of]To dream of seeing one of these animals in a rage is a sign that you have a treacherous friend who will endanger your reputation: to see in your dream a sleeping or quiet tiger foretells that you will soon make the acquaintance of a treacherous or unworthy person.[or]If a girl dreams this she had better be suspicious of the next youngman who offers her his attentions.[cycling]"
"an"	"owl"	"[one of]To dream of seeing one of these birds of night in a roosting position is a sign that you will discover an important secret that relates to yourself: to see an owl flying foretells that some secret of your own will get out.[cycling]"
"a"	"whale"	"[one of]To dream of seeing one of these monsters alive in the ocean is a sign that you will be in great peril of losing either your life or property: if you dream that you spear or harpoon a whale successfully it foretells great and abundant fortune.[cycling]"
"a"	"side"	"[one of]To dream of seeing only the side of any object, denotes that some person is going to treat your honest proposals with indifference.[or]To dream that your side pains you, there will be vexations in your affairs that will gall your endurance.[or]To dream that you have a fleshy, healthy side, you will be successful in courtship and business.[cycling]"
"a"	"tail"	"[one of]To dream of seeing only the tail of a beast, unusual annoyance is indicated where pleasures seemed assured.[or]To cut off the tail of an animal, denotes that you will suffer misfortune by your own carelessness.[or]To dream that you have the tail of a beast grown on you, denotes that your evil ways will cause you untold distress, and strange events will cause you perplexity.[cycling]"
"a"	"colonel"	"[one of]To dream of seeing or being commanded by a colonel, denotes you will fail to reach any prominence in social or business circles.[or]If you are a colonel, it denotes you will contrive to hold position above those of friends or acquaintances.[cycling]"
"a"	"basket"	"[one of]To dream of seeing or carrying a basket, signifies that you will meet unqualified success, if the basket is full; but empty baskets indicate discontent and sorrow.[cycling]"
"a"	"gate"	"[one of]To dream of seeing or passing through a gate, foretells that alarming tidings will reach you soon of the absent.[or]Business affairs will not be encouraging.[or]To see a closed gate, inability to overcome present difficulties is predicted.[or]To lock one, denotes successful enterprises and well chosen friends.[or]A broken one, signifies failure and discordant surroundings.[or]To be troubled to get through one, or open it, denotes your most engrossing labors will fail to be remunerative or satisfactory.[or]To swing on one, foretells you will engage in idle and dissolute pleasures.[cycling]"
"an"	"encyclopedia"	"[one of]To dream of seeing or searching through encyclopedias, portends that you will secure literary ability to the losing of prosperity and comfort.[cycling]"
"a"	"deed"	"[one of]To dream of seeing or signing deeds, portends a law suit, to gain which you should be careful in selecting your counsel, as you are likely to be the loser.[or]To dream of signing any kind of a paper, is a bad omen for the dreamer.[cycling]"
"a"	"pantomime"	"[one of]To dream of seeing pantomimes, denotes that your friends will deceive you.[or]If you participate in them, you will have cause of offense.[or]Affairs will not prove satisfactory.[cycling]"
"a"	"pigeon"	"[one of]To dream of seeing pigeons and hearing them cooing above their cotes, denotes domestic peace and pleasure-giving children.[or]For a young woman, this dream indicates an early and comfortable union.[or]To see them being used in a shooting match, and, if you participate, it denotes that cruelty in your nature will show in your dealings, and you are warned of low and debasing pleasures.[or]To see them flying, denotes freedom from misunderstanding, and perhaps news from the absent.[cycling]"
"a"	"railing"	"[one of]To dream of seeing railings, denotes that some person is trying to obstruct your pathway in love or business.[or]To dream of holding on to a railing, foretells that some desperate chance will be taken by you to obtain some object upon which you have set your heart.[or]It may be of love, or of a more material form.[cycling]"
"a"	"rib"	"[one of]To dream of seeing ribs, denotes poverty and misery.[cycling]"
"a"	"headgear"	"[one of]To dream of seeing rich headgear, you will become famous and successful.[or]To see old and worn headgear, you will have to yield up your possessions to others.[cycling]"
"a"	"tapestry"	"[one of]To dream of seeing rich tapestry, foretells that luxurious living will be to your liking, and if the tapestries are not worn or ragged, you will be able to gratify your inclinations.[or]If a young woman dreams that her rooms are hung with tapestry, she will soon wed some one who is rich and above her in standing.[cycling]"
"a"	"robin"	"[one of]To dream of seeing robins around your house is a good omen as it foretells abundance to farmers and success to any one; if you do not see them but hear them trilling it foreshadows sickness and perhaps death.[cycling]"
"a"	"rocket"	"[one of]To dream of seeing rockets flying in the air foretells joy and gladness at some event about to happen: to married people it denotes the birth of a child or the marriage of a daughter if they have one old enough.[or]If a young girl dreams of seeing a rocket she needn’t trouble herself further as her speedy marriage is certain.[cycling]"
"a"	"screw"	"[one of]To dream of seeing screws, denotes that tedious tasks must be performed, and peevishness in companions must be combated.[or]It also denotes that you must be economical and painstaking.[cycling]"
"a"	"shampoo"	"[one of]To dream of seeing shampooing going on, denotes that you will engage in undignified affairs to please others.[or]To have your own head shampooed, you will soon make a secret trip, in which you will have much enjoyment, if you succeed in keeping the real purport from your family or friends.[cycling]"
"a"	"ship"	"[one of]To dream of seeing ships freighted with goods, denotes prosperity.[or]If you dream of seeing ships endangered by a tempest, it signifies fear.[cycling]"
"a"	"yoke"	"[one of]To dream of seeing sleek and healthy cattle yoked together and acting in harmony is a sign of a happy marriage: if a girl dreams this she will be apt to put her own neck in Hymen’s yoke before a great while.[or]To imagine you see yoked cattle wrangling and trying to get their necks out of the yoke foretells matrimonial troubles though it still denotes wedlock to the unmarried.[cycling]"
"a"	"squirrel"	"[one of]To dream of seeing squirrels, denotes that pleasant friends will soon visit you.[or]You will see advancement in your business also.[or]To kill a squirrel, denotes that you will be unfriendly and disliked.[or]To pet one, signifies family joy.[or]To see a dog chasing one, foretells disagreements and unpleasantness among friends.[cycling]"
"a"	"maddog"	"[one of]To dream of seeing such an animal frothing at the mouth and running is a sign you will be wrongfully accused of a dishonorable action or crime.[cycling]"
"a"	"mast"	"[one of]To dream of seeing the masts of ships, denotes long and pleasant voyages, the making of many new friends, and the gaining of new possessions.[or]To see the masts of wrecked ships, denotes sudden changes in your circumstances which will necessitate giving over anticipated pleasures.[or]If a sailor dreams of a mast, he will soon sail on an eventful trip.[cycling]"
"a"	"minuet"	"[one of]To dream of seeing the minuet danced, signifies a pleasant existence with congenial companions.[or]To dance it yourself, good fortune and domestic joys are foretold.[cycling]"
"a"	"moon"	"[one of]To dream of seeing the moon with the aspect of the heavens remaining normal, prognosticates success in love and business affairs.[or]A weird and uncanny moon, denotes unpropitious lovemaking, domestic infelicities and disappointing enterprises of a business character.[or]The moon in eclipse, denotes that contagion will ravage your community.[or]To see the new moon, denotes an increase in wealth and congenial partners in marriage.[or]For a young woman to dream that she appeals to the moon to know her fate, denotes that she will soon be rewarded with marriage to the one of her choice.[or]If she sees two moons, she will lose her lover by being mercenary.[or]If she sees the moon grow dim, she will let the supreme happiness of her life slip for want of womanly tact.[or]To see a blood red moon, indicates war and strife, and she will see her lover march away in defence of his country.[cycling]"
"a"	"peacock"	"[one of]To dream of seeing this beautiful bird, is a very good omen.[or]It denotes great success in trade.[or]To a man, a very beautiful wife, much riches, and a good place.[or]To a maid, a good and rich husband.[or]To a widow, that she will be courted by one who will tell her very fine tales without being sincere.[or]It also denotes prosperity by sea and a handsome wife in a distant port.[cycling]"
"a"	"lion"	"[one of]To dream of seeing this king of beasts, denotes that you will appear before your betters, and that you will be promoted to some lucrative office, accumulate riches, and marry a woman of great spirit.[or]It argues success in trade and prosperity from a voyage by sea.[cycling]"
"an"	"ivy"	"[one of]To dream of seeing this vine running over and covering any house is a sign of poverty particularly if the ivy grows thick and abundant: if you dream that it covers your own house the sign is still more sure: for a farmer to dream that he sees ivy covering a tree denotes bad crops.[or]A girl who dreams of being in a bower covered with ivy will probably marry a poor and shiftless man.[cycling]"
"a"	"tomb"	"[one of]To dream of seeing tombs, denotes sadness and disappointments in business.[or]Dilapidated tombs omens death or desperate illness.[or]To dream of seeing your own tomb, portends your individual sickness or disappointments.[or]To read the inscription on tombs, foretells unpleasant duties.[cycling]"
"a"	"torch"	"[one of]To dream of seeing torches, foretells pleasant amusement and favorable business.[or]To carry a torch, denotes success in love making or intricate affairs.[or]For one to go out, denotes failure and distress.[or]Lantern and.[cycling]"
"a"	"trout"	"[one of]To dream of seeing trout, is significant of growing prosperity.[or]To eat some, denotes that you will be happily conditioned.[or]To catch one with a hook, foretells assured pleasure and competence.[or]If it falls back into the water, you will have a short season of happiness.[or]To catch them with a seine, is a sign of unparalleled prosperity.[or]To see them in muddy water shows that your success in love will bring you to grief and disappointments.[cycling]"
"a"	"turkey"	"[one of]To dream of seeing turkeys, signifies abundant gain in business, and favorable crops to the farmer.[or]To see them dressed for the market, denotes improvement in your affairs.[or]To see them sick, or dead, foretells that stringent circumstances will cause your pride to suffer.[or]To dream you eat turkey, foretells some joyful occasion approaching.[or]To see them flying, denotes a rapid transit from obscurity to prominence.[or]To shoot them as game, is a sign that you will unscrupulously amass wealth.[cycling]"
"a"	"turtle"	"[one of]To dream of seeing turtles, signifies that an unusual incident will cause you enjoyment, and improve your business conditions.[or]To drink turtle soup, denotes that you will find pleasure in compromising intrigue.[cycling]"
"an"	"urine"	"[one of]To dream of seeing urine, denotes ill health will make you disagreeable and unpleasant with your friends.[or]To dream that you are urinating, is an omen of bad luck, and trying seasons to love.[cycling]"
"a"	"plaster"	"[one of]To dream of seeing walls plainly plastered, denotes that success will come, but it will not be stable.[or]To have plaster fall upon you, denotes unmitigated disasters and disclosure.[or]To see plasterers at work, denotes that you will have a sufficient competency to live above penury.[cycling]"
"a"	"swan"	"[one of]To dream of seeing white swans floating upon placid waters, foretells prosperous outlooks and delightful experiences.[or]To see a black swan, denotes illicit pleasure, if near clear water.[or]A dead swan, foretells satiety and discontentment.[or]To see them flying, pleasant anticipations will be realized soon.[cycling]"
"a"	"sunshade"	"[one of]To dream of seeing young girls carrying sunshades, foretells prosperity and exquisite delights.[or]A broken one, foretells sickness and death to the young.[cycling]"
"a"	"young"	"[one of]To dream of seeing young people, is a prognostication of reconciliation of family disagreements and favorable times for planning new enterprises.[or]To dream that you are young again, foretells that you will make mighty efforts to recall lost opportunities, but will nevertheless fail.[or]For a mother to see her son an infant or small child again, foretells that old wounds will be healed and she will take on her youthful hopes and cheerfulness.[or]If the child seems to be dying, she will fall into ill fortune and misery will attend her.[or]To see the young in school, foretells that prosperity and usefulness will envelope you with favors.[cycling]"
"a"	"partner"	"[one of]To dream of seeing your business partner with a basket of crockery on his back, and, letting it fall, gets it mixed with other crockery, denotes your business will sustain a loss through the indiscriminate dealings of your partner.[or]If you reprimand him for it, you will, to some extent, recover the loss.[cycling]"
"a"	"muscle"	"[one of]To dream of seeing your muscle well developed, you will have strange encounters with enemies, but you will succeed in surmounting their evil works, and gain fortune.[or]If they are shrunken, your inability to succeed in your affairs is portended.[or]For a woman, this dream is prophetic of toil and hardships.[cycling]"
"a"	"feet"	"[one of]To dream of seeing your own feet, is omnious{sic} of despair.[or]You will be overcome by the will and temper of another.[or]To see others' feet, denotes that you will maintain your rights in a pleasant, but determined way, and win for yourself a place above the common walks of life.[or]To dream that you wash your feet, denotes that you will let others take advantage of you.[or]To dream that your feet are hurting you, portends troubles of a humiliating character, as they usually are family quarrels.[or]To see your feet swollen and red, you will make a sudden change in your business by separating from your family.[or]This is an evil dream, as it usually foretells scandal and sensation.[cycling]"
"a"	"tongue"	"[one of]To dream of seeing your own tongue, denotes that you will be looked upon with disfavor by your acquaintances.[or]To see the tongue of another, foretells that scandal will villify you.[or]To dream that your tongue is affected in any way, denotes that your carelessness in talking will get you into trouble.[cycling]"
"a"	"soul"	"[one of]To dream of seeing your soul leaving your body, signifies you are in danger of sacrificing yourself to useless designs, which will dwarf your sense of honor and cause you to become mercenary and uncharitable.[or]For an artist to see his soul in another, foretells he will gain distinction if he applies himself to his work and leaves off sentimental ro^les.[or]To imagine another's soul is in you, denotes you will derive solace and benefit from some stranger who is yet to come into your life.[or]For a young woman musician to dream that she sees another young woman on the stage clothed in sheer robes, and imagining it is her own soul in the other person, denotes she will be outrivaled in some great undertaking.[or]To dream that you are discussing the immortality of your soul, denotes you will improve opportunities which will aid you in gaining desired knowledge and pleasure of intercourse with intellectual people.[cycling]"
"a"	"chameleon"	"[one of]To dream of seeing your swetheart{sic} wearing a chameleon chained to her, shows she will prove faithless to you if by changing she can better her fortune.[or]Ordinarily chameleons signify deceit and self advancement, even though others suffer.[cycling]"
"a"	"thigh"	"[one of]To dream of seeing your thigh smooth and white, denotes unusual good luck and pleasure.[or]To see wounded thighs, foretells illness and treachery.[or]For a young woman to admire her thigh, signifies willingness to engage in adventures, and she should heed this as a warning to be careful of her conduct.[cycling]"
"a"	"mirror"	"[one of]To dream of seeing yourself in a mirror, denotes that you will meet many discouraging issues, and sickness will cause you distress and loss in fortune.[or]To see a broken mirror, foretells the sudden or violent death of some one related to you.[or]To see others in a mirror, denotes that others will act unfairly towards you to promote their own interests.[or]To see animals in a mirror, denotes disappointment and loss in fortune.[or]For a young woman to break a mirror, foretells unfortunate friendships and an unhappy marriage.[or]To see her lover in a mirror looking pale and careworn, denotes death or a broken engagement.[or]If he seems happy, a slight estrangement will arise, but it will be of short duration.[cycling]"
"a"	"convent"	"[one of]To dream of seeking refuge in a convent, denotes that your future will be signally free from care and enemies, unless on entering the building you encounter a priest.[or]If so, you will seek often and in vain for relief from worldly cares and mind worry.[or]For a young girl to dream of seeing a convent, her virtue and honestly will be questioned.[cycling]"
"an"	"altar"	"[one of]To dream of seing{sic} a priest at the altar, denotes quarrels and unsatisfactory states in your business and home.[or]To see a marriage, sorrow to friends, and death to old age.[or]An altar would hardly be shown you in a dream, accept to warn you against the commission of error.[or]Repentance is also implied.[cycling]"
"a"	"table"	"[one of]To dream of setting a table preparatory to a meal, foretells happy unions and prosperous circumstances.[or]To see empty tables, signifies poverty or disagreements.[or]To clear away the table, denotes that pleasure will soon assume the form of trouble and indifference.[or]To eat from a table without a cloth, foretells that you will be possessed of an independent disposition, and the prosperity or conduct of others will give you no concern.[or]To see a table walking or moving in some mysterious way, foretells that dissatisfaction will soon enter your life, and you will seek relief in change.[or]To dream of a soiled cloth on a table, denotes disobedience from servants or children, and quarreling will invariably follow pleasure.[or]To see a broken table, is ominous of decaying fortune.[or]To see one standing or sitting on a table, foretells that to obtain their desires they will be guilty of indiscretions.[or]To see or hear table-rapping or writing, denotes that you will undergo change of feelings towards your friends, and your fortune will be threatened.[or]A loss from the depreciation of relatives or friends is indicated.[cycling]"
"a"	"trap"	"[one of]To dream of setting a trap to catch rats or mice is a sign to a girl that she will receive the attentions of a dishonest lover: if she dreams of catching any she will probably marry a great scamp or be seduced by one.[cycling]"
"a"	"trap"	"[one of]To dream of setting a trap, denotes that you will use intrigue to carry out your designs.[or]If you are caught in a trap, you will be outwitted by your opponents.[or]If you catch game in a trap, you will flourish in whatever vocation you may choose.[or]To see an empty trap, there will be misfortune in the immediate future.[or]An old or broken trap, denotes failure in business, and sickness in your family may follow.[cycling]"
"a"	"shakspeare"	"[one of]To dream of Shakspeare, denotes that unhappiness and dispondency will work much anxiety to momentous affairs, and love will be stripped of passion's fever.[or]To read.[or]Shakspeare's works, denotes that you will unalterably attach yourself to literary accomplishments.[cycling]"
"a"	"shark"	"[one of]To dream of sharks, denotes formidable enemies.[or]To see a shark pursuing and attacking you, denotes that unavoidable reverses will sink you into dispondent foreboding.[or]To see them sporting in clear water, foretells that while you are basking in the sunshine of women and prosperity, jealousy is secretly, but surely, working you disquiet, and unhappy fortune.[or]To see a dead one, denotes reconciliation and renewed prosperity.[cycling]"
"a"	"sheep"	"[one of]To dream of shearing them, denotes a season of profitable enterprises will shower down upon you.[or]To see flocks of sheep, there will be much rejoicing among farmers, and other trades will prosper.[or]To see them looking scraggy and sick, you will be thrown into despair by the miscarriage of some plan, which promised rich returns.[or]To eat the flesh of sheep, denotes that ill-natured persons will outrage your feelings.[or]Lamb and.[cycling]"
"a"	"ship"	"[one of]To dream of ships, foretells honor and unexpected elevation to ranks above your mode of life.[or]To hear of a shipwreck is ominous of a disastrous turn in affairs.[or]Your female friends will betray you.[or]To lose your life in one, denotes that you will have an exceeding close call on your life or honor.[or]To see a ship on her way through a tempestuous storm, foretells that you will be unfortunate in business transactions, and you will be perplexed to find means of hiding some intrigue from the public, as your partner in the affair will threaten you with betrayal.[or]To see others shipwrecked, you will seek in vain to shelter some friend from disgrace and insolvency.[cycling]"
"a"	"silver"	"[one of]To dream of silver, is a warning against depending too largely on money for real happiness and contentment.[or]To find silver money, is indicative of shortcomings in others.[or]Hasty conclusions are too frequently drawn by yourself for your own peace of mind.[or]To dream of silverware, denotes worries and unsatisfied desires.[cycling]"
"a"	"raccoon"	"[one of]To dream of simply treeing a raccoon is a good omen for you will probably either gain a sum of money or have it left to you as a legacy: if you imagine that you shoot the animal and he falls to the ground this will spoil the luck; you should stop dreaming as soon as the ’coon is up the tree.[cycling]"
"an"	"epicure"	"[one of]To dream of sitting at the table with an epicure, denotes that you will enjoy some fine distinction, but you will be surrounded by people of selfish principles.[or]To dream that you an epicure yourself, you will cultivate your mind, body and taste to the highest polish.[or]For a woman to dream of trying to satisfy an epicure, signifies that she will have a distinguished husband, but to her he will be a tyrant.[cycling]"
"a"	"chimney"	"[one of]To dream of sitting in the chimney corner to a maid shows speedy marriage; if there is a fire burning brightly you will become heir to some money.[cycling]"
"a"	"lap"	"[one of]To dream of sitting on some person's lap, denotes pleasant security from vexing engagements.[or]If a young woman dreams that she is holding a person on her lap, she will be exposed to unfavorable criticism.[or]To see a serpent in her lap, foretells she is threatened with humiliation at the hands of enemies.[or]If she sees a cat in her lap, she will be endangered by a seductive enemy.[cycling]"
"a"	"skull"	"[one of]To dream of skulls grinning at you, is a sign of domestic quarrels and jars.[or]Business will feel a shrinkage if you handle them.[or]To see a friend's skull, denotes that you will receive injury from a friend because of your being preferred to him.[or]To see your own skull, denotes that you will be the servant of remorse.[cycling]"
"a"	"sleep"	"[one of]To dream of sleeping on clean, fresh beds, denotes peace and favor from those whom you love.[or]To sleep in unnatural resting places, foretells sickness and broken engagements.[or]To sleep beside a little child, betokens domestic joys and reciprocated love.[or]To see others sleeping, you will overcome all opposition in your pursuit for woman's favor.[or]To dream of sleeping with a repulsive person or object, warns you that your love will wane before that of your sweetheart, and you will suffer for your escapades.[or]For a young woman to dream of sleeping with her lover or some fascinating object, warns her against yielding herself a willing victim to his charms.[cycling]"
"a"	"smoke"	"[one of]To dream of smoke, foretells that you will be perplexed with doubts and fears.[or]To be overcome with smoke, denotes that dangerous persons are victimizing you with flattery.[cycling]"
"a"	"paper"	"[one of]To dream of smooth paper is a good omen; but if it appears rumpled it will give you much pain.[or]To dream of paper that is wet signifies success in love matters.[cycling]"
"a"	"snake"	"[one of]To dream of snakes is a sign of an enemy or that some one is slandering you; it also denotes quarrels and angry disputes: if an engaged young lady dreams of them she had better ascertain positively whether her lover is all right before she marries him.[cycling]"
"a"	"snuff"	"[one of]To dream of snuff, signifies your enemies are seducing the confidence of your friends.[or]For a woman to use it in her dreams, foretells complications which will involve her separation from a favored friend.[cycling]"
"a"	"soap"	"[one of]To dream of soap, foretells that friendships will reveal interesting entertainment.[or]Farmers will have success in their varied affairs.[or]For a young woman to be making soap, omens a substantial and satisfactory competency will be hers.[cycling]"
"a"	"zephyr"	"[one of]To dream of soft zephyrs, denotes that you will sacrifice fortune to obtain the object of your affection and will find reciprocal affection in your wooing.[or]If a young woman dreams that she is saddened by the whisperings of the zephyrs, she will have a season of disquietude by the compelled absence of her lover.[cycling]"
"a"	"poinard"	"[one of]To dream of some one stabbing you with a poinard, denotes that secret enemies will cause you uneasiness of mind.[or]If you attack any person with one of these weapons, you will unfortunately suspect your friends of unfaithfulness.[or]Dreaming of poinards, omens evil.[cycling]"
"a"	"soup"	"[one of]To dream of soup, is a forerunner of good tidings and comfort.[or]To see others taking soup, foretells that you will have many good chances to marry.[or]For a young woman to make soup, signifies that she will not be compelled to do menial work in her household, as she will marry a wealthy man.[or]To drink oyster soup made of sweet milk, there will be quarrels with some bad luck, but reconciliations will follow.[cycling]"
"a"	"sparrow"	"[one of]To dream of sparrows, denotes that you will be surrounded with love and comfort, and this will cause you to listen with kindly interest to tales of woe, and your benevolence will gain you popularity.[or]To see them distressed or wounded, foretells sadness.[cycling]"
"a"	"spice"	"[one of]To dream of spice, foretells you will probably damage your own reputation in search of pleasure.[or]For a young woman to dream of eating spice, is an omen of deceitful appearances winning her confidence.[cycling]"
"a"	"spleen"	"[one of]To dream of spleen, denotes that you will have a misunderstanding with some party who will injure you.[cycling]"
"a"	"splinter"	"[one of]To dream of splinters sticking into your flesh, denotes that you will have many vexations from members of your family or from jealous rivals.[or]If while you are visiting you stick a splinter in your foot, you will soon make, or receive, a visit which will prove extremely unpleasant.[or]Your affairs will go slightly wrong through your continued neglect.[cycling]"
"a"	"squall"	"[one of]To dream of squalls, foretells disappointing business and unhappiness.[cycling]"
"a"	"loom"	"[one of]To dream of standing by and seeing a loom operated by a stranger, denotes much vexation and useless irritation from the talkativeness of those about you.[or]Some disappointment with happy expectations are coupled with this dream.[or]To see good-looking women attending the loom, denotes unqualified success to those in love.[or]It predicts congenial pursuits to the married.[or]It denotes you are drawing closer together in taste.[or]For a woman to dream of weaving on an oldtime loom, signifies that she will have a thrifty husband and beautiful children will fill her life with happy solicitations.[or]To see an idle loom, denotes a sulky and stubborn person, who will cause you much anxious care.[cycling]"
"a"	"precipice"	"[one of]To dream of standing over a yawning precipice, portends the threatenings of misfortunes and calamities.[or]To fall over a precipice, denotes that you will be engulfed in disaster.[or]Abyss and.[cycling]"
"a"	"curbstone"	"[one of]To dream of stepping on a curbstone, denotes your rapid rise in business circles, and that you will be held in high esteem by your friends and the public.[or]For lovers to dream of stepping together on a curb, denotes an early marriage and consequent fidelity; but if in your dream you step or fall from a curbstone your fortunes will be reversed.[cycling]"
"a"	"geography"	"[one of]To dream of studying geography, denotes that you will travel much and visit places of renown.[cycling]"
"a"	"latin"	"[one of]To dream of studying this language, denotes victory and distinction in your efforts to sustain your opinion on subjects of grave interest to the public welfare.[cycling]"
"a"	"cold"	"[one of]To dream of suffering from cold, you are warned to look well to your affairs.[or]There are enemies at work to destroy you.[or]Your health is also menaced.[cycling]"
"a"	"chilblain"	"[one of]To dream of suffering with chilblains, denotes that you will be driven into some bad dealing through over anxity{sic} of a friend or partner.[or]This dream also portends your own illness or an accident.[cycling]"
"a"	"sugar"	"[one of]To dream of sugar denotes purity: if a lover dreams that his sweetheart presents him with white loaf-sugar it shows that her affection for him is pure and disinterested; it is therefore a good sign for him to dream of taking tea with her as she would naturally put such sugar in his tea: to dream of sugar of any kind or sugar candy is an excellent omen.[cycling]"
"a"	"sugar"	"[one of]To dream of sugar, denotes that you will be hard to please in your domestic life, and will entertain jealousy while seeing no cause for aught but satisfaction and secure joys.[or]There may be worries, and your strength and temper taxed after this dream.[or]To eat sugar in your dreams, you will have unpleasant matters to contend with for a while, but they will result better than expected.[or]To price sugar, denotes that you are menaced by enemies.[or]To deal in sugar and see large quantities of it being delivered to you, you will barely escape a serious loss.[or]To see a cask of sugar burst and the sugar spilling out, foretells a slight loss.[or]To hear a negro singing while unloading sugar, some seemingly insignificant affair will bring you great benefit, either in business or social states.[cycling]"
"a"	"sulphur"	"[one of]To dream of sulphur, warns you to use much discretion in your dealings, as you are threatened with foul play.[or]To see sulphur burning, is ominous of great care attendant upon your wealth.[or]To eat sulphur, indicates good health and consequent pleasure.[cycling]"
"a"	"swallow"	"[one of]To dream of swallows, is a sign of peace and domestic harmony.[or]To see a wounded or dead one, signifies unavoidable sadness.[cycling]"
"a"	"meat"	"[one of]To dream of sweet and wholesome fresh meat is a sign you will be coquetted by a lady and perhaps fall in love with her; but if the meat is putrid or maggoty it foreshadows sickness and death.[cycling]"
"a"	"swiss cheese"	"[one of]To dream of Swiss cheese, foretells that you will come into possession of substantial property, and healthful amusements will be enjoyed.[cycling]"
"a"	"symphony"	"[one of]To dream of symphonies, heralds delightful occupations.[cycling]"
"a"	"tadpole"	"[one of]To dream of tadpoles, foretells uncertain speculation will bring cause for uneasiness in business.[or]For a young woman to see them in clear water, foretells she will form a relation with a wealthy but immoral man.[cycling]"
"an"	"oath"	"[one of]To dream of taking a solemn oath before a magistrate or in a court of justice foretells quarreling and litigation: even if you are a timid and quiet person such a dream promises that some one will quarrel with you.[cycling]"
"a"	"toddy"	"[one of]To dream of taking a toddy, foretells interesting events will soon change your plan of living.[cycling]"
"a"	"liberty"	"[one of]To dream of taking liberties with any one bids you be careful of them; if others take liberties with you it shows they intend to cheat you.[cycling]"
"a"	"revenge"	"[one of]To dream of taking revenge, is a sign of a weak and uncharitable nature, which if not properly governed, will bring you troubles and loss of friends.[or]If others revenge themselves on you, there will be much to fear from enemies.[cycling]"
"a"	"tallow"	"[one of]To dream of tallow, forebodes that your possessions of love and wealth will quickly vanish.[cycling]"
"a"	"tape"	"[one of]To dream of tape, denotes your work will be wearisome and unprofitable.[or]For a woman to buy it, foretells she will find misfortune laying oppression upon her.[cycling]"
"a"	"tar"	"[one of]To dream of tar is a sign you will travel by water: if you dream you get it on your hands or clothes it shows that you will have difficulties; and to imagine you accidentally seat yourself on tar and get stuck to the seat foretells that you will be detained against your will in some foreign country.[cycling]"
"a"	"liet"	"[one of]To dream of telling a lie about a woman is a sign you will kiss a black one: to dream that you lie about your business denotes that a colored man will rob you: lies generally imagined in dreams denote either injuries or caresses by colored people.[cycling]"
"a"	"fortune-telling"	"[one of]To dream of telling, or having your fortune told, it dicates that you are deliberating over some vexed affair, and you should use much caution in giving consent to its consummation.[or]For a young woman, this portends a choice between two rivals.[or]She will be worried to find out the standing of one in business and social circles.[or]To dream that she is engaged to a fortune-teller, denotes that she has gone through the forest and picked the proverbial stick.[or]She should be self-reliant, or poverty will attend her marriage.[cycling]"
"a"	"tempest"	"[one of]To dream of tempests, denotes that you will have a siege of calamitous trouble, and friends will treat you with indifference.[or]Storms and.[cycling]"
"a"	"bar"	"[one of]To dream of tending a bar, denotes that you will resort to some questionable mode of advancement.[or]Seeing a bar, denotes activity in communities, quick uplifting of fortunes, and the consummation of illicit desires.[cycling]"
"an"	"asp"	"[one of]To dream of the asp or adder is a sign of designing enemies; but it is good if they do not bite you.[cycling]"
"an"	"air"	"[one of]To dream of the atmosphere has a variety of interpretations, and depends entirely on its appearance.[or]If you dream the sky is clear, of a fine blue, calm and serene, then it is a good omen.[or]To dream that it is streaked with white, denotes that many severe difficulties will befall you, over which you will eventually triumph.[or]To dream that it was full of thick, dark and heavy clouds, is an unfavorable token; disappointments will attend you.[or]To dream that the sky is streaked with red and looks fiery, denotes that in love you will be successful; in business not so; it also forewarns you that sickness and trouble will attend your family.[cycling]"
"a"	"baghavad ghitta"	"[one of]To dream of the Baghavad, foretells for you a season of seclusion; also rest to the exhausted faculties.[or]A pleasant journey for your advancement will be planned by your friends.[or]Little financial advancement is promised in this dream.[cycling]"
"a"	"bereavement"	"[one of]To dream of the bereavement of a child, warns you that your plans will meet with quick frustration, and where you expect success there will be failure.[or]Bereavement of relatives, or friends, denotes disappointment in well matured plans and a poor outlook for the future.[cycling]"
"a"	"catechism"	"[one of]To dream of the catechism, foretells that you will be offered a lucrative position, but the strictures will be such that you will be worried as to accepting it.[cycling]"
"an"	"eclipse"	"[one of]To dream of the eclipse of the sun, denotes temporary failure in business and other secular affairs, also disturbances in families.[or]The eclipse of the moon, portends contagious disease or death.[cycling]"
"an"	"elixir of life"	"[one of]To dream of the elixir of life, denotes that there will come into your environments new pleasures and new possibilities.[cycling]"
"an"	"execution"	"[one of]To dream of the execution of offenders, shows that you will be suddenly sought after for relief by some that are in great want and extremity.[cycling]"
"a"	"firmament"	"[one of]To dream of the firmament filled with stars, denotes many crosses and almost superhuman efforts ere you reach the pinnacle of your ambition.[or]Beware of the snare of enemies in your work.[or]To see the firmament illuminated and filled with the heavenly hosts, denotes great spiritual research, but a final pulling back on.[or]Nature for sustenance and consolation.[or]You will often be disappointed in fortune also.[or]To see people you know in the firmament, signifies that they are about to commit some unwise act through you, and others must be the innocent sufferers.[or]Great disasters usually follow this dream.[cycling]"
"a"	"cain"	"[one of]To dream of the firstborn son of man, who was Adam’s eldest son, is a very unfavorable omen; after such a dream let the dreamer travel into another part of the country and form new connections.[cycling]"
"a"	"future"	"[one of]To dream of the future, is a prognostic of careful reckoning and avoiding of detrimental extravagance.[or]``They answered again and said, `Let the.[or]King tell his servants the dream and we will show the interpretation of it.' ''--Dan.[or]ii, 7.[cycling]"
"a"	"ghost"	"[one of]To dream of the ghost of either one of your parents, denotes that you are exposed to danger, and you should be careful in forming partnerships with strangers.[or]To see the ghost of a dead friend, foretells that you will make a long journey with an unpleasant companion, and suffer disappointments.[or]For a ghost to speak to you, you will be decoyed into the hands of enemies.[or]For a woman, this is a prognostication of widowhood and deception.[or]To see an angel or a ghost appear in the sky, denotes the loss of kindred and misfortunes.[or]To see a female ghost on your right in the sky and a male on your left, both of pleasing countenance, signifies a quick rise from obscurity to fame, but the honor and position will be filled only for a short space, as death will be a visitor and will bear you off.[or]To see a female ghost in long, clinging robes floating calmly through the sky, indicates that you will make progression in scientific studies and acquire wealth almost miraculously, but there will be an under note of sadness in your life.[or]To dream that you see the ghost of a living relative or friend, denotes that you are in danger of some friend's malice, and you are warned to carefully keep your affairs under personal supervision.[or]If the ghost appears to be haggard, it may be the intimation of the early death of that friend.[cycling]"
"a"	"hide"	"[one of]To dream of the hide of an animal, denotes profit and permanent employment.[cycling]"
"a"	"judgment day"	"[one of]To dream of the judgment day, foretells that you will accomplish some well-planned work, if you appear resigned and hopeful of escaping punishment.[or]Otherwise, your work will prove a failure.[or]For a young woman to appear before the judgment bar and hear the verdict of ``Guilty,'' denotes that she will cause much distress among her friends by her selfish and unbecoming conduct.[or]If she sees the dead rising, and all the earth solemnly and fearfully awaiting the end, there will be much struggling for her, and her friends will refuse her aid.[or]It is also a forerunner of unpleasant gossip, and scandal is threatened.[or]Business may assume hopeless aspects.[cycling]"
"a"	"lark"	"[one of]To dream of the lark shows speedy increase of fortune.[or]To lovers this is a very favorable omen and is a sign that the course of true love runs smooth.[cycling]"
"a"	"property"	"[one of]To dream of the loss of property is a sign of good luck and you may calculate to acquire as much as you dreamed was lost for such dreams always work contrariwise.[cycling]"
"a"	"cripple"	"[one of]To dream of the maimed and crippled, denotes famine and distress among the poor, and you should be willing to contribute to their store.[or]It also indicates a temporary dulness in trade.[cycling]"
"a"	"moon"	"[one of]To dream of the moon is a very favorable omen; it denotes sudden joy, great success in love; but unfaithfulness in the married state, undutiful children, and malicious enemies.[cycling]"
"a"	"navy"	"[one of]To dream of the navy, denotes victorious struggles with unsightly obstacles, and the promise of voyages and tours of recreation.[or]If in your dream you seem frightened or disconcerted, you will have strange obstacles to overcome before you reach fortune.[or]A dilapidated navy is an indication of unfortunate friendships in business or love.[cycling]"
"a"	"new year"	"[one of]To dream of the new year, signifies prosperity and connubial anticipations.[or]If you contemplate the new year in weariness, engagement will be entered into inauspiciously.[cycling]"
"a"	"nightingale"	"[one of]To dream of the nightingale signifieth good work, and principally wedding.[cycling]"
"an"	"ocean"	"[one of]To dream of the ocean when it is calm is propitious.[or]The sailor will have a pleasant and profitable voyage.[or]The business man will enjoy a season of remuneration, and the young man will revel in his sweetheart's charms.[or]To be far out on the ocean, and hear the waves lash the ship, forebodes disaster in business life, and quarrels and stormy periods in the household.[or]To be on shore and see the waves of the ocean foaming against each other, foretells your narrow escape from injury and the designs of enemies.[or]To dream of seeing the ocean so shallow as to allow wading, or a view of the bottom, signifies prosperity and pleasure with a commingling of sorrow and hardships.[or]To sail on the ocean when it is calm, is always propitious.[cycling]"
"a"	"palisade"	"[one of]To dream of the palisades, denotes that you will alter well-formed plans to please strangers, and by so doing, you will impair your own interests.[cycling]"
"a"	"sky"	"[one of]To dream of the sky, signifies distinguished honors and interesting travel with cultured companions, if the sky is clear.[or]Otherwise, it portends blasted expectations, and trouble with women.[or]To dream of floating in the sky among weird faces and animals, and wondering all the while if you are really awake, or only dreaming, foretells that all trouble, the most excruciating pain, that reach even the dullest sense will be distilled into one drop called jealousy, and will be inserted into your faithful love, and loyalty will suffer dethronement.[or]To see the sky turn red, indicates that public disquiet and rioting may be expected.[or]Heaven and.[cycling]"
"a"	"transfiguration"	"[one of]To dream of the transfiguration, foretells that your faith in man's own nearness to.[or]God will raise you above trifling opinions, and elevate you to a worthy position, in which capacity you will be able to promote the well being of the ignorant and persecuted.[or]To see yourself transfigured, you will stand high in the esteem of honest and prominent men.[cycling]"
"a"	"zodiac"	"[one of]To dream of the twelve signs of the zodiac, shows to a man that he will be a great traveler, and sail once around the world.[or]To a woman, that she will wed a foreigner who is deeply skilled in astronomy.[cycling]"
"a"	"vatican"	"[one of]To dream of the vatican, signifies unexpected favors will fall within your grasp.[or]You will form the acquaintance of distinguished people, if you see royal personages speaking to the.[cycling]"
"a"	"vulture"	"[one of]To dream of the vulture is unfortunate to all except sick persons to whom it foretells a speedy recovery.[cycling]"
"a"	"vulture"	"[one of]To dream of the vulture is unfortunate to all except sick persons, to whom it foretells a speedy recovery.[cycling]"
"a"	"weather"	"[one of]To dream of the weather, foretells fluctuating tendencies in fortune.[or]Now you are progressing immensely, to be suddenly confronted with doubts and rumblings of failure.[or]To think you are reading the reports of a weather bureau, you will change your place of abode, after much weary deliberation, but you will be benefited by the change.[or]To see a weather witch, denotes disagreeable conditions in your family affairs.[or]To see them conjuring the weather, foretells quarrels in the home and disappointment in business.[cycling]"
"a"	"wind"	"[one of]To dream of the wind blowing softly and sadly upon you, signifies that great fortune will come to you through bereavement.[or]If you hear the wind soughing, denotes that you will wander in estrangement from one whose life is empty without you.[or]To walk briskly against a brisk wind, foretells that you will courageously resist temptation and pursue fortune with a determination not easily put aside.[or]For the wind to blow you along against your wishes, portends failure in business undertakings and disappointments in love.[or]If the wind blows you in the direction you wish to go you will find unexpected and helpful allies, or that you have natural advantages over a rival or competitor.[cycling]"
"a"	"zenith"	"[one of]To dream of the zenith, foretells elaborate prosperity, and your choice of suitors will be successful.[cycling]"
"a"	"zodiac"	"[one of]To dream of the zodiac is a prognostication of unparalleled rise in material worth, but also indicates alloyed peace and happiness.[or]To see it appearing weird, denotes that some untoward grief is hovering over you and it will take strenuous efforts to dispell it.[or]To study the zodiac in your dreams, denotes that you will gain distinction and favor by your intercourse with strangers.[or]If you approach it or it approaches you, foretells that you will succeed in your speculations to the wonderment of others and beyond your wildest imagination.[or]To draw a map of it, signifies future gain.[cycling]"
"a"	"bible"	"[one of]To dream of the.[or]Bible, foretells that innocent and disillusioned enjoyment will be proffered for your acceptance.[or]To dream that you villify{sic} the teachings of the.[or]Bible, forewarns you that you are about to succumb to resisted temptations through the seductive persuasiveness of a friend.[cycling]"
"a"	"squirrel"	"[one of]To dream of these animals is a sign of good fortune; they denote abundant crops to a farmer and success to any one: if a man dreams of being bitten by a squirrel it foretells that he will lose something by robbery; if he catches the animal when it bites him and puts it in a cage the omen is different for he will have a piece of good luck—though a robbery maybe mixed up in it.[cycling]"
"a"	"gold-fish"	"[one of]To dream of these beautiful fish is a sign of good fortune generally: if you dream of catching a large one it foretells that you will soon get a large sum of money: any kind of a dream about these fish is lucky.[cycling]"
"a"	"quail"	"[one of]To dream of these birds is a good omen: if you imagine you see young quail feeding it is a sign of thrift particularly to farmers: to be successful in shooting them in the proper season also foretells good luck and success in any undertaking.[cycling]"
"a"	"goose"	"[one of]To dream of these birds is generally a good omen: if you see them quietly feeding it denotes success and pleasure in your undertakings; but if they are alarmed and cackling it foretells trouble and annoyance but yet nothing that will seriously affect you.[cycling]"
"a"	"dahlia"	"[one of]To dream of these flowers is a sign of thrift.[or]If a lady dreams of them it foretells that her husband will make money rapidly.[or]To a young girl it predicts the same of her lover.[cycling]"
"a"	"liar"	"[one of]To dream of thinking people are liars, foretells you will lose faith in some scheme which you had urgently put forward.[or]For some one to call you a liar, means you will have vexations through deceitful persons.[or]For a woman to think her sweetheart a liar, warns her that her unbecoming conduct is likely to lose her a valued friend.[cycling]"
"an"	"eve"	"[one of]To dream of this ancient character, denotes your hesitancy to accept this ancient story as authentic, and you may encounter opposition in business and social circles because of this doubt.[or]For a young woman to dream that she impersonates.[or]Eve, warns her to be careful.[or]She may be wiser than her ancient relative, but the.[or]One still has powerful agents in the disguise of a handsome man.[or]Keep your eye on innocent.[or]Eve, young man.[or]That apple tree still bears fruit, and you may be persuaded, unwittingly, to share the wealth of its products.[cycling]"
"a"	"leopard"	"[one of]To dream of this animal signifies that you have many false friends who are endeavoring to ruin you it also betokens family quarrels and domestic unhappiness.[cycling]"
"a"	"jessamine"	"[one of]To dream of this beautiful flower, foretells good luck.[or]To lovers, it is a sure sign they will be speedily married.[cycling]"
"an"	"owl"	"[one of]To dream of this bird at night is a bad omen.[or]It foretells sickness, poverty and imprisonment.[or]It also forewarns you some male friend is perfidious.[cycling]"
"a"	"nightingale"	"[one of]To dream of this bird signifies light amours; to hear it sing happiness.[cycling]"
"a"	"fox"	"[one of]To dream of this crafty animal is the forerunner of much difficulty.[or]If you are in love, your sweetheart will turn out of a sour, disagreeable, ill-natured disposition.[or]If you are in trade, sharpers will endeavor to defraud you and overreach you in bargains.[cycling]"
"a"	"banana"	"[one of]To dream of this delicious fruit is a good omen; if you dream you are eating a banana it is a sign you will be rich and happy.[or]To dream you see bananas growing denotes success in love matters.[or]If a girl dreams that her lover presents her with a ripe banana it foretells she will soon be married or ought to be.[cycling]"
"a"	"cholera"	"[one of]To dream of this dread disease devastating the country, portends sickness of virulent type will rage and many disappointments will follow.[or]To dream that you are attacked by it, denotes your own sickness.[cycling]"
"an"	"opium"	"[one of]To dream of this drug foretells sickness and poverty: if you imagine that you see some one under the influence of opium and in danger of dying it foretells a misfortune either to yourself or some near relative.[cycling]"
"a"	"devil"	"[one of]To dream of this enemy to the human race denotes that many dangers threaten you all of which you will overcome if you carefully withstand all temptations to do evil; in love it forebodes loss of the affections; in trade opposition; to dream you are pursued by an evil spirit is also a bad omen.[cycling]"
"a"	"devil"	"[one of]To dream of this enemy to the human race, denotes that many dangers will threaten you, all of which you will overcome.[or]If you are in love, it forebodes that some one is endeavoring to alienate the affection of your sweetheart, but will be unsuccessful.[cycling]"
"a"	"pineapple"	"[one of]To dream of this fruit is a sign of gold; if you see an abundance of it you will receive plenty of gold soon after: a young girl who dreams of pineapples will probably get a rich husband.[cycling]"
"a"	"rye"	"[one of]To dream of this grain is a sign you will be fortunate in money matters; it also foretells success in love affairs: to the married it foreshadows domestic happiness.[cycling]"
"a"	"comet"	"[one of]To dream of this heavenly awe-inspiring object sailing through the skies, you will have trials of an unexpected nature to beset you, but by bravely combating these foes you will rise above the mediocre in life to heights of fame.[or]For a young person, this dream portends bereavement and sorrow.[cycling]"
"a"	"boa-constrictor"	"[one of]To dream of this is just about the same as to dream of the devil; it indicates stormy times and much bad fortune.[or]Disenchantment with humanity will follow.[or]To kill one is good.[cycling]"
"a"	"gint"	"[one of]To dream of this liquor is a sign of poverty and disgrace: if you imagine you are drinking it it foretells that you will lose money or property by some foolish act of your own.[cycling]"
"a"	"wren"	"[one of]To dream of this little bird is good, as the wren is noted for its innocence; the person so dreaming is certain of having a noble friend.[or]But to dream you kill it, is bad.[cycling]"
"a"	"primrose"	"[one of]To dream of this little flower starring the grass at your feet, is an omen of joys laden with comfort and peace.[cycling]"
"a"	"zinc"	"[one of]To dream of this metal denotes happiness and prosperity to the dreamer.[or]To lovers it is a sign of success in love affairs.[cycling]"
"a"	"quicksilver"	"[one of]To dream of this metal is a sign your friends will all be false to you it is also a sign of losses in property.[cycling]"
"a"	"quicksilver"	"[one of]To dream of this mineral is a sign of trouble, discontent and unhappiness in the married state.[or]To the lover, it is a sure sign of quarrel; to the sick, a slow recovery.[cycling]"
"an"	"odd-fellow"	"[one of]To dream of this order, signifies that you will have sincere friends, and misfortune will touch you but lightly.[or]To join this order, foretells that you will win distinction and conjugal bliss.[cycling]"
"a"	"rheumatism"	"[one of]To dream of this painful disease is an omen of health: if you imagine a friend is thus afflicted it shows that he will soon offer to do you a favor or benefit you in some way.[cycling]"
"a"	"peacock"	"[one of]To dream of this proud bird is a sign of poverty; if you imagine that he spreads his tail and exhibits all his finery so much the worse.[or]For a girl to dream of a peacock shows that she will have an empty-headed fop for a lover who will turn out to be as poor as a rat.[cycling]"
"an"	"adder"	"[one of]To dream of this reptile is a sign that some one whom you think friendly to you will injure you in some way.[cycling]"
"a"	"fire"	"[one of]To dream of this subtle element, denotes health and happiness to the lover, marriage to the object of his affections and many children.[or]It also denotes that you will be very angry with some one on a trifling occasion.[or]To dream you see burning lights descending as it were from heaven, is a very bad sign indeed.[or]It portends some dreadful accident to the dreamer, such as being hanged, losing your head, having your brains dashed out, breaking your legs, getting into prison, or other strange accidents.[or]To the lover, it also denotes the loss of the affections of your sweetheart.[or]To the tradesman, bad success in business.[or]To dream that you are burnt by fire, denotes great danger, and that enemies will injure you.[or]To the sailor, storms and shipwreck.[cycling]"
"an"	"urn"	"[one of]To dream of this vessel has a happy signification, for it foretells the marriage either of yourself, a near relative or a dear companion.[cycling]"
"a"	"thread"	"[one of]To dream of thread, denotes that your fortune lies beyond intricate paths.[or]To see broken threads, you will suffer loss through the faithlessness of friends.[cycling]"
"a"	"thunder"	"[one of]To dream of thunder, signifies affliction to the rich, but to the poor repose.[cycling]"
"a"	"tint"	"[one of]To dream of tin is a good omen and signifies you will marry a rich wife and make money at business.[cycling]"
"a"	"toad"	"[one of]To dream of toads, signifies unfortunate adventures.[or]If a woman, your good name is threatened with scandal.[or]To kill a toad, foretells that your judgment will be harshly criticised.[or]To put your hands on them, you will be instrumental in causing the downfall of a friend.[cycling]"
"a"	"tobacco"	"[one of]To dream of tobacco, denotes success in business affairs, but poor returns in love.[or]To use it, warns you against enemies and extravagance.[or]To see it growing, foretells successful enterprises.[or]To see it dry in the leaf, ensures good crops to farmers, and consequent gain to tradesmen.[or]To smoke tobacco, denotes amiable friendships.[cycling]"
"a"	"trade"	"[one of]To dream of trading, denotes fair success in your enterprise.[or]If you fail, trouble and annoyances will overtake you.[cycling]"
"a"	"railroad"	"[one of]To dream of traveling by railroad foretells to people who keep house that they will break up their establishment: to young persons it indicates the loss of their home: to lovers it is a sign that if they marry they will not keep house long if at all.[cycling]"
"a"	"fog"	"[one of]To dream of traveling through a dense fog, denotes much trouble and business worries.[or]To emerge from it, foretells a weary journey, but profitable.[or]For a young woman to dream of being in a fog, denotes that she will be mixed up in a salacious scandal, but if she gets out of the fog she will prove her innocence and regain her social standing.[cycling]"
"a"	"trunk"	"[one of]To dream of trunks, foretells journeys and ill luck.[or]To pack your trunk, denotes that you will soon go on a pleasant trip.[or]To see the contents of a trunk thrown about in disorder, foretells quarrels, and a hasty journey from which only dissatisfaction will accrue.[or]Empty trunks foretell disappointment in love and marriage.[or]For a drummer to check his trunk, is an omen of advancement and comfort.[or]If he finds that his trunk is too small for his wares, he will soon hear of his promotion, and his desires will reach gratification.[or]For a young woman to dream that she tries to unlock her trunk and can't, signifies that she will make an effort to win some wealthy person, but by a misadventure she will lose her chance.[or]If she fails to lock her trunk, she will be disappointed in making a desired trip.[cycling]"
"a"	"turnip"	"[one of]To dream of turnips signifies the discovery of secrets and domestic quarrels.[cycling]"
"a"	"turpentine"	"[one of]To dream of turpentine, foretells your near future holds unprofitable and discouraging engagements.[or]For a woman to dream that she binds turpentine to the wound of another, shows she will gain friendships and favor through her benevolent acts.[cycling]"
"a"	"turtle"	"[one of]To dream of turtles is a sign of long life: an engaged young lady who dreams of these animals will probably marry according to her wishes and live with her husband until they become an old couple; but her husband will be one of the slow and easy kind.[cycling]"
"a"	"brush"	"[one of]To dream of using a hair-brush, denotes you will suffer misfortune from your mismanagement.[or]To see old hair brushes, denotes sickness and ill health.[or]To see clothes brushes, indicates a heavy task is pending over you.[or]If you are busy brushing your clothes, you will soon receive reimbursement for laborious work.[or]To see miscellaneous brushes, foretells a varied line of work, yet withal, rather pleasing and remunerative.[cycling]"
"a"	"knocker"	"[one of]To dream of using a knocker, foretells you will be forced to ask aid and counsel of others.[cycling]"
"a"	"rake"	"[one of]To dream of using a rake, portends that some work which you have left to others will never be accomplished unless you superintend it yourself.[or]To see a broken rake, denotes that sickness, or some accident will bring failure to your plans.[or]To see others raking, foretells that you will rejoice in the fortunate condition of others.[cycling]"
"a"	"blotting paper"	"[one of]To dream of using blotting paper, signifies you will be deceived into the betrayal of secrets which will seriously involve a friend.[or]To see worn blotting paper, denotes continued disagreements in the home or among friends.[cycling]"
"an"	"invective"	"[one of]To dream of using invectives, warns you of passionate outbursts of anger, which may estrange you from close companions.[or]To hear others using them, enemies are closing you in to apparent wrong and deceits.[cycling]"
"a"	"rouge"	"[one of]To dream of using rouge, denotes that you will practice deceit to obtain your wishes.[or]To see others with it on their faces, warns you that you are being artfully used to further the designs of some deceitful persons.[or]If you see it on your hands, or clothing, you will be detected in some scheme.[or]If it comes off of your face, you will be humiliated before some rival, and lose your lover by assuming unnatural manners.[cycling]"
"a"	"veal"	"[one of]To dream of veal being roasted is good; but boiled shows sickness; and raw a great disappointment; particularly to those who have recently formed an attachment or any new connection.[cycling]"
"a"	"velvet"	"[one of]To dream of velvet, portends very successful enterprises.[or]If you wear it, some distinction will be conferred upon you.[or]To see old velvet, means your prosperity will suffer from your extreme pride.[or]If a young woman dreams that she is clothed in velvet garments, it denotes that she will have honors bestowed upon her, and the choice between several wealthy lovers.[cycling]"
"an"	"observatory"	"[one of]To dream of viewing the heavens and beautiful landscapes from an observatory, denotes your swift elevation to prominent positions and places of trust.[or]For a young woman this dream signals the realization of the highest earthly joys.[or]If the heavens are clouded, your highest aims will miss materialization.[cycling]"
"a"	"vine"	"[one of]To dream of vines, is propitious of success and happiness.[or]Good health is in store for those who see flowering vines.[or]If they are dead, you will fail in some momentous enterprise.[or]To see poisonous vines, foretells that you will be the victim of a plausible scheme and you will impair your health.[cycling]"
"a"	"tomb"	"[one of]To dream of visiting a large and magnificent tomb-stone foreshadows that you will fall in love with some one above you in social position: visiting a cemetery or grave-yard in your dream is a sign that your turn will soon come to join the matrimonial ranks.[cycling]"
"a"	"menagerie"	"[one of]To dream of visiting a menagerie, denotes various troubles.[cycling]"
"a"	"seaport"	"[one of]To dream of visiting a seaport, denotes that you will have opportunities of traveling and acquiring knowledge, but there will be some who will object to your anticipated tours.[cycling]"
"a"	"home"	"[one of]To dream of visiting your old home, you will have good news to rejoice over.[or]To see your old home in a dilapidated state, warns you of the sickness or death of a relative.[or]For a young woman this is a dream of sorrow.[or]She will lose a dear friend.[or]To go home and find everything cheery and comfortable, denotes harmony in the present home life and satisfactory results in business.[cycling]"
"a"	"zoological garden"	"[one of]To dream of visiting zoological gardens, denotes that you will have a varied fortune.[or]Sometimes it seems that enemies will overpower you and again you stand in the front rank of success.[or]You will also gain knowledge by travel and sojourn in foreign countries.[cycling]"
"a"	"vomit"	"[one of]To dream of vomiting, is a sign that you will be afflicted with a malady which will threaten invalidism, or you will be connected with a racy scandal.[or]To see others vomiting, denotes that you will be made aware of the false pretenses of persons who are trying to engage your aid.[or]For a woman to dream that she vomits a chicken, and it hops off, denotes she will be disappointed in some pleasure by the illness of some relative.[or]Unfavorable business and discontent are also predicted.[or]If it is blood you vomit, you will find illness a hurried and unexpected visitor.[or]You will be cast down with gloomy forebodings, and children and domesticity in general will ally to work you discomfort.[cycling]"
"a"	"vomit"	"[one of]To dream of vomiting, whether of blood, meat or phlegm, signifies to the poor, profit, to the rich, hurt.[cycling]"
"a"	"voucher"	"[one of]To dream of vouchers, foretells that patient toil will defeat idle scheming to arrest fortune from you.[or]To sign one, denotes that you have the aid and confidence of those around you, despite the evil workings of enemies.[or]To lose one, signifies that you will have a struggle for your rights with relatives.[cycling]"
"a"	"churchyard"	"[one of]To dream of walking in a churchyard, if in winter, denotes that you are to have a long and bitter struggle with poverty, and you will reside far from the home of your childhood, and friends will be separated from you; but if you see the signs of springtime, you will walk up in into pleasant places and enjoy the society of friends.[or]For lovers to dream of being in a churchyard means they will never marry each other, but will see others fill their places.[cycling]"
"a"	"park"	"[one of]To dream of walking through a well-kept park, denotes enjoyable leisure.[or]If you walk with your lover, you will be comfortably and happily married.[or]Ill-kept parks, devoid of green grasses and foliage, is ominous of unexpected reverses.[cycling]"
"a"	"marsh"	"[one of]To dream of walking through marshy places, denotes illness resulting from overwork and worry.[or]You will suffer much displeasure from the unwise conduct of a near relative.[cycling]"
"a"	"sea"	"[one of]To dream of walking upon the sea, is good to him that would travel; as also to a servant, and to him that would take a wife, or who hath a lawsuit.[or]To a young man, this dream is love of a beautiful young woman.[or]To a woman, it signifies she leads a desolate life; for the sea is like a harlot, because it hath a fair appearance and show, but in the end brings many to evil.[or]To dream you walk in the sea, or on the shore, or catch fish, is a bad dream.[cycling]"
"a"	"walnut"	"[one of]To dream of walnuts, is an omen significant of prolific joys and favors.[or]To dream that you crack a decayed walnut, denotes that your expectations will end in bitterness and regretable collapse.[or]For a young woman to dream that she has walnut stain on her hands, foretells that she will see her lover turn his attention to another, and she will entertain only regrets for her past indiscreet conduct.[cycling]"
"a"	"desert"	"[one of]To dream of wandering through a gloomy and barren desert, denotes famine and uprisal of races and great loss of life and property.[or]For a young woman to find herself alone in a desert, her health and reputation is being jeopardized by her indiscretion.[or]She should be more cautious.[cycling]"
"a"	"waste"	"[one of]To dream of wandering through waste places, foreshadows doubt and failure, where promise of success was bright before you.[or]To dream of wasting your fortune, denotes you will be unpleasantly encumbered with domestic cares.[cycling]"
"a"	"war"	"[one of]To dream of war and affairs of war, signifies trouble and danger.[cycling]"
"a"	"war"	"[one of]To dream of war, foretells unfortunate conditions in business, and much disorder and strife in domestic affairs.[or]For a young woman to dream that her lover goes to war, denotes that she will hear of something detrimental to her lover's character.[or]To dream that your country is defeated in war, is a sign that it will suffer revolution of a business and political nature.[or]Personal interest will sustain a blow either way.[or]If of victory you dream, there will be brisk activity along business lines, and domesticity will be harmonious.[cycling]"
"a"	"feet"	"[one of]To dream of washing your feet denotes trouble of some kind; of scratching or tickling the soles of your feet shows that you will be flattered by some one to your disadvantage; dreaming of dirty feet predicts sickness or trouble; if in your dream you imagine your feet are covered with corns you will have great riches.[cycling]"
"a"	"wasp"	"[one of]To dream of wasps denotes thrift and abundance particularly to farmers and those who have fruit-trees.[or]If a girl dreams that she is stung by a mud-wasp it foretells that she will marry a gentleman who will love her dearly.[cycling]"
"a"	"waste"	"[one of]To dream of waste is a sign of beggary provided you are the cause of the waste; but if you feel bad and try to prevent it the omen is one of losses which may not end in beggary.[cycling]"
"a"	"collar"	"[one of]To dream of wearing a collar, you will have high honors thrust upon you that you will hardly be worthy of.[or]For a woman to dream of collars, she will have many admirers, but no sincere ones,.[or]She will be likely to remain single for a long while.[cycling]"
"a"	"girdle"	"[one of]To dream of wearing a girdle, and it presses you, denotes that you will be influenced by designing people.[or]To see others wearing velvet, or jeweled girdles, foretells that you will strive for wealth more than honor.[or]For a woman to receive one, signifies that honors will be conferred upon her.[cycling]"
"a"	"muff"	"[one of]To dream of wearing a muff, denotes that you will be well provided for against the vicissitudes of fortune.[or]For a lover to see his sweetheart wearing a muff, denotes that a worthier man will usurp his place in her affections.[cycling]"
"a"	"sash"	"[one of]To dream of wearing a sash, foretells that you will seek to retain the affections of a flirtatious person.[or]For a young woman to buy one, she will be faithful to her lover, and win esteem by her frank, womanly ways.[cycling]"
"a"	"wig"	"[one of]To dream of wearing a wig is a good omen to a bald bachelor as it foretells that some lady has a design to catch the poor fellow and will not scruple as to the means she uses to accomplish it: if a young man dreams of wearing a wig it is a sign that he will sleep with his sweetheart before he marries her.[cycling]"
"a"	"coat"	"[one of]To dream of wearing another's coat, signifies that you will ask some friend to go security for you.[or]To see your coat torn, denotes the loss of a close friend and dreary business.[or]To see a new coat, portends for you some literary honor.[or]To lose your coat, you will have to rebuild your fortune lost through being over-confident in speculations.[or]Apparel and.[cycling]"
"a"	"ring"	"[one of]To dream of wearing rings, denotes new enterprises in which you will be successful.[or]A broken ring, foretells quarrels and unhappiness in the married state, and separation to lovers.[or]For a young woman to receive a ring, denotes that worries over her lover's conduct will cease, as he will devote himself to her pleasures and future interest.[or]To see others with rings, denotes increasing prosperity and many new friends.[cycling]"
"a"	"silk"	"[one of]To dream of wearing silk clothes, is a sign of high ambitions being gratified, and friendly relations will be established between those who were estranged.[or]For a young woman to dream of old silk, denotes that she will have much pride in her ancestors, and will be wooed by a wealthy, but elderly person.[or]If the silk is soiled or torn, she will drag her ancestral pride in the slums of disgrace.[cycling]"
"a"	"spur"	"[one of]To dream of wearing spurs, denotes that you will engage in some unpleasant controversy.[or]To see others with them on, foretells that enmity is working you trouble.[cycling]"
"a"	"weasel"	"[one of]To dream of weasels, shows a man in love with some ill-natured woman, by whom he will be ensnared, or some domestic who will cajole his master by subtlety.[cycling]"
"a"	"web"	"[one of]To dream of webs, foretells deceitful friends will work you loss and displeasure.[or]If the web is non-elastic, you will remain firm in withstanding the attacks of the envious persons who are seeking to obtain favors from you.[cycling]"
"a"	"willow"	"[one of]To dream of weeping willows is a sign of sickness and death: if they hang over a stream it foretells sickness only.[cycling]"
"a"	"weevil"	"[one of]To dream of weevils, portends loss in trade and falseness in love.[cycling]"
"a"	"hog"	"[one of]To dream of well-kept and happy-looking hogs is a good omen as it foretells luck and success: but if you see lean and hungry-looking hogs squealing it shows that any speculation you may enter into about that time will not be of much account if it does not result in a loss.[cycling]"
"a"	"whisky"	"[one of]To dream of whisky in bottles, denotes that you will be careful of your interests, protecting them with energy and watchfulness, thereby adding to their proportion.[or]To drink it alone, foretells that you will sacrifice your friends to your selfishness.[or]To destroy whisky, you will lose your friends by your ungenerous conduct.[or]Whisky is not fraught with much good.[or]Disappointment in some form will likely appear.[or]To see or drink it, is to strive and reach a desired object after many disappointments.[or]If you only see it, you will never obtain the result hoped and worked for.[cycling]"
"a"	"white lead"	"[one of]To dream of white lead, denotes relatives or children are in danger because of your carelessness.[or]Prosperity will be chary of favor.[cycling]"
"a"	"willow"	"[one of]To dream of willows, foretells that you will soon make a sad journey, but you will be consoled in your grief by faithful friends.[cycling]"
"a"	"wire"	"[one of]To dream of wire, denotes that you will make frequent but short journeys which will be to your disparagement.[or]Old or rusty wire, signifies that you will be possessed of a bad temper, which will give troubles to your kindred.[or]To see a wire fence in your dreams, foretells that you will be cheated in some trade you have in view.[cycling]"
"a"	"witch"	"[one of]To dream of witches, denotes that you, with others, will seek adventures which will afford hilarious enjoyment, but it will eventually rebound to your mortification.[or]Business will suffer prostration if witches advance upon you, home affairs may be disappointing.[cycling]"
"a"	"wool"	"[one of]To dream of wool, is a pleasing sign of prosperous opportunities to expand your interests.[or]To see soiled, or dirty wool, foretells that you will seek employment with those who detest your principles.[cycling]"
"a"	"forge"	"[one of]To dream of working a smith’s forge, denotes a brain full of projects.[or]The blowing with the bellows signifies the getting of a wife and the hammering on the anvil her scolding tongue.[cycling]"
"a"	"putty"	"[one of]To dream of working in putty, denotes that hazardous chances will be taken with fortune.[or]If you put in a window-pane with putty, you will seek fortune with poor results.[cycling]"
"an"	"ouija"	"[one of]To dream of working on an ouija board, foretells the miscarriage of plans and unlucky partnerships.[or]To fail to work, one is ominous of complications, caused by substituting pleasure for business.[or]If it writes fluently, you may expect fortunate results from some well-planned enterprise.[or]If a negro steals it, you will meet with trials and vexations past endurance.[or]To recover it, foretells that grievances will meet a favorable adjustment.[cycling]"
"an"	"obituary"	"[one of]To dream of writing an obituary, denotes that unpleasant and discordant duties will devolve upon you.[or]If you read one, news of a distracting nature will soon reach you.[cycling]"
"a"	"yarn"	"[one of]To dream of yarn, denotes success in your business and an industrious companion in your home.[or]For a young woman to dream that she works with yarn, foretells that she will be proudly recognized by a worthy man as his wife.[cycling]"
"a"	"bladder"	"[one of]To dream of your bladder, denotes you will have heavy trouble in your business if you are not careful of your health and the way you spend your energies.[or]To see children blowing up bladders, foretells your expectations will fail to give you much comfort.[cycling]"
"a"	"daughter-in-law"	"[one of]To dream of your daughter-in-law, indicates some unusual occurence{sic} will add to happiness, or disquiet, according as she is pleasant or unreasonable.[cycling]"
"a"	"daughter"	"[one of]To dream of your daughter, signifies that many displeasing incidents will give way to pleasure and harmony.[or]If in the dream, she fails to meet your wishes, through any cause, you will suffer vexation and discontent.[cycling]"
"a"	"father-in-law"	"[one of]To dream of your father-in-law, denotes contentions with friends or relatives.[or]To see him well and cheerful, foretells pleasant family relations.[cycling]"
"a"	"father"	"[one of]To dream of your father, signifies that you are about to be involved in a difficulty, and you will need wise counsel if you extricate yourself therefrom.[or]If he is dead, it denotes that your business is pulling heavily, and you will have to use caution in conducting it.[or]For a young woman to dream of her dead father, portends that her lover will, or is, playing her false.[cycling]"
"a"	"pimple"	"[one of]To dream of your flesh being full of pimples, denotes worry over trifles.[or]To see others with pimples on them, signifies that you will be troubled with illness and complaints from others.[or]For a woman to dream that her beauty is marred by pimples, her conduct in home or social circles will be criticised by friends and acquaintances.[or]You may have small annoyances to follow this dream.[cycling]"
"a"	"genealogical tree"	"[one of]To dream of your genealogical tree, denotes you will be much burdened with family cares, or will find pleasure in other domains than your own.[or]To see others studying it, foretells that you will be forced to yield your rights to others.[or]If any of the branches are missing, you will ignore some of your friends because of their straightened circumstances.[cycling]"
"a"	"heart"	"[one of]To dream of your heart paining and suffocating you, there will be trouble in your business.[or]Some mistake of your own will bring loss if not corrected.[or]Seeing your heart, foretells sickness and failure of energy.[or]To see the heart of an animal, you will overcome enemies and merit the respect of all.[or]To eat the heart of a chicken, denotes strange desires will cause you to carry out very difficult projects for your advancement.[cycling]"
"a"	"mother-in-law"	"[one of]To dream of your mother-in-law, denotes there will be pleasant reconciliations for you after some serious disagreement.[or]For a woman to dispute with her mother-in-law, she will find that quarrelsome and unfeeling people will give her annoyance.[cycling]"
"a"	"flag"	"[one of]To dream of your national flag, portends victory if at war, and if at peace, prosperity.[or]For a woman to dream of a flag, denotes that she will be ensnared by a soldier.[or]To dream of foreign flags, denotes ruptures and breach of confidence between nations and friends.[or]To dream of being signaled by a flag, denotes that you should be careful of your health and name, as both are threatened.[cycling]"
"a"	"nephew"	"[one of]To dream of your nephew, denotes you are soon to come into a pleasing competency, if he is handsome and well looking; otherwise, there will be disappointment and discomfort for you.[cycling]"
"an"	"offspring"	"[one of]To dream of your own offspring, denotes cheerfulness and the merry voices of neighbors and children.[or]To see the offspring of domestic animals, denotes increase in prosperity.[cycling]"
"a"	"pocket"	"[one of]To dream of your pocket, is a sign of evil demonstrations against you.[cycling]"
"a"	"pulse"	"[one of]To dream of your pulse, is warning to look after your affairs and health with close care, as both are taking on debilitating conditions.[or]To dream of feeling the pulse of another, signifies that you are committing depredations in.[or]Pleasure's domain.[cycling]"
"a"	"purse"	"[one of]To dream of your purse being filled with diamonds and new bills, denotes for you associations where ``Good.[or]Cheer'' is the watchword, and harmony and tender loves will make earth a beautiful place.[cycling]"
"a"	"kite"	"[one of]To dream of your seeing a kite, showeth you shall be in danger of thieves and robbers.[cycling]"
"a"	"son"	"[one of]To dream of your son, if you have one, as being handsome and dutiful, foretells that he will afford you proud satisfaction, and will aspire to high honors.[or]If he is maimed, or suffering from illness or accident, there is trouble ahead for you.[or]For a mother to dream that her son has fallen to the bottom of a well, and she hears cries, it is a sign of deep grief, losses and sickness.[or]If she rescues him, threatened danger will pass away unexpectedly.[cycling]"
"a"	"wardrobe"	"[one of]To dream of your wardrobe, denotes that your fortune will be endangered by your attempts to appear richer than you are.[or]If you imagine you have a scant wardrobe, you will seek association with strangers.[cycling]"
"a"	"wife"	"[one of]To dream of your wife, denotes unsettled affairs and discord in the home.[or]To dream that your wife is unusually affable, denotes that you will receive profit from some important venture in trade.[or]For a wife to dream her husband whips her, foretells unlucky influences will cause harsh criticism in the home and a general turmoil will ensue.[cycling]"
"a"	"nose"	"[one of]To dream one has a fair and great nose is a good to all, for it denotes prosperity in affairs, and acquaintance with rich persons.[cycling]"
"a"	"church"	"[one of]To dream one is at church and praying there signifies joy and comfort.[or]To dream of singing in church is a dream of bad consequence.[cycling]"
"a"	"quagmire"	"[one of]To dream one is falling into a quagmire, shows obstructions and difficulty in business.[cycling]"
"a"	"small-pox"	"[one of]To dream one is full of the small-pox, denotes profit and wealth without infamy.[cycling]"
"a"	"hunger"	"[one of]To dream one is unusually hungry, and that his appetite craves sustenance, shows he will be ingenious, laborious and eager in getting an estate, and will grow rich.[cycling]"
"a"	"violin"	"[one of]To dream one plays or sees another play upon the violin or other musical instrument, signifies good news and concord between man and wife, master and apprentice, brother and sister, &c.[cycling]"
"a"	"father-in-law"	"[one of]To dream one sees his father-in-law, either dead or alive, is ill, especially if he dreams that he uses violence or threatening.[cycling]"
"a"	"belly"	"[one of]To dream one’s belly is bigger and fuller than ordinary shows his family and estate will increase; if one dreams his belly is grown lean and shrunk up he will be joyfully delivered of some bad accident; if any one dreams that his belly is swelled and yet notwithstanding be empty he will become poor; if a girl dreams of a big belly it is a sign of marriage.[cycling]"
"a"	"belly"	"[one of]To dream one’s belly is bigger and fuller than ordinary, shows his family and estate will increase.[or]If one dreams his belly is grown lean and shrunk up, he will be joyfully delivered of some bad accident.[or]If any one dreams that his belly is swelled, and yet notwithstanding be empty, he will become poor, though he be rich in the esteem of many people in the world.[or]If any one dreams his belly aches, he will be afflicted in his family and have many cares upon him.[cycling]"
"a"	"capon"	"[one of]To dream that a capon crows, signifies sadness and trouble.[cycling]"
"a"	"slave"	"[one of]To dream that a favorite slave has become ungrateful and run away is a sign that some one has been tampering with him or her but without effect; if in your dream you imagine that one of your favorite negroes has been impertinent or neglectful and is to be flogged and that you feel bad about it it shows that some one will try to injure you through the medium of your slaves and you should therefore look sharp to the characters of white people around.[cycling]"
"a"	"gift"	"[one of]To dream that a friend presents you with a valuable gift predicts that you will lose something.[or]If a girl dreams that her lover gives her a present it is a sign that she will allow him the husband’s privilege before marriage.[cycling]"
"a"	"jart"	"[one of]To dream that a house is jarred or shook by an earthquake an explosion or anything that may occur outside is a sign that the head of the family in that house will be sick.[or]Jars of preserved fruit or jellies seen in a dream are good omens; if you dream you are presented with one or more of them it shows you will be long lived and thrifty.[cycling]"
"a"	"son"	"[one of]To dream that a man talks with his son, signifies some damage that will suddenly accrue to him.[cycling]"
"an"	"officer"	"[one of]To dream that a military officer is in your company shadows forth beggary and disgrace.[or]If a girl dreams that she has such a person for a lover she may calculate that her first suitor will be a poor shoat of no account whatever.[cycling]"
"a"	"nurse"	"[one of]To dream that a nurse is retained in your home, foretells distressing illness, or unlucky visiting among friends.[or]To see a nurse leaving your house, omens good health in the family.[or]For a young woman to dream that she is a nurse, denotes that she will gain the esteem of people, through her self-sacrifice.[or]If she parts from a patient, she will yield to the persuasion of deceit.[cycling]"
"a"	"phantom"	"[one of]To dream that a phantom pursues you, foretells strange and disquieting experiences.[or]To see a phantom fleeing from you, foretells that trouble will assume smaller proportions.[cycling]"
"a"	"priest"	"[one of]To dream that a priest offers you service or visits you for any purpose is a sign that you will be robbed; if you dream you go to one for advice it foretells that some misfortune will overtake you: any dream about a priest is a bad one.[cycling]"
"a"	"ram"	"[one of]To dream that a ram pursues you, foretells that some misfortune threatens you.[or]To see one quietly grazing denotes that you will have powerful friends, who will use their best efforts for your good.[or]Sheep and.[cycling]"
"a"	"ramt"	"[one of]To dream that a ram runs at you for butting purposes shadows forth to a young man that his society will be coveted by the girls and that he will be fortunate in love matters generally: if a girl dreams this she will probably have her choice of lovers as all the young fellows around there will fall in love with her: if the ram succeeds in butting her she will surely be taken captive and brought as.[or]Cupid’s prisoner into the matrimonial ranks.[cycling]"
"a"	"ransom"	"[one of]To dream that a ransom is made for you, you will find that you are deceived and worked for money on all sides.[or]For a young woman, this is prognostic of evil, unless some one pays the ransom and relieves her.[cycling]"
"an"	"overflow"	"[one of]To dream that a river or any stream overflows its banks and surrounds your house with water is a sign of wealth; that is you will acquire riches in proportion to the quantity of water around and the ground it covers: if you fancy that any one is drowned in the water it foretells a misfortune in connection with your riches.[cycling]"
"a"	"warrant"	"[one of]To dream that a warrant is being served on you, denotes that you will engage in some important work which will give you great uneasiness as to its standing and profits.[or]To see a warrant served on some one else, there will be danger of your actions bringing you into fatal quarrels or misunderstandings.[or]You are likely to be justly indignant with the wantonness of some friend.[cycling]"
"an"	"accident"	"[one of]To dream that an accident has happened to you or to any one of your household or with whom you live foretells that you will see some one whom you little expect to see.[cycling]"
"a"	"perjury"	"[one of]To dream that any one injures you by false swearing or by perjury in court is a sign that you will discover some friend or acquaintance to be dishonest or guilty of a crime or of mean conduct; if a girl dream this it is a similar omen relative to her lover.[cycling]"
"a"	"liar"	"[one of]To dream that any one offends you by lying or defaming your family by lies is a sign you will receive a benefit at the hands of a stranger.[cycling]"
"a"	"praise"	"[one of]To dream that any one praises or flatters you is a sign of scandal: if a girl dreams that her lover praises her good looks or amiability she bad better discard him as a false-hearted person who cares nothing about her but is merely flattering his own vanity.[cycling]"
"a"	"violence"	"[one of]To dream that any person does you violence, denotes that you will be overcome by enemies.[or]If you do some other persons violence, you will lose fortune and favor by your reprehensible way of conducting your affairs.[cycling]"
"a"	"hypocrite"	"[one of]To dream that anyone has acted the hypocrite with you, you will be turned over to your enemies by false friends.[or]To dream that you are a hypocrite, denotes that you will prove yourself a deceiver and be false to friends.[cycling]"
"an"	"evening"	"[one of]To dream that evening is about you, denotes unrealized hopes, and you will make unfortunate ventures.[or]To see stars shining out clear, denotes present distress, but brighter fortune is behind your trouble.[or]For lovers to walk in the evening, denotes separation by the death of one.[cycling]"
"a"	"lettuce"	"[one of]To dream that one eats salads made of lettuce, and other herbs that may be eaten raw, signifies trouble and difficulty in the management of affairs.[cycling]"
"a"	"seat"	"[one of]To dream that one has fallen from his seat, and would fain get into it again signifies that whatever office or employment he is in, he shall be displaced from it, and not be able to recover it again.[cycling]"
"a"	"wren"	"[one of]To dream that one of these musical little birds makes her nest anywhere on your premises is a sign of joy and riches; a girl who dreams this will make a happy match though perhaps not a rich one as the riches only come to the family that lives in the house.[cycling]"
"a"	"blindman’s buff"	"[one of]To dream that one plays blindman’s buff, signifies prosperity, joy and pleasure.[cycling]"
"a"	"lizard"	"[one of]To dream that one sees a lizard, signifies ill-luck and misfortune by secret enemies.[cycling]"
"a"	"rape"	"[one of]To dream that rape has been committed among your acquaintances, denotes that you will be shocked at the distress of some of your friends.[or]For a young woman to dream that she has been the victim of rape, foretells that she will have troubles, which will wound her pride, and her lover will be estranged.[cycling]"
"a"	"malice"	"[one of]To dream that some one bears you malice, foretells a pleasant prospect in your worldly affairs; and that you will be advanced to some important station either by marriage, if you are not married, or if so, through the influence of friends.[cycling]"
"an"	"offend"	"[one of]To dream that some one has greatly offended you, is an indication that you are going a long journey to some one you greatly esteem.[or]If you dream that you have offended some one you love, it signifies that you are about to be visited by a friend whom you have not seen for a long time.[cycling]"
"a"	"register"	"[one of]To dream that some one registers your name at a hotel for you, denotes you will undertake some work which will be finished by others.[or]If you register under an assumed name, you will engage in some guilty enterprise which will give you much uneasiness of mind.[cycling]"
"a"	"spy"	"[one of]To dream that spies are harassing you, denotes dangerous quarrels and uneasiness.[or]To dream that you are a spy, denotes that you will make unfortunate ventures.[cycling]"
"a"	"snow"	"[one of]To dream that the ground is covered with clean white snow is a sign of joy and pleasure: if you walk in it it foretells that you will go on a pleasant journey; to eat it denotes health: if the snow is dirty or melted in patches you will have troubles but they will not amount to much.[or]To dream of a regular storm is a sign you will be very successful in all your love and business affairs.[cycling]"
"a"	"sun"	"[one of]To dream that the sun blinds you foretells that you will be overwhelmed with good fortune: to see a beautiful bright sun is a sign of success in anything you may undertake: a red sun denotes mishaps and accidents: if the sun looks dim and smoky it foreshadows trouble and difficulties.[or]To dream of seeing the sun rise brings good news and luck; the setting sun misfortune.[cycling]"
"a"	"thief"	"[one of]To dream that thieves break into your house and rob you is a sign of honor or profit—the greater the robbery the more extensive will be your good fortune: if you dream that you catch a thief and deliver him over to the officers of justice it denotes that you will have trouble in connection with your good fortune.[cycling]"
"a"	"wart"	"[one of]To dream that war exists and that you see bodies of troops marching foretells quarrels and troubles in your family if you have one and if not among your relatives: if you imagine you see a battle the omen is still worse as the quarrel will probably become public and notorious.[cycling]"
"a"	"good"	"[one of]To dream that we do good to one, signifies jollity and pleasure, and to dream that others do us good, is profit and gain.[cycling]"
"a"	"captive"	"[one of]To dream that you are a captive, denotes that you may have treachery to deal with, and if you cannot escape, that injury and misfortune will befall you.[or]To dream of taking any one captive, you will join yourself to pursuits and persons of lowest status.[or]For a young woman to dream that she is a captive, denotes that she will have a husband who will be jealous of her confidence in others; or she may be censured for her indiscretion.[cycling]"
"a"	"criminal"	"[one of]To dream that you are a criminal shows that disgrace and danger are in store for you.[cycling]"
"a"	"housekeeper"	"[one of]To dream that you are a housekeeper, denotes you will have labors which will occupy your time, and make pleasure an ennobling thing.[or]To employ one, signifies comparative comfort will be possible for your obtaining.[cycling]"
"a"	"mariner"	"[one of]To dream that you are a mariner, denotes a long journey to distant countries, and much pleasure will be connected with the trip.[or]If you see your vessel sailing without you, much personal discomfort will be wrought you by rivals.[cycling]"
"a"	"legislature"	"[one of]To dream that you are a member of a legislature, foretells you will be vain of your possessions and will treat members of your family unkindly.[or]You will have no real advancement.[cycling]"
"a"	"pauper"	"[one of]To dream that you are a pauper, implies unpleasant happenings for you.[or]To see paupers, denotes that there will be a call upon your generosity.[or]Beggars and kindred words.[cycling]"
"a"	"standard-bearer"	"[one of]To dream that you are a standard-bearer, denotes that your occupation will be pleasant, but varied.[or]To see others acting as standard-bearers, foretells that you will be jealous and envious of some friend.[cycling]"
"a"	"street-poster"	"[one of]To dream that you are a street-poster, denotes that you will undertake some unpleasant and unprofitable work.[or]To see street-posters at work, foretells disagreeable news.[cycling]"
"a"	"tourist"	"[one of]To dream that you are a tourist, denotes that you will engage in some pleasurable affair which will take you away from your usual residence.[or]To see tourists, indicates brisk but unsettled business and anxiety in love.[cycling]"
"an"	"usurper"	"[one of]To dream that you are a usurper, foretells you will have trouble in establishing a good title to property.[or]If others are trying to usurp your rights, there will be a struggle between you and your competitors, but you will eventually win.[or]For a young woman to have this dream, she will be a party to a spicy rivalry, in which she will win.[cycling]"
"a"	"vagrant"	"[one of]To dream that you are a vagrant, portends poverty and misery.[or]To see vagrants is a sign of contagion invading your community.[or]To give to a vagrant, denotes that your generosity will be applauded.[cycling]"
"a"	"wet nurse"	"[one of]To dream that you are a wet nurse, denotes that you will be widowed or have the care of the aged, or little children.[or]For a woman to dream that she is a wet nurse, signifies that she will depend on her own labors for sustenance.[cycling]"
"a"	"widow"	"[one of]To dream that you are a widow, foretells that you will have many troubles through malicious persons.[or]For a man to dream that he marries a widow, denotes he will see some cherished undertaking crumble down in disappointment.[cycling]"
"an"	"abroad"	"[one of]To dream that you are abroad, or going abroad, foretells that you will soon, in company with a party, make a pleasant trip, and you will find it necessary to absent yourself from your native country for a sojourn in a different climate.[cycling]"
"an"	"abuse"	"[one of]To dream that you are abused and insulted is a sign that some dispute will happen between you and some person with whom you have business; if you are in love be assured that some one has attempted to injure you with the object of your affections and that they have in a great measure succeeded.[cycling]"
"an"	"abuse"	"[one of]To dream that you are abused and insulted, is a certain sign some dispute will happen between you and some person with whom you have business; therefore after such a dream you should be particularly careful of yourself and be as gentle and mild as possible, that you may not give those with whom you have dealings any advantage over you.[cycling]"
"a"	"typhoid"	"[one of]To dream that you are affected with this malady, is a warning to beware of enemies, and look well to your health.[or]If you dream that there is an epidemic of typhoid, there will be depressions in business, and usual good health will undergo disagreeable changes.[cycling]"
"a"	"hydrophobia"	"[one of]To dream that you are afflicted with hydrophobia, denotes enemies and change of business.[or]To see others thus afflicted, your work will be interrupted by death or ungrateful dependence.[or]To dream that an animal with the rabies bites you, you will be betrayed by your dearest friend, and much scandal will be brought to light.[cycling]"
"a"	"palsy"	"[one of]To dream that you are afflicted with palsy, denotes that you are making unstable contracts.[or]To see your friend so afflicted, there will be uncertainty as to his faithfulness and sickness, too, may enter your home.[or]For lovers to dream that their sweethearts have palsy, signifies that dissatisfaction over some question will mar their happiness.[cycling]"
"an"	"abbot"	"[one of]To dream that you are an abbot, warns you that treacherous plots are being laid for your downfall.[or]If you see this pious man in devotional exercises, it forewarns you of smooth flattery and deceit pulling you a willing victim into the meshes of artful bewilderment.[or]For a young woman to talk with an abbot, portends that she will yield to insinuating flatteries, and in yielding she will besmirch her reputation.[or]If she marries one, she will uphold her name and honor despite poverty and temptation.[or]See similar words in connection with churches, priests, etc.[cycling]"
"a"	"scandal"	"[one of]To dream that you are an object of scandal, denotes that you are not particular to select good and true companions, but rather enjoy having fast men and women contribute to your pleasure.[or]Trade and business of any character will suffer dulness after this dream.[or]For a young woman to dream that she discussed a scandal, foretells that she will confer favors, which should be sacred, to some one who will deceive her into believing that he is honorably inclined.[or]Marriage rarely follows swiftly after dreaming of scandal.[cycling]"
"a"	"goose"	"[one of]To dream that you are annoyed by the quacking of geese, denotes a death in your family.[or]To see them swimming, denotes that your fortune is gradually increasing.[or]To see them in grassy places, denotes assured success.[or]If you see them dead, you will suffer loss and displeasure.[or]For a lover, geese denotes the worthiness of his affianced.[or]If you are picking them, you will come into an estate.[or]To eat them, denotes that your possessions are disputed.[cycling]"
"an"	"education"	"[one of]To dream that you are anxious to obtain an education, shows that whatever your circumstances in life may be there will be a keen desire for knowledge on your part, which will place you on a higher plane than your associates.[or]Fortune will also be more lenient to you.[or]To dream that you are in places of learning, foretells for you many influential friends.[cycling]"
"a"	"feasting"	"[one of]To dream that you are at a feast, denotes that you will meet with many disappointments, particularly in the thing which you are most anxious about.[or]In love it forebodes much uneasiness between sweethearts, and to them which are married it foretells undutiful children, with many heavy losses.[cycling]"
"a"	"fountain"	"[one of]To dream that you are at a fountain, is a very favorable omen.[or]If the waters are clear, it denotes riches and honors; and in love, it foretells great happiness in the marriage state, and that your sweetheart is of an amiable disposition and true to you; but if the waters appear muddy, then it denotes vexation and trouble, disappointment in business, inconstancy in your sweetheart and misery in the marriage state.[cycling]"
"a"	"jubilee"	"[one of]To dream that you are at a jubilee, is a sure sign that you will have a fortune left you by some rich relations.[cycling]"
"an"	"election"	"[one of]To dream that you are at an election, foretells you will engage in some controversy which will prove detrimental to your social or financial standing.[cycling]"
"a"	"rusk"	"[one of]To dream that you are baking them, is good; but to dream that you see others bake them, is bad.[cycling]"
"a"	"resuscitate"	"[one of]To dream that you are being resuscitated, denotes that you will have heavy losses, but will eventually regain more than you lose, and happiness will attend you.[or]To resuscitate another, you will form new friendships, which will give you prominence and pleasure.[cycling]"
"a"	"bite"	"[one of]To dream that you are bitten foretells much jealousy and sorrow.[cycling]"
"a"	"tea"	"[one of]To dream that you are brewing tea, foretells that you will be guilty of indiscreet actions, and will feel deeply remorseful.[or]To see your friends drinking tea, and you with them, denotes that social pleasures will pall on you, and you will seek to change your feelings by serving others in their sorrows.[or]To see dregs in your tea, warns you of trouble in love, and affairs of a social nature.[or]To spill tea, is a sign of domestic confusion and grief.[or]To find your tea chest empty, unfolds much disagreeable gossip and news.[or]To dream that you are thirsty for tea, denotes that you will be surprised with uninvited guests.[cycling]"
"a"	"shelter"	"[one of]To dream that you are building a shelter, signifies that you will escape the evil designs of enemies.[or]If you are seeking shelter, you will be guilty of cheating, and will try to justify yourself.[cycling]"
"a"	"crawl"	"[one of]To dream that you are crawling on the floor is bad; but to dream that you are crawling on the roof of a house is good, particularly to the lovers, as it is a sure sign they will be married.[cycling]"
"a"	"crawl"	"[one of]To dream that you are crawling on the ground, and hurt your hand, you may expect humiliating tasks to be placed on you.[or]To crawl over rough places and stones, indicates that you have not taken proper advantage of your opportunities.[or]A young woman, after dreaming of crawling, if not very careful of her conduct, will lose the respect of her lover.[or]To crawl in mire with others, denotes depression in business and loss of credit.[or]Your friends will have cause to censure you.[cycling]"
"a"	"fraud"	"[one of]To dream that you are defrauding a person, denotes that you will deceive your employer for gain, indulge in degrading pleasures, and fall into disrepute.[or]If you are defrauded, it signifies the useless attempt of enemies to defame you and cause you loss.[or]To accuse some one of defrauding you, you will be offered a place of high honor.[cycling]"
"a"	"disease"	"[one of]To dream that you are diseased, denotes a slight attack of illness, or of unpleasant dealings with a relative.[or]For a young woman to dream that she is incurably diseased, denotes that she will be likely to lead a life of single blessedness.[cycling]"
"a"	"tandem"	"[one of]To dream that you are driving tandem, denotes that you will be prosperous in business and in the marriage state.[cycling]"
"a"	"breakfast"	"[one of]To dream that you are eating breakfast shows you will do something of which you will be sorry.[cycling]"
"an"	"ice cream"	"[one of]To dream that you are eating ice cream, foretells you will have happy success in affairs already undertaken.[or]To see children eating it, denotes prosperity and happiness will attend you most favorably.[or]For a young woman to upset her ice cream in the presence of her lover or friend, denotes she will be flirted with because of her unkindness to others.[or]To see sour ice cream, denotes some unexpected trouble will interfere with your pleasures.[or]If it is melted, your anticipated pleasure will reach stagnation before it is realized.[cycling]"
"an"	"eating"	"[one of]To dream that you are eating, is a very unfavorable omen; it portends disunion in your family, losses in trade, and disappointment in love, storms and shipwrecks by sea.[cycling]"
"a"	"well"	"[one of]To dream that you are employed in a well, foretells that you will succumb to adversity through your misapplied energies.[or]You will let strange elements direct your course.[or]To fall into a well, signifies that overwhelming despair will possess you.[or]For one to cave in, promises that enemies' schemes will overthrow your own.[or]To see an empty well, denotes you will be robbed of fortune if you allow strangers to share your confidence.[or]To see one with a pump in it, shows you will have opportunities to advance your prospects.[or]To dream of an artesian well, foretells that your splendid resources will gain you admittance into the realms of knowledge and pleasure.[or]To draw water from a well, denotes the fulfilment of ardent desires.[or]If the water is impure, there will be unpleasantness.[cycling]"
"a"	"pardon"	"[one of]To dream that you are endeavoring to gain pardon for an offense which you never committed, denotes that you will be troubled, and seemingly with cause, over your affairs, but it will finally appear that it was for your advancement.[or]If offense was committed, you will realize embarrassment in affairs.[or]To receive pardon, you will prosper after a series of misfortunes.[or]See kindred words.[cycling]"
"a"	"mist"	"[one of]To dream that you are enveloped in a mist, denotes uncertain fortunes and domestic unhappiness.[or]If the mist clears away, your troubles will be of short duration.[or]To see others in a mist, you will profit by the misfortune of others.[cycling]"
"a"	"storm"	"[one of]To dream that you are exposed to a violent storm, denotes that a reconciliation is about to take place between you and one with whom you have been at variance.[cycling]"
"a"	"villainy"	"[one of]To dream that you are exposed to some villainy by one from whom you expected different conduct, denotes that you will be astonished to learn that you have had a fortune left to you by one who was no relation.[cycling]"
"a"	"famish"	"[one of]To dream that you are famishing, foretells that you are meeting disheartening failure in some enterprise which you considered a promising success.[or]To see others famishing, brings sorrow to others as well as to yourself.[cycling]"
"a"	"vice"	"[one of]To dream that you are favoring any vice, signifies you are about to endanger your reputation, by letting evil persuasions entice you.[or]If you see others indulging in vice, some ill fortune will engulf the interest of some relative or associate.[cycling]"
"a"	"gambling-house"	"[one of]To dream that you are gambling and win, signifies low associations and pleasure at the expense of others.[or]If you lose, it foretells that your disgraceful conduct will be the undoing of one near to you.[cycling]"
"a"	"fat"	"[one of]To dream that you are getting fat, denotes that you are about to make a fortunate change in your life.[or]To see others fat, signifies prosperity.[cycling]"
"an"	"advertisement"	"[one of]To dream that you are getting out advertisements, denotes that you will have to resort to physical labor to promote your interest, or establish your fortune.[or]To read advertisements, denotes that enemies will overtake you, and defeat you in rivalry.[cycling]"
"a"	"girdle"	"[one of]To dream that you are girt with an old girdle, signifies labor and pains.[or]A new girdle signifies honor.[cycling]"
"a"	"work"	"[one of]To dream that you are hard at work, denotes that you will win merited success by concentration of energy.[or]To see others at work, denotes that hopeful conditions will surround you.[or]To look for work, means that you will be benefited by some unaccountable occurrence.[cycling]"
"a"	"hunger"	"[one of]To dream that you are hungry, is an unfortunate omen.[or]You will not find comfort and satisfaction in your home, and to lovers it means an unhappy marriage.[cycling]"
"a"	"basement"	"[one of]To dream that you are in a basement, foretells that you will see prosperous opportunities abating, and with them, pleasure will dwindle into trouble and care.[cycling]"
"a"	"library"	"[one of]To dream that you are in a library, denotes that you will grow discontented with your environments and associations and seek companionship in study and the exploration of ancient customs.[or]To find yourself in a library for other purpose than study, foretells that your conduct will deceive your friends, and where you would have them believe that you had literary aspirations, you will find illicit assignations.[cycling]"
"a"	"mansion"	"[one of]To dream that you are in a mansion where there is a haunted chamber, denotes sudden misfortune in the midst of contentment.[or]To dream of being in a mansion, indicates for you wealthy possessions.[or]To see a mansion from distant points, foretells future advancement.[cycling]"
"a"	"market"	"[one of]To dream that you are in a market, denotes thrift and much activity in all occupations.[or]To see an empty market, indicates depression and gloom.[or]To see decayed vegetables or meat, denotes losses in business.[or]For a young woman, a market foretells pleasant changes.[cycling]"
"a"	"perspiration"	"[one of]To dream that you are in a perspiration, foretells that you will come out of some difficulty, which has caused much gossip, with new honors.[cycling]"
"a"	"race"	"[one of]To dream that you are in a race, foretells that others will aspire to the things you are working to possess, but if you win in the race, you will overcome your competitors.[cycling]"
"a"	"rogue's gallery"	"[one of]To dream that you are in a rogue's gallery, foretells you will be associated with people who will fail to appreciate you.[or]To see your own picture, you will be overawed by a tormenting enemy.[cycling]"
"a"	"rowboat"	"[one of]To dream that you are in a rowboat with others, denotes that you will derive much pleasure from the companionship of gay and worldly persons.[or]If the boat is capsized, you will suffer financial losses by engaging in seductive enterprises.[or]If you find yourself defeated in a rowing race, you will lose favors to your rivals with your sweetheart.[or]If you are the victor, you will easily obtain supremacy with women.[or]Your affairs will move agreeably.[cycling]"
"a"	"shower"	"[one of]To dream that you are in a shower, foretells that you will derive exquisite pleasure in the study of creation and the proper placing of selfish pleasures.[cycling]"
"a"	"city"	"[one of]To dream that you are in a strange city, denotes you will have sorrowful occasion to change your abode or mode of living.[cycling]"
"a"	"village"	"[one of]To dream that you are in a village, denotes that you will enjoy good health and find yourself fortunately provided for.[or]To revisit the village home of your youth, denotes that you will have pleasant surprises in store and favorable news from absent friends.[or]If the village looks dilapidated, or the dream indistinct, it foretells that trouble and sadness will soon come to you.[cycling]"
"a"	"work house"	"[one of]To dream that you are in a workhouse denotes that some event will work you harm and loss.[cycling]"
"an"	"attic"	"[one of]To dream that you are in an attic, denotes that you are entertaining hopes which will fail of materialization.[or]For a young woman to dream that she is sleeping in an attic, foretells that she will fail to find contentment in her present occupation.[cycling]"
"an"	"orchard"	"[one of]To dream that you are in an orchard, denotes that you will become rich, that you will marry much to your advantage.[or]For a married person to dream of being in an orchard, shows an increase of children, who will become rich and live happy.[or]In love, it denotes affection and constancy in your sweetheart.[cycling]"
"a"	"need"	"[one of]To dream that you are in need, denotes that you will speculate unwisely and distressing news of absent friends will oppress you.[or]To see others in need, foretells that unfortunate affairs will affect yourself with others.[cycling]"
"a"	"pain"	"[one of]To dream that you are in pain, will make sure of your own unhappiness.[or]This dream foretells useless regrets over some trivial transaction.[or]To see others in pain, warns you that you are making mistakes in your life.[cycling]"
"a"	"wedlock"	"[one of]To dream that you are in the bonds of an unwelcome wedlock, denotes you will be unfortunately implicated in a disagreeable affair.[or]For a young woman to dream that she is dissatisfied with wedlock, foretells her inclinations will persuade her into scandalous escapades.[or]For a married woman to dream of her wedding day, warns her to fortify her strength and feelings against disappointment and grief.[or]She will also be involved in secret quarrels and jealousies.[or]For a woman to imagine she is pleased and securely cared for in wedlock, is a propitious dream.[cycling]"
"an"	"adversity"	"[one of]To dream that you are in the clutches of adversity, denotes that you will have failures and continued bad prospects.[or]To see others in adversity, portends gloomy surroundings, and the illness of some one will produce grave fears of the successful working of plans.[or]The old dream books give this as a sign of coming prosperity.[or]This definition is untrue.[or]There are two forces at work in man, one from within and the other from without.[or]They are from two distinct spheres; the animal mind influenced by the personal world of carnal appetites, and the spiritual mind from the realm of universal.[or]Brotherhood, present antagonistic motives on the dream consciousness.[or]If these two forces were in harmony, the spirit or mental picture from the dream mind would find a literal fulfilment in the life of the dreamer.[or]The pleasurable sensations of the body cause the spirit anguish.[or]The selfish enrichment of the body impoverishes the spirit influence upon the.[or][or]The trials of adversity often cause the spirit to rejoice and the flesh to weep.[or]If the cry of the grieved spirit is left on the dream mind it may indicate to the dreamer worldly advancement, but it is hardly the theory of the occult forces, which have contributed to the contents of this book.[cycling]"
"a"	"prostitute"	"[one of]To dream that you are in the company of a prostitute, denotes that you will incur the righteous scorn of friends for some ill-mannered conduct.[or]For a young woman to dream of a prostitute, foretells that she will deceive her lover as to her purity or candor.[or]This dream to a married woman brings suspicion of her husband and consequent quarrels.[cycling]"
"a"	"dome"	"[one of]To dream that you are in the dome of a building, viewing a strange landscape, signifies a favorable change in your life.[or]You will occupy honorable places among strangers.[or]To behold a dome from a distance, portends that you will never reach the height of your ambition, and if you are in love, the object of your desires will scorn your attention.[cycling]"
"a"	"joyt"	"[one of]To dream that you are in the ecstasy of joy at anything that has happened bodes pain and trouble; something will be sure to occur to make you unhappy.[cycling]"
"a"	"whirlwind"	"[one of]To dream that you are in the path of a whirlwind, foretells that you are confronting a change which threatens to overwhelm you with loss and calamity.[or]For a young woman to dream that she is caught in a whirlwind and has trouble to keep her skirts from blowing up and entangling her waist, denotes that she will carry on a secret flirtation and will be horrified to find that scandal has gotten possession of her name and she will run a close risk of disgrace and ostracism.[cycling]"
"a"	"want"	"[one of]To dream that you are in want, denotes that you have unfortunately ignored the realities of life, and chased folly to her stronghold of sorrow and adversity.[or]If you find yourself contented in a state of want, you will bear the misfortune which threatens you with heroism, and will see the clouds of misery disperse.[or]To relieve want, signifies that you will be esteemed for your disinterested kindness, but you will feel no pleasure in well doing.[cycling]"
"a"	"paradise"	"[one of]To dream that you are in.[or]Paradise, means loyal friends, who are willing to aid you.[or]This dream holds out bright hopes to sailors or those about to make a long voyage.[or]To mothers, this means fair and obedient children.[or]If you are sick and unfortunate, you will have a speedy recovery and your fortune will ripen.[or]To lovers, it is the promise of wealth and faithfulness.[or]To dream that you start to.[or]Paradise and find yourself bewildered and lost, you will undertake enterprises which look exceedingly feasible and full of fortunate returns, but which will prove disappointing and vexatious.[cycling]"
"an"	"industry"	"[one of]To dream that you are industrious, denotes that you will be unusually active in planning and working out ideas to further your interests, and that you will be successful in your undertakings.[or]For a lover to dream of being industriously at work, shows he will succeed in business, and that his companion will advance his position.[or]To see others busy, is favorable to the dreamer.[cycling]"
"a"	"leprosy"	"[one of]To dream that you are infected with this dread disease, foretells sickness, by which you will lose money and incur the displeasure of others.[or]If you see others afflicted thus, you will meet discouraging prospects and love will turn into indifference.[cycling]"
"a"	"jealousy"	"[one of]To dream that you are jealous of your wife, denotes the influence of enemies and narrow-minded persons.[or]If jealous of your sweetheart, you will seek to displace a rival.[or]If a woman dreams that she is jealous of her husband, she will find many shocking incidents to vex and make her happiness a travesty.[or]If a young woman is jealous of her lover, she will find that he is more favorably impressed with the charms of some other woman than herself.[or]If men and women are jealous over common affairs, they will meet many unpleasant worries in the discharge of every-day business.[cycling]"
"a"	"nightingale"	"[one of]To dream that you are listening to the harmonious notes of the nightingale, foretells a pleasing existence, and prosperous and healthy surroundings.[or]This is a most favorable dream to lovers, and parents.[or]To see nightingales silent, foretells slight misunderstandings among friends.[cycling]"
"a"	"farm"	"[one of]To dream that you are living on a farm, denotes that you will be fortunate in all undertakings.[or]To dream that you are buying a farm, denotes abundant crops to the farmer, a profitable deal of some kind to the business man, and a safe voyage to travelers and sailors.[or]If you are visiting a farm, it signifies pleasant associations.[cycling]"
"a"	"doomsday"	"[one of]To dream that you are living on, and looking forward to seeing doomsday, is a warning for you to give substantial and material affairs close attention, or you will find that the artful and scheming friends you are entertaining will have possession of what they desire from you, which is your wealth, and not your sentimentality.[or]To a young woman, this dream encourages her to throw aside the attention of men above her in station and accept the love of an honest and deserving man near her.[cycling]"
"a"	"globe"	"[one of]To dream that you are looking at a globe, foretells much good, and that you will become a great traveler.[cycling]"
"a"	"torrent"	"[one of]To dream that you are looking upon a rushing torrent, denotes that you will have unusual trouble and anxiety.[cycling]"
"a"	"lice"	"[one of]To dream that you are lousy and that you are killing a great number of them, is a very good omen.[or]It denotes great riches to the dreamer.[or]They also portend deliverance from enemies, and that you will overcome much slander and malice.[cycling]"
"a"	"bed"	"[one of]To dream that you are lying in bed signifies that you are in danger; being in bed and not able to sleep sickness; to see a stranger in your bed brings quarrels in married life; a well-made bed shows that you will become established in life.[cycling]"
"a"	"vow"	"[one of]To dream that you are making or listening to vows, foretells complaint will be made against you of unfaithfulness in business, or some love contract.[or]To take the vows of a church, denotes you will bear yourself with unswerving integrity through some difficulty.[or]To break or ignore a vow, foretells disastrous consequences will attend your dealings.[cycling]"
"an"	"island"	"[one of]To dream that you are on a deserted island shows that you will commit some act to disgust your friends and make them cut your acquaintance; be careful how you behave after dreaming such a dream.[cycling]"
"an"	"island"	"[one of]To dream that you are on an island in a clear stream, signifies pleasant journeys and fortunate enterprises.[or]To a woman, this omens a happy marriage.[or]A barren island, indicates forfeiture of happiness and money through intemperance.[or]To see an island, denotes comfort and easy circumstances after much striving and worrying to meet honorable obligations.[or]To see people on an island, denotes a struggle to raise yourself higher in prominent circles.[cycling]"
"a"	"jury"	"[one of]To dream that you are on the jury, denotes dissatisfaction with your employments, and you will seek to materially change your position.[or]If you are cleared from a charge by the jury, your business will be successful and affairs will move your way, but if you should be condemned, enemies will overpower you and harass you beyond endurance.[cycling]"
"a"	"boat"	"[one of]To dream that you are on the water in a boat, provided you are in company, denotes prosperity and success in your undertakings.[or]If you dream you are in a boat alone, it is a bad omen.[or]To dream the boat oversets, is the most fatal of all omens.[cycling]"
"a"	"heat"	"[one of]To dream that you are oppressed by heat, denotes failure to carry out designs on account of some friend betraying you.[or]Heat is not a very favorable dream.[cycling]"
"a"	"humidity"	"[one of]To dream that you are overcome with humidity, foretells that you will combat enemies fiercely, but their superior force will submerge you in overwhelming defeat.[cycling]"
"a"	"carnival"	"[one of]To dream that you are participating in a carnival, portends that you are soon to enjoy some unusual pleasure or recreation.[or]A carnival when masks are used, or when incongruous or clownish figures are seen, implies discord in the home; business will be unsatisfactory and love unrequited.[cycling]"
"a"	"blind man's buff"	"[one of]To dream that you are playing at blind man's buff, denotes that you are about to engage in some weak enterprise which will likely humiliate you, besides losing money for you.[cycling]"
"a"	"parrot"	"[one of]To dream that you are pleased with the chattering of one of these birds is a sign that some deceitful person will flatter you: if an engaged young girl has such a dream she should look sharp to the antecedents of her lover before marriage as it is ten to one that he is not worthy of her confidence: the dream may however point to some other flatterer.[cycling]"
"a"	"poison"	"[one of]To dream that you are poisoned is a sign you will get into bad or unworthy company: if you imagine that any friend or acquaintance is poisoned it is a similar omen as regards them: if in your dream you think any one has given you poison to murder you it foretells that some base proposal will be made to you.[cycling]"
"a"	"wealth"	"[one of]To dream that you are possessed of much wealth, foretells that you will energetically nerve yourself to meet the problems of life with that force which compells success.[or]To see others wealthy, foretells that you will have friends who will come to your rescue in perilous times.[or]For a young woman to dream that she is associated with wealthy people, denotes that she will have high aspirations and will manage to enlist some one who is able to further them.[cycling]"
"an"	"abundance"	"[one of]To dream that you are possessed with an abundance; foretells that you will have no occasion to reproach.[or]Fortune, and that you will be independent of her future favors; but your domestic happiness may suffer a collapse under the strain you are likely to put upon it by your infidelity.[cycling]"
"an"	"inquest"	"[one of]To dream that you are present at a coroner’s inquest is a bad sign; you will soon squander your fortune.[cycling]"
"a"	"silver"	"[one of]To dream that you are presented with spoons or any silver plate for household use foretells that you or some near relative will shortly marry: if you dream of buying these articles it is a sign of poverty: to dream of silver dollars or bars of silver used in commerce is a sign that you will gain money either by a legacy or speculation.[cycling]"
"a"	"ramble"	"[one of]To dream that you are rambling through the country, denotes that you will be oppressed with sadness, and the separation from friends, but your worldly surroundings will be all that one could desire.[or]For a young woman, this dream promises a comfortable home, but early bereavement.[cycling]"
"a"	"history"	"[one of]To dream that you are reading history, indicates a long and pleasant recreation.[cycling]"
"a"	"dictionary"	"[one of]To dream that you are referring to a dictionary, signifies you will depend too much upon the opinion and suggestions of others for the clear management of your own affairs, which could be done with proper dispatch if your own will was given play.[cycling]"
"a"	"resurrection"	"[one of]To dream that you are resurrected from the dead, you will have some great vexation, but will eventually gain your desires.[or]To see others resurrected, denotes unfortunate troubles will be lightened by the thoughtfulness of friends.[cycling]"
"a"	"rub"	"[one of]To dream that you are rubbing anything, denotes to the lover that he will marry a very industrious girl, and be successful in business.[cycling]"
"a"	"wild"	"[one of]To dream that you are running about wild, foretells that you will sustain a serious fall or accident.[or]To see others doing so, denotes unfavorable prospects will cause you worry and excitement.[cycling]"
"a"	"rupture"	"[one of]To dream that you are ruptured, denotes you will have physical disorders or disagreeable contentions.[or]If it be others you see in this condition, you will be in danger of irreconcilable quarrels.[cycling]"
"a"	"scandal"	"[one of]To dream that you are scandalized by one from whom you expected different treatment, is an indication that you will be the recipient of a legacy from a distant relative from whom you did not expect anything of the kind.[cycling]"
"a"	"valentine"	"[one of]To dream that you are sending valentines, foretells that you will lose opportunities of enriching yourself.[or]For a young woman to receive one, denotes that she will marry a weak, but ardent lover against the counsels of her guardians.[cycling]"
"an"	"errand"	"[one of]To dream that you are sent of an errand signifies great loss to the married; to the lover it denotes success in his pursuits and that he will shortly marry a very amiable and accomplished maiden.[cycling]"
"an"	"errand"	"[one of]To dream that you are sent of an errand, signifies great loss to the married; to the lover it denotes success in his pursuit, and that he will shortly marry a very amiable and accomplished maiden.[or]For a maiden to dream that she was sent on an errand, denotes that she will shortly marry the object of her affections and be very happy.[or]To the sick it denotes a speedy recovery.[cycling]"
"a"	"shot"	"[one of]To dream that you are shot, and are feeling the sensations of dying, denotes that you are to meet unexpected abuse from the ill feelings of friends, but if you escape death by waking, you will be fully reconciled with them later on.[or]To dream that a preacher shoots you, signifies that you will be annoyed by some friend advancing views condemnatory to those entertained by yourself.[cycling]"
"a"	"sigh"	"[one of]To dream that you are sighing over any trouble or sad event, denotes that you will have unexpected sadness, but some redeeming brightness in your season of trouble.[or]To hear the sighing of others, foretells that the misconduct of dear friends will oppress you with a weight of gloom.[cycling]"
"a"	"skate"	"[one of]To dream that you are skating on ice, foretells that you are in danger of losing employment, or valuable articles.[or]If you break through the ice, you will have unworthy friends to counsel you.[or]To see others skating, foretells that disagreeable people will connect your name in scandal with some person who admires you.[or]To see skates, denotes discord among your associates.[or]To see young people skating on roller skates, foretells that you will enjoy good health, and feel enthusiastic over the pleasures you are able to contribute to others.[cycling]"
"a"	"slander"	"[one of]To dream that you are slandered, is a sign of your untruthful dealings with ignorance.[or]If you slander any one, you will feel the loss of friends through selfishness.[cycling]"
"a"	"fever"	"[one of]To dream that you are stricken with this malady, signifies that you are worrying over trifling affairs while the best of life is slipping past you, and you should pull yourself into shape and engage in profitable work.[or]To dream of seeing some of your family sick with fever, denotes temporary illness for some of them.[cycling]"
"a"	"grammar"	"[one of]To dream that you are studying grammar, denotes you are soon to make a wise choice in momentous opportunities.[cycling]"
"an"	"urgent"	"[one of]To dream that you are supporting an urgent petition, is a sign that you will engage in some affair which will need fine financiering to carry it through successfully.[cycling]"
"a"	"vermin"	"[one of]To dream that you are surrounded and attacked by vermin, some creeping over your body, and others assailing you in various parts of your frame, signifies that you will be gladdened and rejoiced to learn that you have become entitled to the possession of considerable property through the death of a relative.[cycling]"
"a"	"luxury"	"[one of]To dream that you are surrounded by luxury, indicates much wealth, but dissipation and love of self will reduce your income.[or]For a poor woman to dream that she enjoys much luxury, denotes an early change in her circumstances.[cycling]"
"a"	"temptation"	"[one of]To dream that you are surrounded by temptations, denotes that you will be involved in some trouble with an envious person who is trying to displace you in the confidence of friends.[or]If you resist them, you will be successful in some affair in which you have much opposition.[cycling]"
"a"	"splendor"	"[one of]To dream that you are surrounded with great splendor, and living luxuriously, is an indication that you will soon be laid on a bed of affliction and perhaps death.[cycling]"
"a"	"holy communion"	"[one of]To dream that you are taking part in the.[or]Communion, warns you that you will resign your independent opinions to gain some frivolous desire.[or]If you dream that there is neither bread nor wine for the supper, you will find that you have suffered your ideas to be proselytized in vain, as you are no nearer your goal.[or]If you are refused the right of communion and feel worthy, there is hope for your obtaining some prominent position which has appeared extremely doubtful, as your opponents are popular and powerful.[or]If you feel unworthy, you will meet with much discomfort.[or]To dream that you are in a body of Baptists who are taking communion, denotes that you will find that your friends are growing uncongenial, and you will look to strangers for harmony.[cycling]"
"a"	"conspiracy"	"[one of]To dream that you are the object of a conspiracy, foretells you will make a wrong move in the directing of your affairs.[cycling]"
"a"	"calumny"	"[one of]To dream that you are the subject of calumny, denotes that your interests will suffer at the hands of evil-minded gossips.[or]For a young woman, it warns her to be careful of her conduct, as her movements are being critically observed by persons who claim to be her friends.[cycling]"
"a"	"victim"	"[one of]To dream that you are the victim of any scheme, foretells that you will be oppressed and over-powered by your enemies.[or]Your family relations will also be strained.[or]To victimize others, denotes that you will amass wealth dishonorably and prefer illicit relations, to the sorrow of your companions.[cycling]"
"a"	"tipsy"	"[one of]To dream that you are tipsy, denotes that you will cultivate a jovial disposition, and the cares of life will make no serious inroads into your conscience.[or]To see others tipsy, shows that you are careless as to the demeanor of your associates.[cycling]"
"an"	"ugly"	"[one of]To dream that you are ugly, denotes that you will have a difficulty with your sweetheart, and your prospects will assume a depressed shade.[or]If a young woman thinks herself ugly, she will conduct herself offensively toward her lover, which will probably cause a break in their pleasant associations.[cycling]"
"a"	"quack"	"[one of]To dream that you are under the care of quacks, is unfortunate, and foretells to the person dreaming that he beware of these nuisances in society.[cycling]"
"a"	"torture"	"[one of]To dream that you are undergoing some torture from false accusation, denotes that you will be blessed with much happiness and contentment in your future life.[cycling]"
"an"	"unfortunate"	"[one of]To dream that you are unfortunate, is significant of loss to yourself, and trouble for others.[cycling]"
"a"	"veneer"	"[one of]To dream that you are veneering, denotes that you will systematically deceive your friends, your speculations will be of a misleading nature.[cycling]"
"an"	"independent"	"[one of]To dream that you are very independent, denotes that you have a rival who may do you an injustice.[or]To dream that you gain an independence of wealth, you may not be so succcessful{sic} at that time as you expect, but good results are promised.[cycling]"
"a"	"passion"	"[one of]To dream that you are very passionate with some one, denotes that you are likely to be afflicted with some dangerous sickness, probably unto death.[or]If you dream that some one is in a passion with you, it betokens some good fortune is about to attend you.[cycling]"
"an"	"adventurer"	"[one of]To dream that you are victimized by an adventurer, proves that you will be an easy prey for flatterers and designing villains.[or]You will be unfortunate in manipulating your affairs to a smooth consistency.[or]For a young woman to think she is an adventuress, portends that she will be too wrapped up in her own conduct to see that she is being flattered into exchanging her favors for disgrace.[cycling]"
"a"	"forest"	"[one of]To dream that you are walking in a forest, signifies trouble.[cycling]"
"a"	"path"	"[one of]To dream that you are walking in a narrow and rough path, stumbling over rocks and other obstructions, denotes that you will have a rough encounter with adversity, and feverish excitement will weigh heavily upon you.[or]To dream that you are trying to find your path, foretells that you will fail to accomplish some work that you have striven to push to desired ends.[or]To walk through a pathway bordered with green grass and flowers, denotes your freedom from oppressing loves.[cycling]"
"a"	"street"	"[one of]To dream that you are walking in a street, foretells ill luck and worries.[or]You will almost despair of reaching the goal you have set up in your aspirations.[or]To be in a familiar street in a distant city, and it appears dark, you will make a journey soon, which will not afford the profit or pleasure contemplated.[or]If the street is brilliantly lighted, you will engage in pleasure, which will quickly pass, leaving no comfort.[or]To pass down a street and feel alarmed lest a thug attack you, denotes that you are venturing upon dangerous ground in advancing your pleasure or business.[cycling]"
"a"	"mask"	"[one of]To dream that you are wearing a mask, denotes temporary trouble, as your conduct towards some dear one will be misinterpreted, and your endeavors to aid that one will be misunderstood, but you will profit by the temporary estrangements.[or]To see others masking, denotes that you will combat falsehood and envy.[or]To see a mask in your dreams, denotes some person will be unfaithful to you, and your affairs will suffer also.[or]For a young woman to dream that she wears a mask, foretells she will endeavor to impose upon some friendly person.[or]If she unmasks, or sees others doing so, she will fail to gain the admiration sought for.[or]She should demean herself modestly after this dream.[cycling]"
"a"	"wet"	"[one of]To dream that you are wet, denotes that a possible pleasure may involve you in loss and disease.[or]You are warned to avoid the blandishments of seemingly well-meaning people.[or]For a young woman to dream that she is soaking wet, portends that she will be disgracefully implicated in some affair with a married man.[cycling]"
"a"	"wreck"	"[one of]To dream that you are witnessing the wreck of some vessel at a short distance from the sea-shore, is an indication that one in whom you reposed great confidence will deceive you.[cycling]"
"a"	"wound"	"[one of]To dream that you are wounded by being stabbed or shot by an enemy foretells losses and poverty; if the wounds are accidental it still denotes losses though your general fortune may not be affected.[cycling]"
"a"	"wound"	"[one of]To dream that you are wounded, signals distress and an unfavorable turn in business.[or]To see others wounded, denotes that injustice will be accorded you by your friends.[or]To relieve or dress a wound, signifies that you will have occasion to congratulate yourself on your good fortune.[cycling]"
"a"	"favor"	"[one of]To dream that you ask favors of anyone, denotes that you will enjoy abundance, and that you will not especially need anything.[or]To grant favors, means a loss.[cycling]"
"a"	"wake"	"[one of]To dream that you attend a wake, denotes that you will sacrifice some important engagement to enjoy some ill-favored assignation.[or]For a young woman to see her lover at a wake, foretells that she will listen to the entreaties of passion, and will be persuaded to hazard honor for love.[cycling]"
"a"	"saviour"	"[one of]To dream that you behold the.[or]Saviour of mankind suffering on the cross, denotes that you will be annoyed by some vile aspersions on your character, but will eventually vindicate yourself successfully, and be honored and respected by all whose opinion you value.[cycling]"
"a"	"bet"	"[one of]To dream that you bet with any one shows that you will suffer from your own imprudence.[cycling]"
"a"	"lament"	"[one of]To dream that you bitterly lament the loss of friends, or property, signifies great struggles and much distress, from which will spring causes for joy and personal gain.[or]To lament the loss of relatives, denotes sickness or disappointments, which will bring you into closer harmony with companions, and will result in brighter prospects for the future.[cycling]"
"a"	"flour"	"[one of]To dream that you buy flour is a bad omen and portends sickness or the death of a near friend.[cycling]"
"an"	"abode"	"[one of]To dream that you can't find your abode, you will completely lose faith in the integrity of others.[or]If you have no abode in your dreams, you will be unfortunate in your affairs, and lose by speculation.[or]To change your abode, signifies hurried tidings and that hasty journeys will be made by you.[or]For a young woman to dream that she has left her abode, is significant of slander and falsehoods being perpetrated against her.[cycling]"
"a"	"burden"	"[one of]To dream that you carry a heavy burden, signifies that you will be tied down by oppressive weights of care and injustice, caused from favoritism shown your enemies by those in power.[or]But to struggle free from it, you will climb to the topmost heights of success.[cycling]"
"a"	"load"	"[one of]To dream that you carry a load, signifies a long existence filled with labors of love and charity.[or]To fall under a load, denotes your inability to attain comforts that are necessary to those looking to you for subsistence.[or]To see others thus engaged, denotes trials for them in which you will be interested.[cycling]"
"an"	"estate"	"[one of]To dream that you come into the ownership of a vast estate, denotes that you will receive a legacy at some distant day, but quite different to your expectations.[or]For a young woman, this dream portends that her inheritance will be of a disappointing nature.[or]She will have to live quite frugally, as her inheritance will be a poor man and a house full of children.[cycling]"
"a"	"homicide"	"[one of]To dream that you commit homicide, foretells that you will suffer great anguish and humiliation through the indifference of others, and your gloomy surroundings will cause perplexing worry to those close to you.[or]To dream that a friend commits suicide, you will have trouble in deciding a very important question.[cycling]"
"a"	"justice"	"[one of]To dream that you demand justice from a person, denotes that you are threatened with embarrassments through the false statements of people who are eager for your downfall.[or]If some one demands the same of you, you will find that your conduct and reputation are being assailed, and it will be extremely doubtful if you refute the charges satisfactorily.[cycling]"
"a"	"bed fellow"	"[one of]To dream that you do not like your bed fellow, foretells that some person who has claims upon you, will censure and make your surroundings unpleasant generally.[or]If you have a strange bed fellow, your discontent will worry all who come near you.[or]If you think you have any kind of animal in bed with you, there will be unbounded ill luck overhanging you.[cycling]"
"an"	"embankment"	"[one of]To dream that you drive along an embankment, foretells you will be threatened with trouble and unhappiness.[or]If you continue your drive without unpleasant incidents arising, you will succeed in turning these forebodings to useful account in your advancement.[or]To ride on horseback along one, denotes you will fearlessly meet and overcome all obstacles in your way to wealth and happiness.[or]To walk along one, you will have a weary struggle for elevation, but will &ally reap a successful reward.[cycling]"
"a"	"dinner"	"[one of]To dream that you eat your dinner alone, denotes that you will often have cause to think seriously of the necessaries of life.[or]For a young woman to dream of taking dinner with her lover, is indicative of a lovers' quarrel or a rupture, unless the affair is one of harmonious pleasure, when the reverse may be expected.[or]To be one of many invited guests at a dinner, denotes that you will enjoy the hospitalities of those who are able to extend to you many pleasant courtesies.[cycling]"
"a"	"fiend"	"[one of]To dream that you encounter a fiend, forbodes reckless living and loose morals.[or]For a woman, this dream signifies a blackened reputation.[or]To dream of a fiend, warns you of attacks to be made on you by false friends.[or]If you overcome one, you will be able to intercept the evil designs of enemies.[cycling]"
"a"	"fight"	"[one of]To dream that you engage in a fight, denotes that you will have unpleasant encounters with your business opponents, and law suits threaten you.[or]To see fighting, denotes that you are squandering your time and money.[or]For women, this dream is a warning against slander and gossip.[or]For a young woman to see her lover fighting, is a sign of his unworthiness.[or]To dream that you are defeated in a fight, signifies that you will lose your right to property.[or]To whip your assailant, denotes that you will, by courage and perseverance, win honor and wealth in spite of opposition.[or]To dream that you see two men fighting with pistols, denotes many worries and perplexities, while no real loss is involved in the dream, yet but small profit is predicted and some unpleasantness is denoted.[or]To dream that you are on your way home and negroes attack you with razors, you will be disappointed in your business, you will be much vexed with servants, and home associations will be unpleasant.[or]To dream that you are fighting negroes, you will be annoyed by them or by some one of low character.[cycling]"
"an"	"envy"	"[one of]To dream that you entertain envy for others, denotes that you will make warm friends by your unselfish deference to the wishes of others.[or]If you dream of being envied by others, it denotes that you will suffer some inconvenience from friends overanxious to please you.[cycling]"
"a"	"dowry"	"[one of]To dream that you fail to receive a dowry, signifies penury and a cold world to depend on for a living.[or]If you receive it, your expectations for the day will be fulfilled.[or]The opposite may be expected if the dream is superinduced by the previous action of the waking mind.[cycling]"
"a"	"heir"	"[one of]To dream that you fall heir to property or valuables, denotes that you are in danger of losing what you already possess and warns you of coming responsibilities.[or]Pleasant surprises may also follow this dream.[cycling]"
"a"	"lamb"	"[one of]To dream that you feed or bring a lamb to the slaughter signifies torment.[or]To dream that you see a lamb, or young kids, signifies extraordinary comfort.[cycling]"
"a"	"jolly"	"[one of]To dream that you feel jolly and are enjoying the merriment of companions, you will realize pleasure from the good behavior of children and have satisfying results in business.[or]If there comes the least rift in the merriment, worry will intermingle with the success of the future.[cycling]"
"a"	"joy"	"[one of]To dream that you feel joy over any event, denotes harmony among friends.[cycling]"
"a"	"melancholy"	"[one of]To dream that you feel melancholy over any event, is a sign of disappointment in what was thought to be favorable undertakings.[or]To dream that you see others melancholy, denotes unpleasant interruption in affairs.[or]To lovers, it brings separation.[cycling]"
"a"	"mortification"	"[one of]To dream that you feel mortified over any deed committed by yourself, is a sign that you will be placed in an unenviable position before those to whom you most wish to appear honorable and just.[or]Financial conditions will fall low.[or]To see mortified flesh, denotes disastrous enterprises and disappointment in love.[cycling]"
"a"	"terror"	"[one of]To dream that you feel terror at any object or happening, denotes that disappointments and loss will envelope you.[or]To see others in terror, means that unhappiness of friends will seriously affect you.[cycling]"
"a"	“acquaintance"	"[one of]To dream that you fight with them signifies distraction, especially if the person so dreaming be sick.[cycling]"
"a"	"forest"	"[one of]To dream that you find yourself in a dense forest, denotes loss in trade, unhappy home influences and quarrels among families.[or]If you are cold and feel hungry, you will be forced to make a long journey to settle some unpleasant affair.[or]To see a forest of stately trees in foliage, denotes prosperity and pleasures.[or]To literary people, this dream foretells fame and much appreciation from the public.[or]A young lady relates the following dream and its fulfilment: ``I was in a strange forest of what appeared to be cocoanut trees, with red and yellow berries growing on them.[or]The ground was covered with blasted leaves, and.[or]I could hear them crackle under my feet as.[or]I wandered about lost.[or]The next afternoon.[or]I received a telegram announcing the death of a dear cousin.''.[cycling]"
"a"	"chrysanthemum"	"[one of]To dream that you gather white chrysanthemums, signifies loss and much perplexity; colored ones, betokens pleasant engagements.[or]To see them in bouquets, denotes that love will be offered you, but a foolish ambition will cause you to put it aside.[or]To pass down an avenue of white chrysanthemums, with here and there a yellow one showing among the white, foretells a strange sense of loss and sadness, from which the sensibilities will expand and take on new powers.[or]While looking on these white flowers as you pass, and you suddenly feel your spirit leave your body and a voice shouts aloud 'Glory to.[or]God, my.[or]Creator,' foretells that a crisis is pending in your near future.[or]If some of your friends pass out, and others take up true ideas in connection with spiritual and earthly needs, you will enjoy life in its deepest meaning.[or]Often death is near you in these dreams.[cycling]"
"a"	"pitch"	"[one of]To dream that you get pitch on your person is a sign that some one has been scandalizing you by telling lies: a girl who dreams this may be sure that her fair fame has been questioned somewhere.[cycling]"
"a"	"mortgage"	"[one of]To dream that you give a mortgage on your property, denotes that you are threatened with financial upheavals, which will throw you into embarrassing positions.[or]To take, or hold one, against others, is ominous of adequate wealth to liquidate your obligations.[or]To find yourself reading or examining mortgages, denotes great possibilities before you of love or gain.[or]To lose a mortgage, if it cannot be found again, implies loss and worry.[cycling]"
"an"	"underground"	"[one of]To dream that you go down under ground whether into a well a deep cellar or vault or a cave denotes your early death; but if you dream that you are digging in the ground and are in a hole which you have dug the omen is different for it denotes riches and long life.[cycling]"
"a"	"journey"	"[one of]To dream that you go on a journey, signifies profit or a disappointment, as the travels are pleasing and successful or as accidents and disagreeable events take active part in your journeying.[or]To see your friends start cheerfully on a journey, signifies delightful change and more harmonious companions than you have heretofore known.[or]If you see them depart looking sad, it may be many moons before you see them again.[or]Power and loss are implied.[or]To make a long-distance journey in a much shorter time than you expected, denotes you will accomplish some work in a surprisingly short time, which will be satisfactory in the way of reimbursement.[cycling]"
"a"	"hate"	"[one of]To dream that you hate a person, denotes that if you are not careful you will do the party an inadvertent injury or a spiteful action will bring business loss and worry.[or]If you are hated for unjust causes, you will find sincere and obliging friends, and your associations will be most pleasant.[or]Otherwise, the dream forebodes ill.[cycling]"
"a"	"bass voice"	"[one of]To dream that you have a bass voice, denotes you will detect some discrepancy in your business, brought about by the deceit of some one in your employ.[or]For the lover, this foretells estrangements and quarrels.[cycling]"
"a"	"complexion"	"[one of]To dream that you have a beautiful complexion is lucky.[or]You will pass through pleasing incidents.[or]To dream that you have bad and dark complexion, denotes disappointment and sickness.[cycling]"
"a"	"guitar"	"[one of]To dream that you have a guitar, or is playing one in a dream, signifies a merry gathering and serious love making.[or]For a young woman to think it is unstrung or broken, foretells that disappointments in love are sure to overtake her.[or]Upon hearing the weird music of a guitar, the dreamer should fortify herself against flattery and soft persuasion, for she is in danger of being tempted by a fascinating evil.[or]If the dreamer be a man, he will be courted, and will be likely to lose his judgment under the wiles of seductive women.[or]If you play on a guitar, your family affairs will be harmonious.[cycling]"
"a"	"master"	"[one of]To dream that you have a master, is a sign of incompetency on your part to command others, and you will do better work under the leadership of some strong-willed person.[or]If you are a master, and command many people under you, you will excel in judgment in the fine points of life, and will hold high positions and possess much wealth.[cycling]"
"a"	"mustache"	"[one of]To dream that you have a mustache, denotes that your egotism and effrontery will cause you a poor inheritance in worldy{sic} goods, and you will betray women to their sorrow.[or]If a woman dreams of admiring a mustache, her virtue is in danger, and she should be mindful of her conduct.[or]If a man dreams that he has his mustache shaved, he will try to turn from evil companions and pleasures, and seek to reinstate himself in former positions of honor.[cycling]"
"a"	"belt"	"[one of]To dream that you have a new style belt, denotes you are soon to meet and make engagements with a stranger, which will demoralize your prosperity.[or]If it is out of date, you will be meritedly censured for rudeness.[cycling]"
"a"	"bull"	"[one of]To dream that you have been gored or received some hurt from a bull shows you are likely to receive some harm from a great man.[or]To dream you are pursued by a bull denotes loss of friends and ill reports; if in love your sweetheart will be in danger and you will narrowly escape some misfortune.[cycling]"
"a"	"breast"	"[one of]To dream that you have hairy breasts and the tap pup covered with hair, denotes great gain and profit to men; but to a woman, loss of her husband.[or]If a young married woman dreams that her breasts are full and spurting out milk, it signifies that she is with child and that it will be a perfect birth.[or]If a virgin dreams thus, she is near her marriage.[or]If a woman dreams she has sore breasts she is threatened with death.[cycling]"
"a"	"hidden"	"[one of]To dream that you have hidden away any object, denotes embarrassment in your circumstances.[or]To find hidden things, you will enjoy unexpected pleasures.[or]For a young woman to dream of hiding objects, she will be the object of much adverse gossip, but will finally prove her conduct orderly.[cycling]"
"a"	"lockjaw"	"[one of]To dream that you have lockjaw, signifies there is trouble ahead for you, as some person is going to betray your confidence.[or]For a woman to see others with lockjaw, foretells her friends will unconsciously detract from her happiness by assigning her unpleasant tasks.[or]If stock have it, you will lose a friend.[cycling]"
"a"	"vow"	"[one of]To dream that you have made a vow and broken it is bad to all.[cycling]"
"a"	"vow"	"[one of]To dream that you have made a vow and broken it, is bad to all.[cycling]"
"an"	"ague"	"[one of]To dream that you have one warns you against an inclination to strong drink; to dream your sweetheart has an ague denotes affection and happiness.[cycling]"
"a"	"patch"	"[one of]To dream that you have patches upon your clothing, denotes that you will show no false pride in the discharge of obligations.[or]To see others wearing patches, denotes want and misery are near.[or]If a young woman discovers a patch on her new dress, it indicates that she will find trouble facing her when she imagines her happiest moments are approaching near.[or]If she tries to hide the patches, she will endeavor to keep some ugly trait in her character from her lover.[or]If she is patching, she will assume duties for which she has no liking.[or]For a woman to do family patching, denotes close and loving bonds in the family, but a scarcity of means is portended.[cycling]"
"a"	"cash"	"[one of]To dream that you have plenty of cash, but that it has been borrowed, portends that you will be looked upon as a worthy man, but that those who come in close contact with you will find that you are mercenary and unfeeling.[or]For a young woman to dream that she is spending borrowed money, foretells that she will be found out in her practice of deceit, and through this lose a prized friend.[cycling]"
"a"	"sold"	"[one of]To dream that you have sold anything, denotes that unfavorable business will worry you.[cycling]"
"an"	"itch"	"[one of]To dream that you have the itch or that your body itches shows that you will shortly receive money.[cycling]"
"a"	"jaundice"	"[one of]To dream that you have the jaundice, denotes prosperity after temporary embarrassments.[or]To see others with jaundice, you will be worried with unpleasant companions and discouraging prospects.[cycling]"
"a"	"tooth-ache"	"[one of]To dream that you have the tooth-ache is a sign of trouble: if you imagine that you are about to have the tooth pulled it foretells that your trouble will end by a piece of good luck; and if you dream that the tooth is out and you have it in your hand you will soon gain a good lump of money.[cycling]"
"a"	"small-pox"	"[one of]To dream that you have this disease foretells health and good fortune: if a lover should be so ungallant as to imagine that his sweetheart is thus afflicted it is a sign that he will marry a great beauty; if she happens to be a beauty it will be all right of course; if not he will look out for number two.[cycling]"
"a"	"vertigo"	"[one of]To dream that you have vertigo, foretells you will have loss in domestic happiness, and your affairs will be under gloomy outlooks.[cycling]"
"a"	"buzzard"	"[one of]To dream that you hear a buzzard talking, foretells that some old scandal will arise and work you injury by your connection with it.[or]To see one sitting on a railroad, denotes some accident or loss is about to descend upon you.[or]To see them fly away as you approach, foretells that you will be able to smooth over some scandalous disagreement among your friends, or even appertaining to yourself.[or]To see buzzards in a dream, portends generally salacious gossip or that unusual scandal will disturb you.[cycling]"
"a"	"hen"	"[one of]To dream that you hear hens cackle, or that you catch them, signifies joy, profit and assurance of the dispatch of business.[or]To dream that you are turned into a hen, signifies disquiet.[or]To dream that you see a hen lay eggs, signifies gain.[or]To see a hen with her chickens, signifies loss or damage.[or]To dream that a hen crows, signifies sadness and trouble.[cycling]"
"a"	"screech-owl"	"[one of]To dream that you hear the shrill startling notes of the screech-owl, denotes that you will be shocked with news of the desperate illness, or death of some dear friend.[cycling]"
"a"	"horn"	"[one of]To dream that you hear the sound of a horn, foretells hasty news of a joyful character.[or]To see a broken horn, denotes death or accident.[or]To see children playing with horns, denotes congeniality in the home.[or]For a woman to dream of blowing a horn, foretells that she is more anxious for marriage than her lover.[cycling]"
"a"	"mansion"	"[one of]To dream that you inhabit a mansion, is not good; expect some calamity happening either to yourself, or some relative, or lover.[cycling]"
"an"	"invite"	"[one of]To dream that you invite persons to visit you, denotes that some unpleasant event is near, and will cause worry and excitement in your otherwise pleasant surroundings.[or]If you are invited to make a visit, you will receive sad news.[or]For a woman to dream that she is invited to attend a party, she will have pleasant anticipations, but ill luck will mar them.[cycling]"
"an"	"infirmary"	"[one of]To dream that you leave an infirmary, denotes your escape from wily enemies who will cause you much worry.[cycling]"
"a"	"limp"	"[one of]To dream that you limp in your walk, denotes that a small worry will unexpectedly confront you, detracting much from your enjoyment.[or]To see others limping, signifies that you will be naturally offended at the conduct of a friend.[or]Small failures attend this dream.[or]Cripple and.[cycling]"
"an"	"occultist"	"[one of]To dream that you listen to the teachings of an occultist, denotes that you will strive to elevate others to a higher plane of justice and forbearance.[or]If you accept his views, you will find honest delight by keeping your mind and person above material frivolities and pleasures.[cycling]"
"a"	"hutt"	"[one of]To dream that you live in a small hut is a sign that you will shortly have a house of your own.[or]If in your dream you visit a little hut which is inhabited it shows that you will be invited to partake of the hospitalities of some family.[cycling]"
"a"	"splendor"	"[one of]To dream that you live in splendor, denotes that you will succeed to elevations, and will reside in a different state to the one you now occupy.[or]To see others thus living, signifies pleasure derived from the interest that friends take in your welfare.[cycling]"
"a"	"harem"	"[one of]To dream that you maintain a harem, denotes that you are wasting your best energies on low pleasures.[or]Life holds fair promises, if your desires are rightly directed.[or]If a woman dreams that she is an inmate of a harem, she will seek pleasure where pleasure is unlawful, as her desires will be toward married men as a rule.[or]If she dreams that she is a favorite of a harem, she will be preferred before others in material pleasures, but the distinction will be fleeting.[cycling]"
"a"	"memorandum"	"[one of]To dream that you make memoranda, denotes that you will engage in an unprofitable business, and much worry will result for you.[or]To see others making a memorandum, signifies that some person will worry you with appeals for aid.[or]To lose your memorandum, you will experience a slight loss in trade.[or]To find a memorandum, you will assume new duties that will cause much pleasure to others.[cycling]"
"a"	"mad dog"	"[one of]To dream that you meet a mad dog denotes that you will be fortunate in any undertaking in which you are engaged, and that success will crown your efforts.[cycling]"
"an"	"adversary"	"[one of]To dream that you meet or engage with an adversary, denotes that you will promptly defend any attacks on your interest.[or]Sickness may also threaten you after this dream.[or]If you overcome an adversary, you will escape the effect of some serious disaster.[cycling]"
"an"	"enemy"	"[one of]To dream that you overcome enemies, denotes that you will surmount all difficulties in business, and enjoy the greatest prosperity.[or]If you are defamed by your enemies, it denotes that you will be threatened with failures in your work.[or]You will be wise to use the utmost caution in proceeding in affairs of any moment.[or]To overcome your enemies in any form, signifies your gain.[or]For them to get the better of you is ominous of adverse fortunes.[or]This dream may be literal.[cycling]"
"a"	"property"	"[one of]To dream that you own vast property, denotes that you will be successful in affairs, and gain friendships.[cycling]"
"a"	"flageolet"	"[one of]To dream that you play or hear playing on a flageolet, denotes trouble and contention, and being overthrown at law.[cycling]"
"a"	"halter"	"[one of]To dream that you put a halter on a young horse, shows that you will manage a very prosperous and clean business.[or]Love matters will shape themselves to suit you.[or]To see other things haltered, denotes that fortune will be withheld from you for a while.[or]You will win it, but with much toil.[cycling]"
"a"	"dun"	"[one of]To dream that you receive a dun, warns you to look after your affairs and correct all tendency towards neglect of business and love.[cycling]"
"a"	"telegram"	"[one of]To dream that you receive a telegram, denotes that you will soon receive tidings of an unpleasant character.[or]Some friend is likely to misrepresent matters which are of much concern to you.[or]To send a telegram is a sign that you will be estranged from some one holding a place near you, or business will disappoint you.[or]If you are the operator sending these messages, you will be affected by them only through the interest of others.[or]To see or be in a telegraph office, foretells unfortunate engagements.[cycling]"
"a"	"welcome"	"[one of]To dream that you receive a warm welcome into any society, foretells that you will become distinguished among your acquaintances and will have deference shown you by strangers.[or]Your fortune will approximate anticipation.[or]To accord others welcome, denotes your congeniality and warm nature will be your passport into pleasures, or any other desired place.[cycling]"
"an"	"inheritance"	"[one of]To dream that you receive an inheritance, foretells that you will be successful in easily obtaining your desires.[cycling]"
"a"	"gift"	"[one of]To dream that you receive gifts from any one, denotes that you will not be behind in your payments, and be unusually fortunate in speculations or love matters.[or]To send a gift, signifies displeasure will be shown you, and ill luck will surround your efforts.[or]For a young woman to dream that her lover sends her rich and beautiful gifts, denotes that she will make a wealthy and congenial marriage.[cycling]"
"an"	"adversary"	"[one of]To dream that you receive obstruction from him, shows that you will dispatch your business speedily.[cycling]"
"an"	"obedience"	"[one of]To dream that you render obedience to another, foretells for you a common place, a pleasant but uneventful period of life.[or]If others are obedient to you, it shows that you will command fortune and high esteem.[cycling]"
"a"	"rent"	"[one of]To dream that you rent a house, is a sign that you will enter into new contracts, which will prove profitable.[or]To fail to rent out property, denotes that there will be much inactivity in business.[or]To pay rent, signifies that your financial interest will be satisfactory.[or]If you can't pay your rent, it is unlucky for you, as you will see a falling off in trade, and social pleasures will be of little benefit.[cycling]"
"a"	"resign"	"[one of]To dream that you resign any position, signifies that you will unfortunately embark in new enterprises.[or]To hear of others resigning, denotes that you will have unpleaasant{sic} tidings.[cycling]"
"a"	"patent medicine"	"[one of]To dream that you resort to patent medicine in your search for health, denotes that you will use desperate measures in advancing your fortune, but you will succeed, to the disappointment of the envious.[or]To see or manufacture patent medicines, you will rise from obscurity to positions above your highest imaginings.[cycling]"
"a"	"landau"	"[one of]To dream that you ride in a landau, with your friend or sweetheart, denotes that incidents of a light, but pleasant character will pass in rapid succession through your life.[or]If the vehicle is overturned, then pleasure will abruptly turn into woe.[or]Fields ant.[cycling]"
"an"	"automobile"	"[one of]To dream that you ride in an automobile, denotes that you will be restless under pleasant conditions, and will make a change in your affairs.[or]There is grave danger of impolitic conduct intimated through a dream of this nature.[or]If one breaks down with you, the enjoyment of a pleasure will not extend to the heights you contemplate.[or]To find yourself escaping from the path of one, signifies that you will do well to avoid some rival as much as you can honestly allow.[or]For a young woman to look for one, she will be disappointed in her aims to entice some one into her favor.[cycling]"
"a"	"scratch head"	"[one of]To dream that you scratch your head, denotes strangers will annoy you by their flattering attentions, which you will feel are only shown to win favors from you.[cycling]"
"a"	"fountain"	"[one of]To dream that you see a clear fountain sparkling in the sunlight, denotes vast possessions, ecstatic delights and many pleasant journeys.[or]A clouded fountain, denotes the insincerity of associates and unhappy engagements and love affairs.[or]A dry and broken fountain, indicates death and cessation of pleasures.[or]For a young woman to see a sparkling fountain in the moonlight, signifies ill-advised pleasure which may result in a desertion.[cycling]"
"a"	"clock"	"[one of]To dream that you see a clock, denotes danger from a foe.[or]To hear one strike, you will receive unpleasant news.[or]The death of some friend is implied.[cycling]"
"a"	"cavalry"	"[one of]To dream that you see a division of cavalry, denotes personal advancement and distinction.[or]Some little sensation may accompany your elevation.[cycling]"
"a"	"file"	"[one of]To dream that you see a file, signifies that you will transact some business which will prove unsatisfactory in the extreme.[or]To see files, to store away bills and other important papers, foretells animated discussions over subjects which bear relation to significant affairs, and which will cause you much unrest and disquiet.[or]Unfavorable predictions for the future are also implied in this dream.[cycling]"
"a"	"mason"	"[one of]To dream that you see a mason plying his trade, denotes a rise in your circumstances and a more congenial social atmosphere will surround you.[or]If you dream of seeing a band of the order of masons in full regalia, it denotes that you will have others beside yourself to protect and keep from the evils of life.[cycling]"
"a"	"monkey"	"[one of]To dream that you see a monkey and are pleased with his antics shows that you will make the acquaintance of a fool.[or]For a girl to dream of playing with a monkey is a sign she will do something she is ashamed of and perhaps lose her virtue.[or]Monkeys are also a sign of law suits and secret enemies.[cycling]"
"a"	"murder"	"[one of]To dream that you see a murder committed, indicates that you will shortly have the pleasure of welcoming one whom you had not expected to see again in this world.[cycling]"
"a"	"grave"	"[one of]To dream that you see a newly made grave, you will have to suffer for the wrongdoings of others.[or]If you visit a newly made grave, dangers of a serious nature is hanging over you.[or]Grave is an unfortunate dream.[or]Ill luck in business transactions will follow, also sickness is threatened.[or]To dream of walking on graves, predicts an early death or an unfortunate marriage.[or]If you look into an empty grave, it denotes disappointment and loss of friends.[or]If you see a person in a grave with the earth covering him, except the head, some distressing situation will take hold of that person and loss of property is indicated to the dreamer.[or]To see your own grave, foretells that enemies are warily seeking to engulf you in disaster, and if you fail to be watchful they will succeed.[or]To dream of digging a grave, denotes some uneasiness over some undertaking, as enemies will seek to thwart you, but if you finish the grave you will overcome opposition.[or]If the sun is shining, good will come out of seeming embarrassments.[or]If you return for a corpse, to bury it, and it has disappeared, trouble will come to you from obscure quarters.[or]For a woman to dream that night overtakes her in a graveyard, and she can find no place to sleep but in an open grave, foreshows she will have much sorrow and disappointment through death or false friends.[or]She may lose in love, and many things seek to work her harm.[or]To see a graveyard barren, except on top of the graves, signifies much sorrow and despondency for a time, but greater benefits and pleasure await you if you properly shoulder your burden.[or]To see your own corpse in a grave, foreshadows hopeless and despairing oppression.[cycling]"
"a"	"pall"	"[one of]To dream that you see a pall, denotes that you will have sorrow and misfortune.[or]If you raise the pall from a corpse, you will doubtless soon mourn the death of one whom you love.[cycling]"
"a"	"letter"	"[one of]To dream that you see a registered letter, foretells that some money matters will disrupt long-established relations.[or]For a young woman to dream that she receives such a letter, intimates that she will be offered a competency, but it will not be on strictly legal, or moral grounds; others may play towards her a dishonorable part.[or]To the lover, this bears heavy presentments of disagreeable mating.[or]His sweetheart will covet other gifts than his own.[or]To dream of an anonymous letter, denotes that you will receive injury from an unsuspected source.[or]To write one, foretells that you will be jealous of a rival, whom you admit to be your superior.[or]To dream of getting letters bearing unpleasant news, denotes difficulties or illness.[or]If the news is of a joyous character, you will have many things to be thankful for.[or]If the letter is affectionate, but is written on green, or colored, paper, you will be slighted in love and business.[or]Despondency will envelop you.[or]Blue ink, denotes constancy and affection, also bright fortune.[or]Red colors in a letter, imply estrangements through suspicion and jealousy, but this may be overcome by wise maneuvering of the suspected party.[or]If a young woman dreams that she receives a letter from her lover and places it near her heart, she will be worried very much by a good-looking rival.[or]Truthfulness is often rewarded with jealousy.[or]If you fail to read the letter, you will lose something either in a business or social way.[or]Letters nearly always bring worry.[or]To have your letter intercepted, rival enemies are working to defame you.[or]To dream of trying to conceal a letter from your sweetheart or wife, intimates that you are interested in unworthy occupations.[or]To dream of a letter with a black border, signifies distress and the death of some relative.[or]To receive a letter written on black paper with white ink, denotes that gloom and disappointment will assail you, and friendly interposition will render small relief.[or]If the letter passes between husband and wife, it means separation under sensational charges.[or]If lovers, look for quarrels and threats of suicide.[or]To business people, it denotes enviousness and covetousness.[or]To dream that you write a letter, denotes that you will be hasty in condemning some one on suspicion, and regrets will follow.[or]A torn letter, indicates that hopeless mistakes may ruin your reputation.[or]To receive a letter by hand, denotes that you are acting ungenerously towards your companions or sweetheart, and you also are not upright in your dealings.[or]To dream often of receiving a letter from a friend, foretells his arrival, or you will hear from him by letter or otherwise.[cycling]"
"a"	"spider"	"[one of]To dream that you see a spider coming toward you is a sign that some one will soon pay you money: if you imagine that the spider spins down before your face the omen is similar for you will make a good lot of money in some way.[or]If a married woman dreams of seeing a large spider it foretells that she will have a miscarriage which she will not be sorry for.[cycling]"
"a"	"spirit"	"[one of]To dream that you see a spirit before you of a comely aspect, and attired in white, denotes joy and consolation; but if it be deformed and black, it signifies deceit and temptation to sin.[cycling]"
"a"	"wreath"	"[one of]To dream that you see a wreath of fresh flowers, denotes that great opportunities for enriching yourself will soon present themselves before you.[or]A withered wreath bears sickness and wounded love.[or]To see a bridal wreath, foretells a happy ending to uncertain engagements.[cycling]"
"an"	"earwig"	"[one of]To dream that you see an earwig or have one in your ear, denotes that you will have unpleasant news affecting your business or family relations.[cycling]"
"a"	"handwriting"	"[one of]To dream that you see and recognize your own handwriting, foretells that malicious enemies will use your expressed opinion to foil you in advancing to some competed position.[cycling]"
"a"	"mill-dam"	"[one of]To dream that you see clear water pouring over a mill-dam, foretells pleasant enterprises, either of a business or social nature.[or]If the water is muddy or impure, you will meet with losses, and troubles will arise where pleasure was anticipated.[or]If the dam is dry, your business will assume shrunken proportions.[cycling]"
"a"	"fish"	"[one of]To dream that you see fish in clear-water streams, denotes that you will be favored by the rich and powerful.[or]Dead fish, signifies the loss of wealth and power through some dire calamity.[or]For a young woman to dream of seeing fish, portends that she will have a handsome and talented lover.[or]To dream of catching a catfish, denotes that you will be embarrassed by evil designs of enemies, but your luck and presence of mind will tide you safely over the trouble.[or]To wade in water, catching fish, denotes that you will possess wealth acquired by your own ability and enterprise.[or]To dream of fishing, denotes energy and economy; but if you do not succeed in catching any, your efforts to obtain honors and wealth will be futile.[or]Eating fish, denotes warm and lasting attachments.[cycling]"
"a"	"glass-blower"	"[one of]To dream that you see glass-blowers at their work, denotes you will contemplate change in your business, which will appear for the better, but you will make it at a loss to yourself.[cycling]"
"a"	"honey"	"[one of]To dream that you see honey, you will be possessed of considerable wealth.[or]To see strained honey, denotes wealth and ease, but there will be an undercurrent in your life of unlawful gratification of material desires.[or]To dream of eating honey, foretells that you will attain wealth and love.[or]To lovers, this indicates a swift rush into marital joys.[cycling]"
"an"	"air"	"[one of]To dream that you see it clear and serene shows that you shall be beloved and esteemed by most people; if at law success.[or]In short all good is denoted by clear and serene air.[or]But to dream that the air is thick cloudy dark and troubled denotes to the dreamer grief sickness loss of good hindrance ofbusiness and crosses in love.[cycling]"
"a"	"lazy"	"[one of]To dream that you see lazy people lounging around and that you are vexed with them is a sign of bad luck to some of your relatives who will depend upon you to assist them: if in your dream you imagine yourself to be lazy and sleepy over your work it foretells either sickness or that you will meet with a loss.[cycling]"
"a"	"panther"	"[one of]To dream that you see one of these animals and are terrified by it shows that you will be disgusted at the ingratitude of a friend you have served: if in your dream you see a tame panther and caress it it foretells that you have some ungrateful person in your household or else a false-hearted friend.[cycling]"
"a"	"hammer"	"[one of]To dream that you see or hear hammering denotes thrift to some one of your friends; if you are using the hammer yourself it shows that you will be fortunate.[or]A hammer is a good article to dream about.[cycling]"
"a"	"macadamize"	"[one of]To dream that you see or travel on a macadamized road, is significant of pleasant journeys, from which you will derive much benefit.[or]For young people, this dream foretells noble aspirations.[cycling]"
"a"	"passenger"	"[one of]To dream that you see passengers coming in with their luggage, denotes improvement in your surroundings.[or]If they are leaving you will lose an opportunity of gaining some desired property.[or]If you are one of the passengers leaving home, you will be dissatisfied with your present living and will seek to change it.[cycling]"
"a"	"seal"	"[one of]To dream that you see seals, denotes that you are striving for a place above your power to maintain.[or]Dreams of seals usually show that the dreamer has high aspirations and discontent will harass him into struggles to advance his position.[cycling]"
"an"	"inkt"	"[one of]To dream that you see splashes of ink on white paper or on anything is a sign of scandal: after such a dream you may be sure that somebody will be talking pretty hard about you: the larger the splashes the bigger will be the stories that are told.[cycling]"
"a"	"chairman"	"[one of]To dream that you see the chairman of any public body, foretells you will seek elevation and be recompensed by receiving a high position of trust.[or]To see one looking out of humor you are threatened with unsatisfactory states.[or]If you are a chairman, you will be distinguished for your justice and kindness to others.[cycling]"
"a"	"meat"	"[one of]To dream that you see the meat you have eaten, signifies loss and damage.[cycling]"
"a"	"neck"	"[one of]To dream that you see your own neck, foretells that vexatious family relations will interfere with your business.[or]To admire the neck of another, signifies your worldly mindedness will cause broken domestic ties.[or]For a woman to dream that her neck is thick, foretells that she will become querulous and something of a shrew if she fails to control her temper.[cycling]"
"a"	"hyacinth"	"[one of]To dream that you see, or gather, hyacinths, you are about to undergo a painful separation from a friend, which will ultimately result in good for you.[cycling]"
"a"	"clergyman"	"[one of]To dream that you send for a clergyman to preach a funeral sermon, denotes that you will vainly strive against sickness and to ward off evil influences, but they will prevail in spite of your earnest endeavors.[or]If a young woman marries a clergyman in her dream, she will be the object of much mental distress, and the wayward hand of fortune will lead her into the morass of adversity.[cycling]"
"an"	"apprentice"	"[one of]To dream that you serve as an apprentice, foretells you will have a struggle to win a place among your companions.[cycling]"
"a"	"sneeze"	"[one of]To dream that you sneeze, denotes that hasty tidings will cause you to change your plans.[or]To see or hear others sneeze, some people will bore you with visits.[cycling]"
"a"	"keyhole"	"[one of]To dream that you spy upon others through a keyhole, you will damage some person by disclosing confidence.[or]If you catch others peeping through a keyhole, you will have false friends delving into your private matters to advance themselves over you.[or]To dream that you cannot find the keyhole, you will unconsciously injure a friend.[cycling]"
"a"	"stammer"	"[one of]To dream that you stammer in your conversation, denotes that worry and illness will threaten your enjoyment.[or]To hear others stammer, foretells that unfriendly persons will delight in annoying you and giving you needless worry.[cycling]"
"a"	"surprise"	"[one of]To dream that you surprise any one, denotes good luck to the dreamer and great success in trade.[cycling]"
"a"	"fall"	"[one of]To dream that you sustain a fall, and are much frightened, denotes that you will undergo some great struggle, but will eventually rise to honor and wealth; but if you are injured in the fall, you will encounter hardships and loss of friends.[cycling]"
"a"	"laudanum"	"[one of]To dream that you take laudanum, signifies weakness of your own; and that you will have a tendency to be unduly influenced by others.[or]You should cultivate determination.[or]To prevent others from taking this drug, indicates that you will be the means of conveying great joy and good to people.[or]To see your lover taking laudanum through disappointment, signifies unhappy affairs and the loss of a friend.[or]To give it, slight ailments will attack some member of your domestic circle.[cycling]"
"a"	"pill"	"[one of]To dream that you take pills, denotes that you will have responsibilities to look after, but they will bring you no little comfort and enjoyment.[or]To give them to others, signifies that you will be criticised for your disagreeableness.[cycling]"
"a"	"thatch"	"[one of]To dream that you thatch a roof with any quickly, perishable material, denotes that sorrow and discomfort will surround you.[or]If you find that a roof which you have thatched with straw is leaking, there will be threatenings of danger, but by your rightly directed energy they may be averted.[cycling]"
"a"	"tumble"	"[one of]To dream that you tumble off of any thing, denotes that you are given to carelessness, and should strive to be prompt with your affairs.[or]To see others tumbliing,{sic} is a sign that you will profit by the negligence of others.[cycling]"
"a"	"saw"	"[one of]To dream that you use a hand-saw, indicates an energetic and busy time, and cheerful home life.[or]To see big saws in machinery, foretells that you will superintend a big enterprise, and the same will yield fair returns.[or]For a woman, this dream denotes that she will be esteemed, and her counsels will be heeded.[or]To dream of rusty or broken saws, denotes failure and accidents.[or]To lose a saw, you will engage in affairs which will culminate in disaster.[or]To hear the buzz of a saw, indicates thrift and prosperity.[or]To find a rusty saw, denotes that you will probably restore your fortune.[or]To carry a saw on your back, foretells that you will carry large, but profitable, responsibilities.[cycling]"
"a"	"plane"	"[one of]To dream that you use a plane, denotes that your liberality and successful efforts will be highly commended.[or]To see carpenters using their planes, denotes that you will progress smoothly in your undertakings.[or]To dream of seeing planes, denotes congeniality and even success.[or]A love of the real, and not the false, is portended by this dream.[cycling]"
"a"	"morgue"	"[one of]To dream that you visit a morgue searching for some one, denotes that you will be shocked by news of the death of a relative or friend.[or]To see many corpses there, much sorrow and trouble will come under your notice.[cycling]"
"a"	"pauper"	"[one of]To dream that you visit the poor-house and see the inmates is a sign to a woman that she will bear many children and to a man that he will raise a large family such a dream to a young girl foretells that she will be apt to become a mother before she is a wife.[cycling]"
"a"	"mud"	"[one of]To dream that you walk in mud, denotes that you will have cause to lose confidence in friendships, and there will be losses and disturbances in family circles.[or]To see others walking in mud, ugly rumors will reach you of some friend or employee.[or]To the farmer, this dream is significant of short crops and unsatisfactory gains from stock.[or]To see mud on your clothing, your reputation is being assailed.[or]To scrape it off, signifies that you will escape the calumny of enemies.[cycling]"
"a"	"labor"	"[one of]To dream that you watch domestic animals laboring under heavy burdens, denotes that you will be prosperous, but unjust to your servants, or those employed by you.[or]To see men toiling, signifies profitable work, and robust health.[or]To labor yourself, denotes favorable outlook for any new enterprise, and bountiful crops if the dreamer is interested in farming.[cycling]"
"a"	"sword"	"[one of]To dream that you wear a sword, indicates that you will fill some public position with honor.[or]To have your sword taken from you, denotes your vanquishment in rivalry.[or]To see others bearing swords, foretells that altercations will be attended with danger.[or]A broken sword, foretells despair.[cycling]"
"a"	"talisman"	"[one of]To dream that you wear a talisman, implies you will have pleasant companions and enjoy favors from the rich.[or]For a young woman to dream her lover gives her one, denotes she will obtain her wishes concerning marriage.[cycling]"
"a"	"veil"	"[one of]To dream that you wear a veil, denotes that you will not be perfectly sincere with your lover, and you will be forced to use stratagem to retain him.[or]To see others wearing veils, you will be maligned and defamed by apparent friends.[or]An old, or torn veil, warns you that deceit is being thrown around you with sinister design.[or]For a young woman to dream that she loses her veil, denotes that her lover sees through her deceitful ways and is likely to retaliate with the same.[or]To dream of seeing a bridal veil, foretells that you will make a successful change in the immediate future, and much happiness in your position.[or]For a young woman to dream that she wears a bridal veil, denotes that she will engage in some affair which will afford her lasting profit and enjoyment.[or]If it gets loose, or any accident befalls it, she will be burdened with sadness and pain.[or]To throw a veil aside, indicates separation or disgrace.[or]To see mourning veils in your dreams, signifies distress and trouble, and embarrassment in business.[cycling]"
"an"	"ermine"	"[one of]To dream that you wear this beautiful and costly raiment, denotes exaltation, lofty character and wealth forming a barrier to want and misery.[or]To see others thus clothed, you will be associated with wealthy people, polished in literature and art.[or]For a lover to see his sweetheart clothed in ermine, is an omen of purity and faithfulness.[or]If the ermine is soiled, the reverse is indicated.[cycling]"
"a"	"work"	"[one of]To dream that you were working hard and are very tired is a sign of sickness: if you imagine that you see men at work it foretells a successful business.[cycling]"
"a"	"victory"	"[one of]To dream that you win a victory, foretells that you will successfully resist the attacks of enemies, and will have the love of women for the asking.[cycling]"
"a"	"poor"	"[one of]To dream that you, or any of your friends, appear to be poor, is significant of worry and losses.[cycling]"
"an"	"ambush"	"[one of]To dream that your are atacked{sic} from ambush, denotes that you have lurking secretly near you a danger, which will soon set upon and overthrow you if you are heedless of warnings.[or]If you lie in ambush to revenge yourself on others, you will unhesitatingly stoop to debasing actions to defraud your friends.[cycling]"
"a"	"back"	"[one of]To dream that your back is broken hurt or scabby shows that your enemies will get the better of you.[or]To dream of the backbone signifies health and much joy.[or]To see your back denotes misfortune.[cycling]"
"a"	"croup"	"[one of]To dream that your child has the croup, denotes slight illness, but useless fear for its safety.[or]This is generally a good omen of health and domestic harmony.[cycling]"
"an"	"apparel"	"[one of]To dream that your clothes are good denotes prosperity and happiness; of white apparel is good only for clergymen; to others it is a sign of trouble; to mechanics decline of business; to the sick death.[or]If of black however it is of their recovery; of rich scarlet apparel is good for rich men signifying honor; but is death to the sick and loss or captivity to the poor; to dream of women’s apparel is good for the unmarried; but to a married man loss of his wife or sickness.[cycling]"
"a"	"conscience"	"[one of]To dream that your conscience censures you for deceiving some one, denotes that you will be tempted to commit wrong and should be constantly on your guard.[or]To dream of having a quiet conscience, denotes that you will stand in high repute.[cycling]"
"a"	"face"	"[one of]To dream that your face is swelled indicates an augmentation of wealth and honor; but if it grows pale or emaciated you will be severely disappointed.[or]Of a fresh smiling face friendship and joy; black face long life; washing repentance.[cycling]"
"a"	"husband"	"[one of]To dream that your husband is leaving you, and you do not understand why, there will be bitterness between you, but an unexpected reconciliation will ensue.[or]If he mistreats and upbraids you for unfaithfulness, you will hold his regard and confidence, but other worries will ensue and you are warned to be more discreet in receiving attention from men.[or]If you see him dead, disappointment and sorrow will envelop you.[or]To see him pale and careworn, sickness will tax you heavily, as some of the family will linger in bed for a time.[or]To see him gay and handsome, your home will be filled with happiness and bright prospects will be yours.[or]If he is sick, you will be mistreated by him and he will be unfaithful.[or]To dream that he is in love with another woman, he will soon tire of his present surroundings and seek pleasure elsewhere.[or]To be in love with another woman's husband in your dreams, denotes that you are not happily married, or that you are not happy unmarried, but the chances for happiness are doubtful.[or]For an unmarried woman to dream that she has a husband, denotes that she is wanting in the graces which men most admire.[or]To see your husband depart from you, and as he recedes from you he grows larger, inharmonious surroundings will prevent immediate congeniality.[or]If disagreeable conclusions are avoided, harmony will be reinstated.[or]For a woman to dream she sees her husband in a compromising position with an unsuspected party, denotes she will have trouble through the indiscretion of friends.[or]If she dreams that he is killed while with another woman, and a scandal ensues, she will be in danger of separating from her husband or losing property.[or]Unfavorable conditions follow this dream, though the evil is often exaggerated.[cycling]"
"a"	"knee"	"[one of]To dream that your knees are too large, denotes sudden ill luck for you.[or]If they are stiff and pain you, swift and fearful calamity awaits you.[or]For a woman to dream that she has well-formed and smooth knees, predicts she will have many admirers, but none to woo her in wedlock.[or]If they are soiled, sickness from dissipation is portended.[or]If they are unshapely, unhappy changes in her fortune will displace ardent hopes.[or]To dream of knees is an unfortunate omen.[cycling]"
"a"	"partner"	"[one of]To dream that your partner in a dance slights or snubs you is a sign that some one is enamored of you: this applies to either sex: if you dream of a particularly agreeable and attractive partner it shows that you will quarrel with somebody of the opposite sex: for a man in business to dream of taking a partner foretells that he will be robbed.[cycling]"
"a"	"privacy"	"[one of]To dream that your privacy suffers intrusion, foretells you will have overbearing people to worry you.[or]For a woman, this dream warns her to look carefully after private affairs.[or]If she intrudes on the privacy of her husband or lover, she will disabuse some one's confidence, if not careful of her conversation.[cycling]"
"a"	"shirt"	"[one of]To dream that your shirt is ragged and without buttons is a sign of poverty: if you imagine that you have a new shirt with a stylish bosom it foretells some disagreeable adventure in which your self-esteem will be keenly wounded such as being placed in a ridiculous position before ladies or before company in public.[cycling]"
"a"	"hair"	"[one of]To dream that your sweetheart has red hair, you will be denounced by the woman you love for unfaithfulness.[or]Red hair usually suggests changes.[or]If you see brown hair, you will be unfortunate in choosing a career.[or]If you see well kept and neatly combed hair, your fortune will improve.[or]To dream you cut your hair close to the scalp, denotes that you will be generous to lavishness towards a friend.[or]Frugality will be the fruits growing out therefrom.[or]To see the hair growing out soft and luxuriant, signifies happiness and luxury.[or]For a woman to compare a white hair with a black one, which she takes from her head, foretells that she will be likely to hesitate between two offers of seeming fortune, and unless she uses great care, will choose the one that will afford her loss or distress instead of pleasant fortune.[or]To see tangled and unkempt hair, life will be a veritable burden, business will fall off, and the marriage yoke will be troublesome to carry.[or]If a woman is unsuccessful in combing her hair, she will lose a worthy man's name by needless show of temper and disdain.[or]For a young woman to dream of women with gray hair, denotes that they will come into her life as rivals in the affection of a male relative, or displace the love of her affianced.[or]To dream of having your hair cut, denotes serious disappointments.[or]For a woman to dream that her hair is falling out, and baldness is apparent, she will have to earn her own livelihood, as fortune has passed her by.[or]For man or woman to dream that they have hair of snowy whiteness, denotes that they will enjoy a pleasing and fortunate journey through life.[or]For a man to caress the hair of a woman, shows he will enjoy the love and confidence of some worthy woman who will trust him despite the world's condemnation.[or]To see flowers in your hair, foretells troubles approaching which, when they come, will give you less fear than when viewed from a distance.[or]For a woman to dream that her hair turns to white flowers, augurs that troubles of a various nature will confront her, and she does well if she strengthens her soul with patience, and endeavors to bear her trials with fortitude.[or]To dream that a lock of your hair turns gray and falls out, is a sign of trouble and disappointment in your affairs.[or]Sickness will cast gloom over bright expectations.[or]To see one's hair turn perfectly white in one night, and the face seemingly young, foretells sudden calamity and deep grief.[or]For a young woman to have this dream, signifies that she will lose her lover by a sudden sickness or accident.[or]She will likely come to grief from some indiscretion on her part.[or]She should be careful of her associates.[cycling]"
"a"	"sweetheart"	"[one of]To dream that your sweetheart is affable and of pleasing physique, foretells that you will woo a woman who will prove a joy to your pride and will bring you a good inheritance.[or]If she appears otherwise, you will be discontented with your choice before the marriage vows are consummated.[or]To dream of her as being sick or in distress, denotes that sadness will be intermixed with joy.[or]If you dream that your sweetheart is a corpse, you will have a long period of doubt and unfavorable fortune.[or]Hugging, and.[cycling]"
"a"	"wrist"	"[one of]To dream that your wrists are broken, is very good.[or]It foretells that you will marry your present lover and be very happy.[cycling]"
"a"	"freemason"	"[one of]To dream you are a free mason denotes you will soon make a number of new friends who will treat you on the square it also foretells you will take a journey to the east.[or]If you are already a member of that celebrated.[or]Order and dream you attend a meeting of the lodge it portends sickness and a heavy loss of property to dream you are expelled from the.[or]Order shows you will attain a higher station in life.[cycling]"
"a"	"linen"	"[one of]To dream you are arrayed in clean linen denotes that you will shortly receive some glad tidings; and that your sweetheart is faithful; if it is dirty then it denotes poverty and disappointment in love.[or]White linen if dressed in it presages death; colored linen removal; shifts a gay sweetheart; gowns a gift.[cycling]"
"a"	"bath"	"[one of]To dream you are at a bath where you see people bathing is a sign you will have good luck in some undertaking.[or]If you are in bathing yourself it predicts that you will confer a benefit on some person who will be very grateful.[or]This dream also foretells a change of residence.[cycling]"
"a"	"fair"	"[one of]To dream you are at a fair is a bad omen; it denotes that some pretended friend is about to do you an injury; if you are in trade keep a keen look out for some swindler will certainly attempt to defraud you.[cycling]"
"a"	"fountain"	"[one of]To dream you are at a fountain is a favorable omen; if the water is clear it denotes riches and honors; and in love it foretells happiness in marriage; but if muddy it denotes vexation and trouble.[cycling]"
"an"	"altar"	"[one of]To dream you are at the altar and receiving the holy sacrament is a very unfavorable omen, and denotes many heavy and severe afflictions.[cycling]"
"a"	"wool"	"[one of]To dream you are buying or selling wool, denotes prosperity and great affluence, by means or industry and trade.[or]To the lover, it is a favorable omen.[or]Your sweetheart is thereby shown to be of an amiable disposition, very constant and deeply in love with you.[cycling]"
"a"	"pirate"	"[one of]To dream you are captured by pirates is a sign you will travel in foreign countries and eventually make your fortune: if a girl dreams this it foretells that she will marry a foreigner who dying will leave her a fortune.[cycling]"
"an"	"intrigue"	"[one of]To dream you are connected in an intrigue, is ominous of evil.[cycling]"
"a"	"bridge"	"[one of]To dream you are crossing over a bridge denotes prosperity in life and success in love; but to dream you are passing under a bridge indicates difficulties in life both in love and business; if you meet with obstructions either on or under the bridge it foretells illness.[or]To dream a bridge breaks down with you denotes sudden death.[cycling]"
"a"	"bridge"	"[one of]To dream you are crossing over a bridge is a good omen--it denotes prosperity through life, and success in love.[or]To dream you are passing under a bridge, indicates that you will never be perfectly at ease.[or]If you meet with any obstruction on the bridge it foretells a fit of sickness; are you a lover, it denotes that your sweetheart will be afflicted with illness.[or]To dream a bridge breaks down with you denotes sudden death.[cycling]"
"a"	"crowing"	"[one of]To dream you are crowing, or that you hear others crowing, denotes ill luck, especially to lovers; but to dream that you hear pigeons crowing, is good, especially to the newly-married, as it denotes happiness.[cycling]"
"a"	"wood"	"[one of]To dream you are cutting or chopping wood, clearly shows that you will be happy in your family, and become rich and respectable in life.[or]To dream you are carrying wood upon your back, shows that you will rise to affluence by your industry, but that your partner will be of a bad temper and your children undutiful.[or]If you dream you are walking or sitting alone in an extensive wood by a running stream, it denotes that you will quickly fall in love, and also that you will be often married.[or]To dream that you are walking or sitting there with a worthy object of your affections, betokens your speedy union, which will prove so felicitous that you will be called 'the happy couple.'[cycling]"
"a"	"linen"	"[one of]To dream you are dressed in clean linen, denotes that you will shortly receive some glad tidings.[or]That your sweetheart is faithful, and will marry.[or]If it is dirty, then it denotes poverty, and disappointment in love.[cycling]"
"a"	"beer"	"[one of]To dream you are drinking beer is a sure sign of domestic troubles.[cycling]"
"a"	"drowning"	"[one of]To dream you are drowning or that you see another drowned portends good to the dreamer; to the lover good-tempered sweethearts and marriage; but to a girl it is a sign she should keep an eye on her lover.[cycling]"
"a"	"drowning"	"[one of]To dream you are drowning, or that you see another drowned or drowning, portends good to the dreamer.[or]To the lover it denotes that your sweetheart is good-tempered and inclined to marry you.[cycling]"
"a"	"hash"	"[one of]To dream you are eating hash, many sorrows and vexations are foretold.[or]You will probably be troubled with various little jealousies and contentions over mere trifles, and your health will be menaced through worry.[or]For a woman to dream that she cooks hash, denotes that she will be jealous of her husband, and children will be a stumbling block to her wantonness.[cycling]"
"a"	"fat"	"[one of]To dream you are growing fat if you are a married woman signifies you will soon have a son; to a maiden it signifies she will soon be engaged; to men it is a sign of success in business.[or]To dream you are cutting or eating fat portends sickness and misfortune.[cycling]"
"a"	"labor"	"[one of]To dream you are hard at work shows you will go a painful journey unless you be very circumspect; but to see others at work betokens good fortune.[or]If a girl dreams she sees her lover at work it signifies that he will try and seduce her.[cycling]"
"a"	"cellar"	"[one of]To dream you are in a cellar is a sign of sickness and an unlucky law suit.[cycling]"
"a"	"dairy"	"[one of]To dream you are in a dairy busy at work is a very favorable omen; to the maid it indicates that her lover will be of an industrious turn and will rise to honor.[or]To the farmer it denotes that his crops will be abundant; to the tradesman good news.[cycling]"
"a"	"dairy"	"[one of]To dream you are in a dairy busy at work, is a very favorable omen; to the maid it indicates that her lover will be of an industrious turn, and that if she marries, she will have children, and her husband will become rich and rise to honor.[or]To the farmer it denotes that his crops will be abundant, but that he will lose some of his live stock by thieves.[cycling]"
"a"	"hail"	"[one of]To dream you are in a hailstorm, presages great sorrow in life.[or]If you are in love, it forewarns you against marrying your present sweetheart, who will prove of very bad temper and make you miserable.[cycling]"
"a"	"market"	"[one of]To dream you are in a large market where all kinds of meats and vegetables are sold is a sign you will want money that it will be difficult and perhaps impossible to raise; it is a bad sign for tradesmen and others who have notes to pay.[cycling]"
"a"	"grease"	"[one of]To dream you are in grease, is significant of travels being enjoyed with disagreeable but polished strangers.[cycling]"
"a"	"love"	"[one of]To dream you are in love is a sign you will make a fool of yourself and do something silly of which you may afterwards be ashamed—thus showing that the dream works contrariwise—for love is anything but a silly sentiment unless indulged in by fools.[or]For a young girl to dream of falling in love foretells that she will be laughed at and ridiculed for some folly.[cycling]"
"a"	"jealousy"	"[one of]To dream you are jealous of your sweetheart or wife signifies that they will betray you; for a maiden to dream she is jealous of her sweetheart is a sign some particular friend will 'cut her out' for a wife to dream she is jealous of her husband foretells the loss of his love.[cycling]"
"a"	"globe"	"[one of]To dream you are looking at a globe foretells much good and that you will be a great traveller.[cycling]"
"a"	"kaleidoscope"	"[one of]To dream you are looking through one of these curious instruments and if you are delighted with the changes that present themselves it is a sign that you will either travel in distant countries or be very discontented at home.[cycling]"
"a"	"mad"	"[one of]To dream you are mad, and that you are in company with mad people, is very good to the dreamer.[or]It promises long life, riches, happy marriage, success in trade and good children.[or]If you are a farmer, some accident will happen to a part of your live stock, but you will have plentiful crops.[or]If you are in lawsuit, it will determine greatly in your favor.[cycling]"
"a"	"will"	"[one of]To dream you are making your will, is significant of momentous trials and speculations.[or]For a wife or any one to think a will is against them, portends that they will have disputes and disorderly proceedings to combat in some event soon to transpire.[or]If you fail to prove a will, you are in danger of libelous slander.[or]To lose one is unfortunate for your business.[or]To destroy one, warns you that you are about to be a party to treachery and deceit.[cycling]"
"a"	"marriage"	"[one of]To dream you are married, is ominous of death, and very unfavorable to the dreamer.[or]It denotes poverty, a prison, and misfortune.[or]To dream you assist at a wedding, is the forerunner of some pleasing news and great success.[or]To dream of lying with your newly married husband or wife, threatens danger and sudden misfortunes and also that you will lose part of your property.[or]To the sailor, it argues storm and shipwrecks with a narrow escape from death.[cycling]"
"a"	"feet"	"[one of]To dream you are near a river or fountain and that you wash your feet, signifies molestation and trouble.[or]To dream of one scratching the soles of your feet, signifies loss by flattery.[cycling]"
"an"	"ocean"	"[one of]To dream you are on the ocean with a woman, is a sign some female friend is deceitful, or that you are deceitful in some friends.[or]It is unlucky to dream you swim, walk on, or catch fish in the season.[or]But it is nevertheless lucky to dream of the ocean to any person about to go on a journey, unless, indeed, it be very tempestuous.[cycling]"
"a"	"dice"	"[one of]To dream you are playing at dice backgammon or draughts denotes much good to the dreamer in either love marriage or business.[or]To a young girl engaged to be married dreaming of dice foretells that her lover will be wild and not of much account.[cycling]"
"a"	"dice"	"[one of]To dream you are playing at dice or back-gammon, denotes much good to the dreamer, in either love, marriage or trade.[cycling]"
"a"	"wisdom"	"[one of]To dream you are possessed of wisdom, signifies your spirit will be brave under trying circumstances, and you will be able to overcome these trials and rise to prosperous living.[or]If you think you lack wisdom, it implies you are wasting your native talents.[cycling]"
"a"	"prison"	"[one of]To dream you are put in prison foretells that honor awaits you: but this omen does not apply to rogues or dishonest people though such a dream by them favors their desires: if a girl dreams that her lover has gone to prison she will soon hear of his advancement.[cycling]"
"a"	"rich"	"[one of]To dream you are rich or that you have inherited a fortune is a sign of poverty and bad luck; but if you imagine that some one pays you large sums of money enough to make you rich your dream will be realized so far that you will acquire property.[or]If a person dreams that a legacy is paid to him in money it has an entirely different meaning from a dream that you are enriched from a legacy but do not see the money.[cycling]"
"a"	"coach"	"[one of]To dream you are riding in a coach is a very unlucky omen.[or]It foretells poverty and disgrace.[or]If you are in love, your sweetheart will be idle and bad-tempered.[or]If you are in trade, you will become bankrupt, and if you are a farmer, your goods will be seized for rent.[or]It also denotes that the dreamer will shortly be in prison.[cycling]"
"a"	"cradle"	"[one of]To dream you are rocking a cradle is a good omen and signifies a long and prosperous life.[or]To the married it is a sign of domestic happiness and to the single a sign of speedy marriage with the object of their affection.[or]To dream you upset a cradle portends sickness or a loss in business.[cycling]"
"a"	"boat"	"[one of]To dream you are sailing in a boat in pleasant weather and enjoying yourself denotes good success in business; to lovers it foretells happiness; if the weather is boisterous it predicts quarrels which will be speedily settled; dreams of sailing smoothly in boats are emphatically good ones to all kinds of people.[cycling]"
"a"	"chair"	"[one of]To dream you are sitting on a chair is a sign you will soon have an increase in your family; if a maiden has this dream it is a sign she soon will be married.[or]To dream you are sitting in a rocking chair denotes you will very soon better your condition.[cycling]"
"a"	"segar"	"[one of]To dream you are smoking a segar is a sign you will have misfortunes and troubles with your business matters: if you imagine the fire of your segar goes out it is a sign you will meet with losses: in love matters this dream is a bad omen.[cycling]"
"a"	"pain"	"[one of]To dream you are suffering great pain from toothache, headache, rheumatism, or in any part or your body, denotes that you are about to receive some glad tidings from one who has been long absent from you.[cycling]"
"an"	"office"	"[one of]To dream you are turned out of your office, foretells death and loss of property.[or]If you are in love, it foretells want of affection in your sweetheart and misery if you marry the present object of your affection.[cycling]"
"an"	"incantation"	"[one of]To dream you are using incantations, signifies unpleasantness between husband and wife, or sweethearts.[or]To hear others repeating them, implies dissembling among your friends.[cycling]"
"a"	"fatigue"	"[one of]To dream you are very much fatigued portends that you will be successful in business but it is a sign of sickness.[cycling]"
"a"	"vote"	"[one of]To dream you are voting is bad particularly to a sick person: for a newly married woman to dream of voting is a sure sign that her first child will be a boy who will come to great honors.[cycling]"
"a"	"vote"	"[one of]To dream you are voting is bad, particularly to sick persons.[or]For a newly-married woman to dream of voting, is a sure sign her first child will be a boy, who will come to great honors.[cycling]"
"a"	"garden"	"[one of]To dream you are walking in a garden, is of a very favorable nature.[or]It portends elevation in fortune and dignity.[or]To the lover, it denotes great success and an advantageous marriage.[or]To the tradesman, it promises increase of business.[or]To the farmer, plentiful crops, and to the sailor, prosperous voyages.[cycling]"
"a"	"ladder"	"[one of]To dream you ascend a ladder, signifies honor.[or]But to dream you descend a ladder, betokens damage.[cycling]"
"a"	"revival"	"[one of]To dream you attend a religious revival, foretells family disturbances and unprofitable engagements.[or]If you take a part in it, you will incur the displeasure of friends by your contrary ways.[cycling]"
"an"	"auction"	"[one of]To dream you attend an auction is, on the whole, unfavorable.[or]If you purchase, expect loss of property.[or]If you only attend, you are sure to meet with a heavy deprivation of friends and property.[or]If you pass by one, then you will attain, in a few years, all that you moderately desire.[cycling]"
"a"	"school"	"[one of]To dream you begin again to go to school, and yet cannot say your lessons right, shows you are about to undertake something you do not understand.[cycling]"
"a"	"tumbler"	"[one of]To dream you break a tumbler, is prognostic of secrets being discovered that have long remained a mystery.[or]To drink from a clear tumbler, denotes health and activity; to drink from a dirty one, the reverse.[cycling]"
"a"	"house"	"[one of]To dream you build a house denotes you will have a comfortable life: to burn your house signifies increased riches: to dream you spill water in a house is a sign of care and affliction: to dream you see a house fall denotes death.[or]Dreaming of building houses wearing fine clothes and talking with ladies is a sign that the parties will suddenly marry.[cycling]"
"a"	"hay"	"[one of]To dream you cut it, signifies that you will have great influence in society.[or]To dream of raking it together, denotes that you will stand at the head of assemblies.[cycling]"
"a"	"drink"	"[one of]To dream you drink cold water is good to all; hot sickness and hindrance; wine is good; sweet wine success in love; oil sickness; from vessels of gold or silver or earthenware intends tranquillity; of horn implies good; glass evil.[cycling]"
"a"	"drink"	"[one of]To dream you drink cold water, is good, but hot signifies sickness and hindrance of affairs.[or]To dream you drink wine with moderation, is good; to drink oil, signifies poison.[or]To dream you are drinking when you are dry from a stream or fountain, is a sign of sickness.[or]If a man dreams he is drunk with sack, or some sweet, pleasant drink, it is a sign he will be beloved by some lady and grow rich thereby.[cycling]"
"a"	"milk"	"[one of]To dream you drink milk, is an extraordinary good sign.[or]And to dream you see breasts of milk, signifies profit.[or]To dream you are carrying milk is a good sign, but if you fall and spill it, misfortune will befall you, from which it would be difficult to extricate yourself.[cycling]"
"a"	"vinegar"	"[one of]To dream you drink vinegar signifies sickness and sharp words: to use it in pickling is a sign of gain.[cycling]"
"a"	"vinegar"	"[one of]To dream you drink vinegar, signifies sickness.[cycling]"
"a"	"pitcher"	"[one of]To dream you drink water or milk from a pitcher is a good omen and signifies you will be prosperous in love and business.[or]To dream you spill anything out of a pitcher foretells losses from the treachery of supposed friends and to dream you break a pitcher portends sickness and accident while on a journey.[or]To dream of breaking a pitcher is also a sign of bankruptcy through carelessness.[cycling]"
"a"	"cheese"	"[one of]To dream you eat cheese signifies profit and gain in trade; in love deceit.[cycling]"
"a"	"mushroom"	"[one of]To dream you eat mushrooms is a sign you will live to a good old age but to dream you see them grow or gather them is a sign you will get rich by a splendid speculation and then get poor as suddenly as you got wealthy.[cycling]"
"a"	"fall"	"[one of]To dream you fall from any high place, or from a tree, denotes loss of place and goods.[or]If you are in love, it surely indicates that you will never marry the present object of your affections.[cycling]"
"a"	"treasure"	"[one of]To dream you find a treasure in the earth, is very ominous.[or]It shows that you will be betrayed by some one whom you make your bosom friend; that your sweetheart is unfaithful and grossly deceives you; and should you not be able to carry it away, then it denotes that you will have some very heavy loss, and that you will be waylaid by robbers, who will ill-treat you.[cycling]"
"a"	"shell"	"[one of]To dream you find an empty shell is a sign you will meet with losses in business but if in your dream you imagine the shell to be full it foretells you will be successful in all your undertakings.[or]If you dream you are opening any kind of shell fish for others to eat it foreshadows that you will have plentyof funds.[cycling]"
"a"	"bird’s nest"	"[one of]To dream you find one is a good sign.[or]To dream you find one without eggs or birds, shows you will meet with great disappointments.[cycling]"
"a"	"newyear’spresent"	"[one of]To dream you give a New.[or]Year’s present signifies you will hear good news.[or]To receive one is a sign you will soon get into trouble.[cycling]"
"a"	"bed"	"[one of]To dream you go to the bedside of your lover, foretells a speedy marriage; if you dream you go between the sheets, you will have a child within twelve months after marriage, who will become rich and afford you support in your old age.[cycling]"
"a"	"head"	"[one of]To dream you have a great head, or a head bigger than ordinary, and very highly raised, that signifies dignity, esteem.[or]If a sick person dream thus, it prognosticates both the headache and violent fever.[or]If one dreams his head is cut off by robbers and murderers, that signifies loss of children, relations, estate or wife; and to the wife so dreaming, the loss of her husband.[or]To dream that one cuts off another’s head, signifies assurance of effecting business, or revenge upon your enemies.[or]To dream you cut off the head of a pullet, or a green goose, signifies joy and recreation.[or]To dream one hath the head of a lion or wolf, or some other cruel beast, it is a good sign to the dreamer.[or]To dream one hath the head of a dog, horse, or ass, or such four-footed beast, is servitude, pain and misery to the dreamer.[or]To dream one hath a bird’s head, argues one shall not stay long in his country.[or]If one dreams that he is careful to comb and trim his hair, it is a sign he shall dispose well of his business.[or]To dream you wash your head, signifies deliverance from danger.[cycling]"
"a"	"misfortune"	"[one of]To dream you have a misfortune denotes luck and success: thus; dreaming of the loss of money is a sign you will get some: if you imagine your house is burned you will be successful in a speculation: if you dream of being robbed it foretells a legacy or the finding of something valuable &c.[cycling]"
"a"	"rival"	"[one of]To dream you have a rival, is a sign that you will be slow in asserting your rights, and will lose favor with people of prominence.[or]For a young woman, this dream is a warning to cherish the love she already holds, as she might unfortunately make a mistake in seeking other bonds.[or]If you find that a rival has outwitted you, it signifies that you will be negligent in your business, and that you love personal ease to your detriment.[or]If you imagine that you are the successful rival, it is good for your advancement, and you will find congeniality in your choice of a companion.[cycling]"
"a"	"beard"	"[one of]To dream you have a very little beard signifies suits at law; if it is a long thick beard the dream is a good one for it shows success; for a person to dream of his beard falling out he will lose some near relative or will come to disgrace.[cycling]"
"an"	"ague"	"[one of]To dream you have an ague, denotes that you are in danger of becoming a drunkard and a glutton.[or]To dream your sweetheart has an ague, is a lucky omen; it shows you are beloved, and that you will be happy with the object of your wishes, but never very rich.[cycling]"
"a"	"disease"	"[one of]To dream you have any disease promises prompt and speedy employment.[cycling]"
"a"	"comfort"	"[one of]To dream you have comforts of any one, betokens to the rich and happy, injury and mishap; but to the poor and afflicted, aid and comfort.[cycling]"
"a"	"grip"	"[one of]To dream you have griping sensations in the bowels denotes an accident causing a flesh wound: if you dream that a man takes you by the hand or any part of your body by a hard grip that hurts you it is a sign that you will have a pressing invitation to go somewhere—perhaps a summons to court.[cycling]"
"a"	"wager"	"[one of]To dream you have laid a wager on some matter in dispute, or on some event that has to come off, denotes that you are in danger of being subjected to a serious accident, and that through the interposition and courage of a friend you are permitted to escape with only a slight injury.[cycling]"
"a"	"supreme"	"[one of]To dream you have supreme command over any place, is unfortunate, particularly if the person is sick and helpless.[cycling]"
"a"	"music"	"[one of]To dream you hear delicious music is a very favorable omen, promising joyful news from a long absent friend.[or]To married people it denotes sweet tempered children.[or]In love it shows that your sweetheart is very fond of you, is good tempered, sincere and constant.[or]Rough and discordant music foretells trouble, vexation and disappointment.[cycling]"
"a"	"neigh"	"[one of]To dream you hear horses neigh, augurs that you will have new and powerful friends, who will do you much service.[cycling]"
"a"	"door bell"	"[one of]To dream you hear or ring a door bell, foretells unexpected tidings, or a hasty summons to business, or the bedtide of a sick relative.[cycling]"
"a"	"clock"	"[one of]To dream you hear the clock strike denotes speedy marriage; if you dream the clock falls or breaks it denotes danger.[or]To dream of counting the hours of the forenoon is lucky; the afternoon unlucky.[cycling]"
"a"	"clock"	"[one of]To dream you hear the clock strike, denotes that you will be speedily married, and that you will be moderately successful in life.[or]To dream you are counting the hours, if in the forenoon, shows much happiness, and that your sweetheart is true to you, but if in the afternoon, that misfortune and danger will attend you, and that your sweetheart is false and loves another.[cycling]"
"a"	"drum"	"[one of]To dream you hear the rolling of a drum signifies that you will be called away from your home or business unexpectedly.[or]If you see soldiers marching when you hear the drum it shows that though you may not have to leave yet you will receive an unexpected message that will cause you trouble or excitement.[cycling]"
"a"	"trumpet"	"[one of]To dream you hear the sound of a trumpet is a bad omen and denotes trouble and misfortune; to the tradesman it presages the loss of business; to the farmer bad crops; to the lover insincerity in the object of your affections.[cycling]"
"a"	"trumpet"	"[one of]To dream you hear the sound of a trumpet is a bad omen, and denotes troubles and misfortunes.[or]To the tradesman, it presages loss of business; to the farmer, bad crops; to the lover, insincerity in the object of his affections.[cycling]"
"a"	"thunder and lightning"	"[one of]To dream you hear thunder and see lightning is a very good dream.[or]It denotes success in trade, good crops to the farmer and a speedy and happy marriage to the lover.[or]If you are soliciting a place, you will obtain it; if you have a lawsuit, you will gain it.[or]It also indicates speedy news from a far distant country.[cycling]"
"a"	"kill"	"[one of]To dream you kill a man, signifies assuredness of business.[or]To dream you kill your father, is a bad sign.[or]To dream you are killed, denotes loss to him whom you dreamed has killed you.[cycling]"
"a"	"teeth"	"[one of]To dream you lose a tooth, denotes the loss of some friend by death, and that troubles and misfortunes are about to attend you.[or]To dream you cut new teeth, denotes the birth of a child, who will make a great figure in the world.[cycling]"
"a"	"teeth"	"[one of]To dream you lose your teeth denotes the loss of friends troubles and misfortunes; to the lover it shows the loss of your sweetheart’s affections: to dream you cut a new tooth denotes the birth of a child who will make a figure in the world.[cycling]"
"a"	"way"	"[one of]To dream you lose your way, warns you to disabuse your mind of lucky speculations, as your enterprises threaten failure unless you are painstaking in your management of affairs.[or]Road and.[cycling]"
"a"	"maid"	"[one of]To dream you obtain a young maid, signifies joy.[or]To dream you take away a maid by force, signifies sorrow.[cycling]"
"a"	"flute"	"[one of]To dream you play or hear playing on a flute signifies trouble and contention with your friends.[cycling]"
"a"	"flute"	"[one of]To dream you play or hear playing on a flute, signifies trouble and contention.[cycling]"
"a"	"harp"	"[one of]To dream you play upon the harp indicates that you have some envious enemies who seek to injure you with slander.[or]To dream you hear any person play upon the harp is a sign that if you have sick friends they will recover.[or]In love affairs this dream is very lucky.[cycling]"
"an"	"acquaintance"	"[one of]To dream you quarrel or fight with an acquaintance forebodes divisions in your own family; in love unfaithfulness; and losses in business.[cycling]"
"an"	"injury"	"[one of]To dream you receive an injury, signifies that you have many friends--no enemies.[or]If you dream of inflicting injury, you will both receive and dispense blessings.[cycling]"
"a"	"carriage"	"[one of]To dream you ride in a carriage is a sign of success in business and love.[or]If the carriage breaks down it is a sign you will meet with sudden losses.[cycling]"
"a"	"rouse"	"[one of]To dream you rouse a person from sleep, is good.[cycling]"
"a"	"cock"	"[one of]To dream you see a cock in the house is a good sign to those who would marry; to hear a cock crow denotes great prosperity.[cycling]"
"a"	"comedy"	"[one of]To dream you see a comedy or farce is a good omen.[or]To the business man it betokens success and to the maiden a speedy marriage to the one she loves.[cycling]"
"a"	"cook"	"[one of]To dream you see a cook in the house is good to those who would marry and to the poor; but it is also the revealing of secrets; to dream of cooking is also a sign of a wedding.[cycling]"
"a"	"corpse"	"[one of]To dream you see a corpse is a sign of long life.[cycling]"
"a"	"crow"	"[one of]To dream you see a crow, signifies expedition of business.[or]To dream you see a crow flying, is ill luck; and if you hear them croaking unpleasantly, the dream is so much the worse.[or]If you dream the crow flies on the head of a child, it will be in great danger of some misfortune.[cycling]"
"a"	"dragon"	"[one of]To dream you see a dragon signifies riches and gain of great treasure.[cycling]"
"a"	"flag"	"[one of]To dream you see a flag waving betokens great danger from enemies or sickness.[or]To dream you carry a flag signifies you will receive some mark of distinction from your fellow-citizens.[or]If a maid dream she is making a flag it is a sign she will marry a rich officer in the.[or]Army or.[or]Navy; but if a married woman has this dream it foretells the birth of a son who will become a great general.[cycling]"
"a"	"sheep"	"[one of]To dream you see a flock of sheep feeding, is a very favorable omen; it denotes success.[or]To dream you see them dispersing, and running away from you, shows that pretended friends are endeavoring to do you an injury, and that your children will meet with persecution and great troubles.[or]In love, such a dream shows your sweetheart to be fickle and little calculated to make you happy.[or]To dream you see sheep shearing, is indicative of loss of property and the affections of the person you love; also of your liberty.[or]To dream you are shearing them yourself, shows that you will gain an advantage over some person who meant to harm you, and that you will get the better of difficulties and marry the object of your affection.[cycling]"
"a"	"river"	"[one of]To dream you see a flowing river, and that the waters are smooth and clear, presages happiness and success in life.[or]If the water appears disturbed and muddy, or has a yellow tinge, then it denotes that you will acquire considerable riches.[cycling]"
"a"	"friend"	"[one of]To dream you see a friend dead, betokens hasty news of a joyful nature.[or]If you are in love, it foretells a speedy marriage with the object of your affections.[cycling]"
"a"	"grave"	"[one of]To dream you see a grave, foretells sickness and disappointment.[or]If you are in love, you will surely never marry your present sweetheart.[or]If you go into the grave, it shows you will experience a loss of property and that false friends will defame you.[or]If you come out of the grave, it denotes success in your undertakings, that you will rise in the world, become rich, and if you are in love, that you will speedily marry your sweetheart.[or]If you take another out of the grave, you will be the means of saving the life of a person who will be a very great friend to you, and receive some unexpected legacy.[cycling]"
"a"	"light"	"[one of]To dream you see a great light is a happy presage; it denotes that you will attain honors and become rich; in love it shows a sweetheart of an amiable disposition.[cycling]"
"a"	"light"	"[one of]To dream you see a great light is a happy presage.[or]It denotes that you will attain great honors and become very rich.[or]In love, it shows a sweetheart of an amiable disposition, that you will marry well, have children and be very happy.[cycling]"
"a"	"bread"	"[one of]To dream you see a great quantity of loaves of bread, denotes success in life.[or]To dream you are eating good bread, denotes that you will be shortly married.[or]To dream the bread is musty and bad, denotes the loss of friends and that some near relation will shortly die.[cycling]"
"a"	"laurel"	"[one of]To dream you see a laurel tree is a token of victory and pleasure, and if you be married, it denotes the inheritance of possession by your wife.[or]To dream one sees or smells laurel, if it be a woman, she shall bear children.[or]If a maid, she will be suddenly married.[cycling]"
"a"	"midwife"	"[one of]To dream you see a midwife, is a revealing of secrets, and signifies hurt.[or]To those who are kept by force, to dream of a midwife, signifies liberty.[or]If a woman that is not with child dreameth often of seeing her, it forebodeth she shall have a fit of sickness, which shall be long and continuous.[cycling]"
"a"	"fainting"	"[one of]To dream you see a person fainting indicates that you will soon hear of the death of a dear friend.[cycling]"
"a"	"gibbet"	"[one of]To dream you see a person hanging on a gibbet, is a sign of damage and great affliction.[cycling]"
"a"	"swoon"	"[one of]To dream you see a person swoon is unfortunate to the maid.[or]To the married, it is a sign they will become rich and prosperous.[or]To those who are nervous it is bad.[cycling]"
"a"	"mask"	"[one of]To dream you see a person wearing a mask is a sign of hypocrisy; to the lover it shows that his sweetheart loves some one better than himself; to a girl it signifies that her lover is engaged to another.[or]To married people it portends infidelity to the wedding-ring.[cycling]"
"a"	"rainbow"	"[one of]To dream you see a rainbow, denotes great traveling and change of fortune; it also foretells sudden news of a very agreeable nature; it announces that your sweetheart is of good temper and very constant, and that you will be very happy in marriage; great success in business, through the means of trading with foreign ports.[cycling]"
"a"	"serpent"	"[one of]To dream you see a serpent turning and winding himself, signifies danger and imprisonment.[or]It denotes also sickness and hatred.[or]To dream you kill a serpent, is a sign that you will overcome your enemies.[or]To dream of beating serpents is very good, and if a serpent approaching near to do you harm, but does it not, it is a sign that some ill woman shall be disappointed in her designs.[cycling]"
"a"	"tapeworm"	"[one of]To dream you see a tapeworm, or have one, denotes disagreeable prospects for health or for pleasure.[cycling]"
"a"	"teakettle"	"[one of]To dream you see a teakettle, implies sudden news which will be likely to distress you.[or]For a woman to pour sparkling, cold water from a teakettle, she will have unexpected favor shown her.[cycling]"
"a"	"turkey"	"[one of]To dream you see a turkey strutting about, is a sign you will overcome your enemies.[or]To dream you see or are amongst a drove of turkeys, betokens success in your undertakings about this time.[or]To dream of dead turkeys denotes that you will encounter trouble that you will soon surmount.[cycling]"
"a"	"yacht"	"[one of]To dream you see a yacht under full sail while you are on shore is a sign you will soon fall in love with a pretty maid or widow.[or]To dream you are sailing in a yacht with a pleasant breeze is a good omen and denotes success in business and to lovers happiness.[or]Dreams of sailing on smooth water are good to all persons but to dream the weather is stormy predicts quarrels and strife (_See.[or]Ship and.[cycling]"
"an"	"apparition"	"[one of]To dream you see an apparition or spirit clothed in white signifies deceit temptation to sin and disappointment in love.[cycling]"
"an"	"apparition"	"[one of]To dream you see an apparition, or spirit, clothed in white, signifies deceit and temptation to sin.[cycling]"
"an"	"eclipse"	"[one of]To dream you see an eclipse of the moon, denotes that you will lose some female friend--your mother, if she be living.[or]You will experience a great uneasiness on account of a woman.[or]Your sweetheart will prove unfaithful.[or]Poverty will overtake you and misery end your days.[or]To dream you see an eclipse of the sun, denotes that you will lose some male friend--your father, if he be alive; and that you will experience some uneasiness by the means of some troublesome friends; to a woman with child it foretells a son, who will be a great man.[cycling]"
"an"	"inscription"	"[one of]To dream you see an inscription, foretells you will shortly receive unpleasant communications.[or]If you are reading them on tombs, you will be distressed by sickness of a grave nature.[or]To write one, you will lose a valued friend.[cycling]"
"a"	"complexion"	"[one of]To dream you see an unknown person of a brown complexion, is a sign of glory, honor, success and dispatch of business.[or]If one dreams he sees a woman of a very brown complexion, it signifies a very dangerous disease.[or]If you see a woman unknown in your dream, with long and comely hair, with clear complexion, it is a very good sign.[cycling]"
"an"	"angel"	"[one of]To dream you see angels in your sleep is a sign some are near you and that the rest of your dream will come to pass.[or]To see many angels is a sign of many children and much prosperity.[cycling]"
"an"	"angel"	"[one of]To dream you see angels is good, but to speak with or call upon them is evil.[cycling]"
"a"	"grain"	"[one of]To dream you see any kind of grain and that one gathers it, signifies profit and gain.[cycling]"
"a"	"coal"	"[one of]To dream you see dead coal signifies expedition in business; but to dream you see burning coal threatens you with shame and reproach.[cycling]"
"a"	"corn"	"[one of]To dream you see fields of corn, or that you are among unthrashed corn, is a very favorable omen; it denotes success in business; to the lover it announces that you will marry, have many children, and become rich and happy.[or]If you are a sailor, it denotes a lucrative voyage and fine weather, and that you will be near marrying in the next port you touch at.[or]If you dream you are gathering ripe corn, it is the most fortunate dream you can have.[cycling]"
"an"	"anchor"	"[one of]To dream you see one signifies unexpected success in love; but in business it shows the success to be distant and only obtainable with care.[cycling]"
"an"	"anchor"	"[one of]To dream you see one, signifies great assurance and certain joys.[cycling]"
"a"	"wheat"	"[one of]To dream you see or are walking in a field of wheat, is a very favorable omen, and denotes great prosperity and riches.[or]In love, it argues a completion of your most sanguine wishes and foretells much happiness, with fine children, when you marry.[or]If you have a lawsuit, you will gain it and you will be successful in all your undertakings.[cycling]"
"a"	"mile-post"	"[one of]To dream you see or pass a mile-post, foretells that you will be assailed by doubtful fears in business or love.[or]To see one down, portends accidents are threatening to give disorder to your affairs.[cycling]"
"an"	"idol"	"[one of]To dream you see persons worshiping at an idol, betokens a change of affairs and much for the better.[or]To dream you worship an idol, is a sign of merriment, such as going to balls, parties or excursions, pleasant journeys and the like.[or]If a sick person has this dream, they will have a speedy recovery.[cycling]"
"a"	"silk"	"[one of]To dream you see silk, either in pieces or for sewing, signifies prosperity and success in undertakings.[or]To dream you are clothed in silk, foretells that you will do honors in the state, and become rich, but that you will quarrel with a rich neighbor, who will endeavor to do you mischief.[or]For a married woman to dream of being dressed in a silk gown, shows her husband is fond of a harlot, who will go near to ruin him.[or]If a maiden dreams of it, she will speedily see her lover.[cycling]"
"an"	"acorn"	"[one of]To dream you see swine eating acorns denotes that you will have reverses in business and lose if you are not very careful; to dream of picking acorns signifies that a rich relative will leave you a fortune.[cycling]"
"a"	"snow"	"[one of]To dream you see the ground covered with snow is a good omen.[cycling]"
"an"	"eve"	"[one of]To dream you see the mother of all men, is a favorable omen.[or]It denotes great happiness to the lover.[cycling]"
"a"	"sun"	"[one of]To dream you see the sun shine, shows acquisition of riches, and enjoyment of honorable posts in the state; also success to the lover.[or]To dream you see the sun rise, promises fidelity in your sweetheart and good news from friends.[or]To dream you see the sun set, shows infidelity in your sweetheart, and disgraceful news.[or]To the tradesman, loss of business.[or]To dream you see the sun under a cloud, foretells many hardships and troubles about to befall you, and that you will encounter some great danger.[cycling]"
"a"	"dove"	"[one of]To dream you see these emblems of love denotes good fortune to the dreamer.[cycling]"
"an"	"adam"	"[one of]To dream you see this father of men, this inhabitant of Paradise, who was betrayed by.[or]Eve into sin, is a happy omen.[or]If he looks pleasant, be sure you will succeed in whatever you undertake.[or]If he looks displeased and angry, then you must use great caution in all your dealings, for some mischief is intended you, but you will get the better of it.[or]Be careful, if he speaks to you, to mind what he says, and observe it as faithfully as you possibly can.[cycling]"
"a"	"sycamore"	"[one of]To dream you see this tree, denotes jealousy to the married; and to the virgin, she shall shortly be married.[cycling]"
"a"	"back"	"[one of]To dream you see your back, betokens some uneasiness; for the back to be broken or hurt, shows you will be scoffed at by your enemies; yet to dream of the backbone, signifies health and success in love, marriage and business.[cycling]"
"a"	"brother"	"[one of]To dream you see your brother, denotes a speedy marriage in your family and that the dreamer will not be long-lived; if you are in love it is a favorable omen.[cycling]"
"a"	"father"	"[one of]To dream you see your father is fortunate; to see him die is unlucky and portends sickness.[cycling]"
"a"	"mother"	"[one of]To dream you see your own mother living, signifies joy.[or]To see your mother dead, signifies misfortune.[cycling]"
"a"	"sister"	"[one of]To dream you see your sister denotes a speedy death in your family and that the dreamer will be long-lived: if you are in love it is a favorable omen.[cycling]"
"a"	"fant"	"[one of]To dream you see your sweetheart fanning herself signifies that a stranger will step in some fine day and 'cut you out'.[or]If a maid dreams that her beau presents her with a fan or offers to fan her it is a sign he will attempt to take improper liberties with her.[cycling]"
"a"	"zouave"	"[one of]To dream you see zouaves as well as other soldiers and armed men denotes that you will have quarrels and trouble in your family if you have one and if you have not among your relatives: to the single man this dream foreshadows that his sweetheart loves another better than himself; and to the maiden it signifies her lover will try and seduce her.[cycling]"
"a"	"duet"	"[one of]To dream you sing a duet with a lady shows that you can win her if you desire.[or]To dream you sing with a man shows you have a secret but powerful enemy and is a sign you will never marry.[or]To hear a duet denotes business troubles.[cycling]"
"a"	"sleep"	"[one of]To dream you sleep or slumber, is evil to all, except to those who are in doubt or expectation of some danger, for this delivers them from pain and care.[or]To dream you sleep in a churchyard, is death to the sick and hindrance to others.[cycling]"
"a"	"pipe"	"[one of]To dream you smoke a pipe is an omen of success in business; if the pipe goes out three times it is a sign you will meet with losses.[or]To dream you break a pipe foretells a quarrel that will injure your prospects.[cycling]"
"a"	"sneeze"	"[one of]To dream you sneeze is a sign of long life.[cycling]"
"a"	"dunghill"	"[one of]To dream you stand on a dunghill is a favorable omen.[or]It is a sure forerunner of success in everything undertaken at this time.[or]For a maiden to dream she is on a dunghill, is a sign that she will marry the choice of her affections, who will be a man of some importance.[cycling]"
"a"	"shipwreck"	"[one of]To dream you suffer shipwreck, the ship being overwhelmed, is dangerous to all, except to those detained by force.[or]To them it signifies liberty.[cycling]"
"a"	"quack medicine"	"[one of]To dream you take quack medicine, shows that you are growing morbid under some trouble, and should overcome it by industrious application to duty.[or]To read the advertisement of it, foretells unhappy companions will wrong and distress you.[cycling]"
"an"	"enemy"	"[one of]To dream you talk to an enemy, is a caution to beware of him.[or]To dream you fight with and are worsted by him, denotes that you will meet with some misfortune which has threatened you for some time.[cycling]"
"a"	"velvet"	"[one of]To dream you trade with a stranger in velvet and other silks, is a sign of profit and joy.[cycling]"
"an"	"altar"	"[one of]To dream you uncover or discover an altar, betokens joy and gladness.[cycling]"
"a"	"blood"	"[one of]To dream you vomit blood is good for him that is poor for he shall soon get a sum of money.[or]It is also very good for him that has no children and whose kindred are in a strange country; the first shall see a child of his own; the other will hear favorable news of his kindred or see them returning home.[cycling]"
"a"	"mire"	"[one of]To dream you wade in mire and stubble,.[or]Foretelleth surely toil and trouble,.[or]Yet perseverance will not fail.[or]O’er toil and trouble to prevail.[cycling]"
"a"	"wig"	"[one of]To dream you wear a wig, indicates that you will soon make an unpropitious change.[or]To lose a wig, you will incur the derision and contempt of enemies.[or]To see others wearing wigs, is a sign of treachery entangling you.[cycling]"
"a"	"yield"	"[one of]To dream you yield to another's wishes, denotes that you will throw away by weak indecision a great opportunity to elevate yourself.[or]If others yield to you, exclusive privileges will be accorded you and you will be elevated above your associates.[or]To receive poor yield for your labors, you may expect cares and worries.[cycling]"
"a"	"face"	"[one of]To dream your face is swelled shows that you will accumulate wealth.[or]If you are in love, it denotes that your sweetheart will receive an unexpected legacy and marry you.[cycling]"
"a"	"hat"	"[one of]To dream your hat is torn or dirty, signifies damage and dishonor.[or]But to dream you have a hat on that pleases you, signifies joy, profit, and good success in business.[cycling]"
"an"	"english"	"[one of]To dream, if you are a foreigner, of meeting.[or]English people, denotes that you will have to suffer through the selfish designs of others.[cycling]"
"a"	"cocktail"	"[one of]To drink a cocktail while dreaming, denotes that you will deceive your friends as to your inclinations and enjoy the companionship of fast men and women while posing as a serious student and staid home lover.[or]For a woman, this dream portends fast living and an ignoring of moral and set rules.[cycling]"
"an"	"acid"	"[one of]To drink any acid is an adverse dream, bringing you much anxiety.[or]For a woman to drink aciduous liquors, denotes that she may ensnare herself with compromising situations; even health may be involved.[or]To see poisonous acids, some treachery against you may be discovered.[cycling]"
"a"	"pacify"	"[one of]To endeavor to pacify suffering ones, denotes that you will be loved for your sweetness of disposition.[or]To a young woman, this dream is one of promise of a devoted husband or friends.[or]Pacifying the anger of others, denotes that you will labor for the advancement of others.[or]If a lover dreams of soothing the jealous suspicions of his sweetheart, he will find that his love will be unfortunately placed.[cycling]"
"a"	"poison"	"[one of]To fed that you are poisoned in a dream, denotes that some painful influence will immediately reach you.[or]If you seek to use poison on others, you will be guilty of base thoughts, or the world will go wrong for you.[or]For a young woman to dream that she endeavors to rid herself of a rival in this way, she will be likely to have a deal of trouble in securing a lover.[or]To throw the poison away, denotes that by sheer force you will overcome unsatisfactory conditions.[or]To handle poison, or see others with it, signifies that unpleasantness will surround you.[or]To dream that your relatives or children are poisoned, you will receive injury from unsuspected sources.[or]If an enemy or rival is poisoned, you will overcome obstacles.[or]To recover from the effects of poison, indicates that you will succeed after worry.[or]To take strychnine or other poisonous medicine under the advice of a physician, denotes that you will undertake some affair fraught with danger.[cycling]"
"a"	"fatigue"	"[one of]To feel fatigued in a dream, foretells ill health or oppression in business.[or]For a young woman to see others fatigued, indicates discouraging progress in health.[cycling]"
"a"	"fear"	"[one of]To feel fear signifies that you will be courageous in your waking moments; to dream of frightening others shows that your courage is weak.[cycling]"
"a"	"rheumatism"	"[one of]To feel rheumatism attacking you in a dream, foretells unexpected delay in the accomplishment of plans.[or]To see others so afflicted brings disappointments.[cycling]"
"a"	"sting"	"[one of]To feel that any insect stings you in a dream, is a foreboding of evil and unhappiness.[or]For a young woman to dream that she is stung, is ominous of sorrow and remorse from over-confidence in men.[cycling]"
"a"	"dew"	"[one of]To feel the dew falling on you in your dreams, portends that you will be attacked by fever or some malignant disease; but to see the dew sparkling through the grass in the sunlight, great honors and wealth are about to be heaped upon you.[or]If you are single, a wealthy marriage will soon be your portion.[cycling]"
"a"	"pocketbook"	"[one of]To find a pocketbook filled with bills and money in your dreams, you will be quite lucky, gaining in nearly every instance your desire.[or]If empty, you will be disappointed in some big hope.[or]If you lose your pocketbook, you will unfortunately disagree with your best friend, and thereby lose much comfort and real gain.[cycling]"
"an"	"usurer"	"[one of]To find yourself a usurer in your dreams, foretells that you will be treated with coldness by your associates, and your business will decline to your consternation.[or]If others are usurers, you will discard some former friend on account of treachery.[cycling]"
"a"	"mystery"	"[one of]To find yourself bewildered by some mysterious event, denotes that strangers will harass you with their troubles and claim your aid.[or]It warns you also of neglected duties, for which you feel much aversion.[or]Business will wind you into unpleasant complications.[or]To find yourself studying the mysteries of creation, denotes that a change will take place in your life, throwing you into a higher atmosphere of research and learning, and thus advancing you nearer the attainment of true pleasure and fortune.[cycling]"
"a"	"chamber"	"[one of]To find yourself in a beautiful and richly furnished chamber implies sudden fortune, either through legacies from unknown relatives or through speculation.[or]For a young woman, it denotes that a wealthy stranger will offer her marriage and a fine establishment.[or]If the chamber is plainly furnished, it denotes that a small competency and frugality will be her portion.[cycling]"
"a"	"quicksand"	"[one of]To find yourself in quicksand while dreaming, you will meet with loss and deceit.[or]If you are unable to overcome it, you will be involved in overwhelming misfortunes.[or]For a young woman to be rescued by her lover from quicksand, she will possess a worthy and faithful husband, who will still remain her lover.[cycling]"
"a"	"roof"	"[one of]To find yourself on a roof in a dream, denotes unbounded success.[or]To become frightened and think you are falling, signifies that, while you may advance, you will have no firm hold on your position.[or]To see a roof falling in, you will be threatened with a sudden calamity.[or]To repair, or build a roof, you will rapidly increase your fortune.[or]To sleep on one, proclaims your security against enemies and false companions.[or]Your health will be robust.[cycling]"
"a"	"puddle"	"[one of]To find yourself stepping into puddles of clear water in a dream, denotes a vexation, but some redeeming good in the future.[or]If the water be muddy, unpleasantness will go a few rounds with you.[or]To wet your feet by stepping into puddles, foretells that your pleasure will work you harm afterwards.[cycling]"
"a"	"valley"	"[one of]To find yourself walking through green and pleasant valleys, foretells great improvements in business, and lovers will be happy and congenial.[or]If the valley is barren, the reverse is predicted.[or]If marshy, illness or vexations may follow.[cycling]"
"an"	"absence"	"[one of]To grieve over the absence of any one in your dreams, denotes that repentance for some hasty action will be the means of securing you life-long friendships.[or]If you rejoice over the absence of friends, it denotes that you will soon be well rid of an enemy.[cycling]"
"a"	"cancer"	"[one of]To have one successfully treated in a dream, denotes a sudden rise from obscure poverty to wealthy surroundings.[or]To dream of a cancer, denotes illness of some one near you, and quarrels with those you love.[or]Depressions may follow to the man of affairs after this dream.[or]To dream of a cancer, foretells sorrow in its ugliest phase.[or]Love will resolve itself into cold formality, and business will be worrying and profitless.[cycling]"
"an"	"alarm bell"	"[one of]To hear a bell in your sleep, denotes that you will have cause for anxiety.[cycling]"
"a"	"cricket"	"[one of]To hear a cricket in one's dream, indicates melancholy news, and perhaps the death of some distant friend.[or]To see them, indicates hard struggles with poverty.[cycling]"
"a"	"passing bell"	"[one of]To hear a passing bell, unexpected intelligence of the sorrow or illness of the absent.[or]To ring one yourself, denotes ill health and reverses.[cycling]"
"a"	"serenade"	"[one of]To hear a serenade in your dream, you will have pleasant news from absent friends, and your anticipations will not fail you.[or]If you are one of the serenaders, there are many delightful things in your future.[cycling]"
"a"	"whistle"	"[one of]To hear a whistle in your dream, denotes that you will be shocked by some sad intelligence, which will change your plans laid for innocent pleasure.[or]To dream that you are whistling, foretells a merry occasion in which you expect to figure largely.[or]This dream for a young woman indicates indiscreet conduct and failure to obtain wishes is foretold.[cycling]"
"a"	"duck"	"[one of]To hear ducks quacking or to see these fowls in your dream denotes that somebody is coming to see you who is hungry or that you will shortly have a visitor in your family who will stop to dinner.[cycling]"
"a"	"groan"	"[one of]To hear groans of agony in your dream denotes that you will soon go to a frolic or to a place where you will be much entertained: if you see and recognize people groaning it shows that they will soon do something to amuse or please you.[cycling]"
"a"	"bugle"	"[one of]To hear joyous blasts from a bugle, prepare for some unusual happiness, as a harmony of good things for you is being formed by unseen powers.[or]Blowing a bugle, denotes fortunate dealings.[cycling]"
"a"	"knocking"	"[one of]To hear knocking in your dreams, denotes that tidings of a grave nature will soon be received by you.[or]If you are awakened by the knocking, the news will affect you the more seriously.[cycling]"
"a"	"cackle"	"[one of]To hear the cackling of hens denotes a sudden shock produced by the news of an unexpected death in your neighborhood.[or]Sickness will cause poverty.[cycling]"
"a"	"drum"	"[one of]To hear the muffled beating of a drum, denotes that some absent friend is in distress and calls on you for aid.[or]To see a drum, foretells amiability of character and a great aversion to quarrels and dissensions.[or]It is an omen of prosperity to the sailor, the farmer and the tradesman alike.[cycling]"
"an"	"organ"	"[one of]To hear the pealing forth of an organ in grand anthems, signifies lasting friendships and well-grounded fortune.[or]To see an organ in a church, denotes despairing separation of families, and death, perhaps, for some of them.[or]If you dream of rendering harmonious music on an organ, you will be fortunate in the way to worldly comfort, and much social distinction will be given you.[or]To hear doleful singing and organ accompaniment, denotes you are nearing a wearisome task, and probable loss of friends or position.[cycling]"
"a"	"hurricane"	"[one of]To hear the roar and see a hurricane heading towards you with its frightful force, you will undergo torture and suspense, striving to avert failure and ruin in your affairs.[or]If you are in a house which is being blown to pieces by a hurricane, and you struggle in the awful gloom to extricate some one from the falling timbers, your life will suffer a change.[or]You will move and remove to distant places, and still find no improvement in domestic or business affairs.[or]If you dream of looking on de'bris and havoc wrought by a hurricane, you will come close to trouble, which will be averted by the turn in the affairs of others.[or]To see dead and wounded caused by a hurricane, you will be much distressed over the troubles of others.[cycling]"
"a"	"harp"	"[one of]To hear the sad sweet strains of a harp, denotes the sad ending to what seems a pleasing and profitable enterprise.[or]To see a broken harp, betokens illness, or broken troth between lovers.[or]To play a harp yourself, signifies that your nature is too trusting, and you should be more careful in placing your confidence as well as love matters.[cycling]"
"an"	"owl"	"[one of]To hear the solemn, unearthly sound of the muffled voice of the owl, warns dreamers that death creeps closely in the wake of health and joy.[or]Precaution should be taken that life is not ruthlessly exposed to his unyielding grasp.[or]Bad tidings of the absent will surely follow this dream.[or]To see a dead owl, denotes a narrow escape from desperate illness or death.[or]To see an owl, foretells that you will be secretly maligned and be in danger from enemies.[cycling]"
"a"	"gong"	"[one of]To hear the sound of a gong while dreaming, denotes false alarm of illness, or loss will vex you excessively.[cycling]"
"a"	"stick"	"[one of]To hold a stick foretells mourning; to use it as a prop instability of fortune; to any one with it shows that you are charitable; to receive a beating with one predicts you will better your position in life[cycling]"
"a"	"luck"	"[one of]To imagine in your dream that you have had excellent luck in any enterprise predicts a misfortune: if a man has had a quarrel with his sweetheart and dreams that it is all made up he may be sure that the quarrel will continue a great deal longer than is agreeable to him: to a young lady the sign is the same relative to her beau.[cycling]"
"a"	"sceptre"	"[one of]To imagine in your dreams that you wield a sceptre, foretells that you will be chosen by friends to positions of trust, and you will not disappoint their estimate of your ability.[or]To dream that others wield the sceptre over you, denotes that you will seek employment under the supervision of others, rather than exert your energies to act for yourself.[cycling]"
"a"	"somnambulist"	"[one of]To imagine while dreaming that you are a somnambulist, portends that you will unwittingly consent to some agreement of plans which will bring you anxiety or ill fortune.[cycling]"
"a"	"voyage"	"[one of]To make a voyage in your dreams, foretells that you will receive some inheritance besides that which your labors win for you.[or]A disastrous voyage brings incompetence, and false loves.[cycling]"
"an"	"acquaintance"	"[one of]To meet an acquaintance, and converse pleasantly with him, foretells that your business will run smoothly, and there will be but little discord in your domestic affairs.[or]If you seem to be disputing, or engaged in loud talk, humiliations and embarrassments will whirl seethingly around you.[or]If you feel ashamed of meeting an acquaintance, or meet him at an inopportune time, it denotes that you will be guilty of illicitly conducting yourself, and other parties will let the secret out.[or]For a young woman to think that she has an extensive acquaintance, signifies that she will be the possessor of vast interests, and her love will be worthy the winning.[or]If her circle of acquaintances is small, she will be unlucky in gaining social favors.[or]After dreaming of acquaintances, you may see or hear from them.[cycling]"
"a"	"shave"	"[one of]To merely contemplate getting a shave, in your dream, denotes you will plan for the successful development of enterprises, but will fail to generate energy sufficient to succeed.[cycling]"
"a"	"canoe"	"[one of]To paddle a canoe on a calm stream, denotes your perfect confidence in your own ability to conduct your business in a profitable way.[or]To row with a sweetheart, means an early marriage and fidelity.[or]To row on rough waters you will have to tame a shrew before you attain connubial bliss.[or]Affairs in the business world will prove disappointing after you dream of rowing in muddy waters.[or]If the waters are shallow and swift, a hasty courtship or stolen pleasures, from which there can be no lasting good, are indicated.[or]Shallow, clear and calm waters in rowing, signifies happiness of a pleasing character, but of short duration.[or]Water is typical of futurity in the dream realms.[or]If a pleasant immediate future awaits the dreamer he will come in close proximity with clear water.[or]Or if he emerges from disturbed watery elements into waking life the near future is filled with crosses for him.[cycling]"
"a"	"capt"	"[one of]To put one on be careful in your love affairs; to take one down shows that that which you wish to hide will be discovered; if you receive a cap you will soon be married.[cycling]"
"a"	"question"	"[one of]To question the merits of a thing in your dreams, denotes that you will suspect some one whom you love of unfaithfulness, and you will fear for your speculations.[or]To ask a question, foretells that you will earnestly strive for truth and be successful.[or]If you are questioned, you will be unfairly dealt with.[cycling]"
"an"	"epitaph"	"[one of]To read or write an epitaph in your dream, signifies much good to come from a secret friend.[or]To read your own epitaph, signifies marriage with one now an entire stranger, of great wealth and position.[cycling]"
"a"	"bouquet"	"[one of]To receive one much pleasure; to give one signifies that your lover is constant.[cycling]"
"a"	"present"	"[one of]To receive presents in your dreams, denotes that you will be unusually fortunate.[cycling]"
"a"	"cab"	"[one of]To ride in a cab in dreams, is significant of pleasant avocations, and average prosperity you will enjoy.[or]To ride in a cab at night, with others, indicates that you will have a secret that you will endeavor to keep from your friends.[or]To ride in a cab with a woman, scandal will couple your name with others of bad repute.[or]To dream of driving a public cab, denotes manual labor, with little chance of advancement.[cycling]"
"a"	"vehicle"	"[one of]To ride in a vehicle while dreaming, foretells threatened loss, or illness.[or]To be thrown from one, foretells hasty and unpleasant news.[or]To see a broken one, signals failure in important affairs.[or]To buy one, you will reinstate yourself in your former position.[or]To sell one, denotes unfavorable change in affairs.[cycling]"
"a"	"gig"	"[one of]To run a gig in your dream, you will have to forego a pleasant journey to entertain unwelcome visitors.[or]Sickness also threatens you.[cycling]"
"a"	"farewell"	"[one of]To say farewell or to hear another say it is a bad sign you will hear painful news.[cycling]"
"a"	"scratch"	"[one of]To scratch others in your dream, denotes that you will be ill-tempered and fault-finding in your dealings with others.[or]If you are scratched, you will be injured by the enmity of some deceitful person.[cycling]"
"a"	"bald man"	"[one of]To see a bald-headed man, denotes that sharpers are to make a deal adverse to your interests, but by keeping wide awake, you will outwit them.[or]For a man to dream of a bald-headed woman, insures him to have a vixen for wife.[or]A bald hill, or mountain, indicates famine and suffering in various forms.[or]For a young woman to dream of a bald-headed man, is a warning to her to use her intelligence against listening to her next marriage offer.[or]Bald-headed babies signify a happy home, a loving companion, and obedient children.[cycling]"
"a"	"barometer"	"[one of]To see a barometer in a dream, foretells a change will soon take place in your affairs, which will prove profitable to you.[or]If it is broken, you will find displeasing incidents in your business, arising unexpectedly.[cycling]"
"a"	"garden"	"[one of]To see a beautiful and thrifty garden in your dream denotes good luck and abundance: if the garden is run to weeds you may still have luck but much trouble and vexation will accompany it: if you see rats or pigs in the garden it denotes thieves to annoy you.[cycling]"
"a"	"blacksmith"	"[one of]To see a blacksmith in a dream, means laborious undertakings will soon work to your advantage.[cycling]"
"a"	"bookcase"	"[one of]To see a bookcase in your dreams, signifies that you will associate knowledge with your work and pleasure.[or]Empty bookcases, imply that you will be put out because of lack of means or facility for work.[cycling]"
"a"	"torch"	"[one of]To see a bright torch-light at a distance in a dark night and go toward it foretells a successful journey; but if you stumble by the way you will experience an accident: to dream of carrying a lighted torch at night is a sign that some distant friend will pay you a visit.[cycling]"
"a"	"butterfly"	"[one of]To see a butterfly among flowers and green grasses, indicates prosperity and fair attainments.[or]To see them flying about, denotes news from absent friends by letter, or from some one who has seen them.[or]To a young woman, a happy love, culminating in a life union.[cycling]"
"a"	"candlestick"	"[one of]To see a candlestick bearing a whole candle, denotes that a bright future lies before you filled with health, happiness and loving companions.[or]If empty, the reverse.[cycling]"
"a"	"cannonball"	"[one of]To see a cannon ball denotes misfortune.[cycling]"
"a"	"carpet"	"[one of]To see a carpet in a dream, denotes profit, and wealthy friends to aid you in need.[or]To walk on a carpet, you will be prosperous and happy.[or]To dream that you buy carpets, denotes great gain.[or]If selling them, you will have cause to go on a pleasant journey, as well as a profitable one.[or]For a young woman to dream of carpets, shows she will own a beautiful home and servants will wait upon her.[cycling]"
"a"	"carriage"	"[one of]To see a carriage, implies that you will be gratified, and that you will make visits.[or]To ride in one, you will have a sickness that will soon pass, and you will enjoy health and advantageous positions.[or]To dream that you are looking for a carriage, you will have to labor hard, but will eventually be possessed with a fair competency.[cycling]"
"a"	"cashier"	"[one of]To see a cashier in your dream, denotes that others will claim your possessions.[or]If you owe any one, you will practice deceit in your designs upon some wealthy person.[cycling]"
"a"	"caterpillar"	"[one of]To see a caterpillar in a dream, denotes that low and hypocritical people are in your immediate future, and you will do well to keep clear of deceitful appearances.[or]You may suffer a loss in love or business.[or]To dream of a caterpillar, foretells you will be placed in embarrassing situations, and there will be small honor or gain to be expected.[cycling]"
"a"	"chair"	"[one of]To see a chair in your dream, denotes failure to meet some obligation.[or]If you are not careful you will also vacate your most profitable places.[or]To see a friend sitting on a chair and remaining motionless, signifies news of his death or illness.[cycling]"
"a"	"chambermaid"	"[one of]To see a chambermaid, denotes bad fortune and decided changes will be made.[or]For a man to dream of making love to a chambermaid, shows he is likely to find himself an object of derision on account of indiscreet conduct and want of tact.[cycling]"
"a"	"coffee mill"	"[one of]To see a coffee mill in your dreams, denotes you are approaching a critical danger, and all your energy and alertness will have to stand up with obduracy to avert its disastrous consequences.[or]To hear it grinding, signifies you will hardly overthrow some evil pitted against your interest.[cycling]"
"a"	"cooking stove"	"[one of]To see a cooking stove in a dream, denotes that much unpleasantness will be modified by your timely interference.[or]For a young woman to dream of using a cooking stove, foretells she will be too hasty in showing her appreciation of the attention of some person and thereby lose a closer friendship.[cycling]"
"a"	"crucifix"	"[one of]To see a crucifix in a dream, is a warning of distress approaching, which will involve others beside yourself.[or]To kiss one, foretells that trouble will be accepted by you with resignation.[or]For a young woman to possess one, foretells she will observe modesty and kindness in her deportment, and thus win the love of others and better her fortune.[cycling]"
"a"	"cupboard"	"[one of]To see a cupboard in your dream, is significant of pleasure and comfort, or penury and distress, according as the cupboard is clean and full of shining ware, or empty and dirty.[cycling]"
"a"	"cuspidor"	"[one of]To see a cuspidor in a dream, signifies that an unworthy attachment will be formed by you, and that your work will be neglected.[or]To spit in one, foretells that reflections wil{sic} be cast upon your conduct.[cycling]"
"a"	"drama"	"[one of]To see a drama, signifies pleasant reunions with distant friends.[or]To be bored with the performance of a drama, you will be forced to accept an uncongenial companion at some entertainment or secret affair.[or]To write one, portends that you will be plunged into distress and debt, to be extricated as if by a miracle.[cycling]"
"a"	"fan"	"[one of]To see a fan in your dreams, denotes pleasant news and surprises are awaiting you in the near future.[or]For a young woman to dream of fanning herself, or that some one is fanning her, gives promise of a new and pleasing acquaintances; if she loses an old fan, she will find that a warm friend is becoming interested in other women.[cycling]"
"a"	"fire-engine"	"[one of]To see a fire-engine, denotes worry under extraordinary circumstances, but which will result in good fortune.[or]To see one broken down, foretells accident or serious loss.[or]For a young woman to ride on one, denotes she will engage in some unladylike and obnoxious affair.[cycling]"
"a"	"fireman"	"[one of]To see a fireman in your dreams, signifies the constancy of your friends.[or]For a young woman to see a fireman crippled, or meet with an accident otherwise, implies grave danger is threatening a close friend.[cycling]"
"a"	"fly-trap"	"[one of]To see a fly-trap in a dream, is signal of malicious designing against you.[or]To see one full of flies, denotes that small embarrassments will ward off greater ones.[cycling]"
"a"	"brood"	"[one of]To see a fowl with her brood, denotes that, if you are a woman, your cares will be varied and irksome.[or]Many children will be in your care, and some of them will prove wayward and unruly.[or]Brood, to others, denotes accumulation of wealth.[cycling]"
"a"	"funeral"	"[one of]To see a funeral, denotes an unhappy marriage and sickly offspring.[or]To dream of the funeral of a stranger, denotes unexpected worries.[or]To see the funeral of your child, may denote the health of your family, but very grave disappointments may follow from a friendly source.[or]To attend a funeral in black, foretells an early widowhood.[or]To dream of the funeral of any relative, denotes nervous troubles and family worries.[cycling]"
"a"	"garden"	"[one of]To see a garden in your dreams, filled with evergreen and flowers, denotes great peace of mind and comfort.[or]To see vegetables, denotes misery or loss of fortune and calumny.[or]To females, this dream foretells that they will be famous, or exceedingly happy in domestic circles.[or]To dream of walking with one's lover through a garden where flowering shrubs and plants abound, indicates unalloyed happiness and independent means.[cycling]"
"a"	"glass house"	"[one of]To see a glass house, foretells you are likely to be injured by listening to flattery.[or]For a young woman to dream that she is living in a glass house, her coming trouble and threatened loss of reputation is emphasized.[cycling]"
"a"	"grotto"	"[one of]To see a grotto in your dreams, is a sign of incomplete and inconstant friendships.[or]Change from comfortable and simple plenty will make showy poverty unbearable.[cycling]"
"a"	"haggard"	"[one of]To see a haggard face in your dreams, denotes misfortune and defeat in love matters.[or]To see your own face haggard and distressed, denotes trouble over female affairs, which may render you unable to meet business engagements in a healthy manner.[cycling]"
"a"	"jackdaw"	"[one of]To see a jackdaw, denotes ill health and quarrels.[or]To catch one, you will outwit enemies.[or]To kill one, you will come into possession of disputed property.[cycling]"
"a"	"jailer"	"[one of]To see a jailer, denotes that treachery will embarrass your interests and evil women will enthrall you.[or]To see a mob attempting to break open a jail, is a forerunner of evil, and desperate measures will be used to extort money and bounties from you.[cycling]"
"a"	"kangaroo"	"[one of]To see a kangaroo in your dreams, you will outwit a wily enemy who seeks to place you in an unfavorable position before the public and the person you are striving to win.[or]If a kangaroo attacks you, your reputation will be in jeopardy.[or]If you kill one, you will succeed in spite of enemies and obstacles.[or]To see a kangaroo's hide, denotes that you are in a fair way to success.[cycling]"
"a"	"knapsack"	"[one of]To see a knapsack while dreaming, denotes you will find your greatest pleasure away from the associations of friends.[or]For a woman to see an old dilapidated one, means poverty and disagreeableness for her.[cycling]"
"a"	"ladle"	"[one of]To see a ladle in your dreams, denotes you will be fortunate in the selection of a companion.[or]Children will prove sources of happiness.[or]If the ladle is broken or uncleanly, you will have a grievous loss.[cycling]"
"a"	"lamp-post"	"[one of]To see a lamp-post in your dreams, some stranger will prove your staunchiest friend in time of pressing need.[or]To fall against a lamp-post, you will have deception to overcome, or enemies will ensnare you.[or]To see a lamp-post across your path, you will have much adversity in your life.[cycling]"
"a"	"hanging"	"[one of]To see a large concourse of people gathering at a hanging, denotes that many enemies will club together to try to demolish your position in their midst.[cycling]"
"a"	"fleet"	"[one of]To see a large fleet moving rapidly in your dreams, denotes a hasty change in the business world.[or]Where dulness oppressed, brisk workings of commercial wheels will go forward and some rumors of foreign wars will be heard.[cycling]"
"a"	"paunch"	"[one of]To see a large paunch, denotes wealth and the total absence of refinement.[or]To see a shriveled paunch, foretells illness and reverses.[cycling]"
"a"	"letter-file"	"[one of]To see a letter-file in your dreams, is significant of important news, which will cause you an irksome journey.[or]For a woman, this dream implies distressful news and unfaithful friends.[cycling]"
"a"	"lightning-rod"	"[one of]To see a lightning-rod, denotes that threatened destruction to some cherished work will confront you.[or]To see one change into a serpent, foretells enemies will succeed in their schemes against you.[or]If the lightning strikes one, there will be an accident or sudden news to give you sorrow.[or]If you are having one put up, it is a warning to beware how you begin a new enterprise, as you will likely be overtaken by disappointment.[or]To have them taken down, you will change your plans and thereby further your interests.[or]To see many lightning rods, indicates a variety of misfortunes.[cycling]"
"a"	"bridge"	"[one of]To see a long bridge dilapidated, and mysteriously winding into darkness, profound melancholy over the loss of dearest possessions and dismal situations will fall upon you.[or]To the young and those in love, disappointment in the heart's fondest hopes, as the loved one will fall below your ideal.[or]To cross a bridge safely, a final surmounting of difficulties, though the means seem hardly safe to use.[or]Any obstacle or delay denotes disaster.[or]To see a bridge give way before you, beware of treachery and false admirers.[or]Affluence comes with clear waters.[or]Sorrowful returns of best efforts are experienced after looking upon or coming in contact with muddy or turbid water in dreams.[cycling]"
"a"	"madstone"	"[one of]To see a madstone applied to a wound from the fangs of some mad animal, denotes that you will endeavor, to the limits of your energy, to shield self from the machinations of enemies, which will soon envelop you with the pall of dishonorable defeat.[cycling]"
"a"	"midwife"	"[one of]To see a midwife denotes revealing of secrets; to the sick it is death.[cycling]"
"a"	"midwife"	"[one of]To see a midwife in your dreams, signifies unfortunate sickness with a narrow escape from death.[or]For a young woman to dream of such a person, foretells that distress and calumny will attend her.[cycling]"
"a"	"millet"	"[one of]To see a miller in your dreams, signifies your surroundings will grow more hopeful.[or]For a woman to dream of a miller failing in an attempt to start his mill, foretells she will be disappointed in her lover's wealth, as she will think him in comfortable circumstances.[cycling]"
"a"	"monster"	"[one of]To see a monster in the sea is not good; but out of the sea every fish and great monster is good.[cycling]"
"a"	"moth"	"[one of]To see a moth in a dream, small worries will lash you into hurried contracts, which will prove unsatisfactory.[or]Quarrels of a domestic nature are prognosticated.[cycling]"
"a"	"mouse-trap"	"[one of]To see a mouse-trap in dreams, signifies your need to be careful of character, as wary persons have designs upon you.[or]To see it full of mice, you will likely fall into the hands of enemies.[or]To set a trap, you will artfully devise means to overcome your opponents.[cycling]"
"a"	"mulatto"	"[one of]To see a mulatto in sleep brings good luck; a female mulatto dangerous sickness.[cycling]"
"a"	"page"	"[one of]To see a page, denotes that you will contract a hasty union with one unsuited to you.[or]You will fail to control your romantic impulses.[or]If a young woman dreams she acts as a page, it denotes that she is likely to participate in some foolish escapade.[cycling]"
"a"	"pagoda"	"[one of]To see a pagoda in your dreams, denotes that you will soon go on a long desired journey.[or]If a young woman finds herself in a pagoda with her sweetheart, many unforeseen events will transpire before her union is legalized.[or]An empty one, warns her of separation from her lover.[cycling]"
"a"	"panther"	"[one of]To see a panther and experience fright, denotes that contracts in love or business may be canceled unexpectedly, owing to adverse influences working against your honor.[or]But killing, or over-powering it, you will experience joy and be successful in your undertakings.[or]Your surroundings will take on fair prospects.[or]If one menaces you by its presence, you will have disappointments in business.[or]Other people will likely recede from their promises to you.[or]If you hear the voice of a panther, and experience terror or fright, you will have unfavorable news, coming in the way of reducing profit or gain, and you may have social discord; no fright forebodes less evil.[or]A panther, like the cat, seen in a dream, portends evil to the dreamer, unless he kills it.[cycling]"
"a"	"roof corner"	"[one of]To see a person dressed in mourning sitting on a roof corner, foretells there will be unexpected and dismal failures in your business.[or]Affairs will appear unfavorable in love.[cycling]"
"a"	"head"	"[one of]To see a person's head in your dream, and it is well-shaped and prominent, you will meet persons of power and vast influence who will lend you aid in enterprises of importance.[or]If you dream of your own head, you are threatened with nervous or brain trouble.[or]To see a head severed from its trunk, and bloody, you will meet sickening disappointments, and the overthrow of your dearest hopes and anticipations.[or]To see yourself with two or more heads, foretells phenomenal and rapid rise in life, but the probabilities are that the rise will not be stable.[or]To dream that your head aches, denotes that you will be oppressed with worry.[or]To dream of a swollen head, you will have more good than bad in your life.[or]To dream of a child's head, there will be much pleasure ill store for you and signal financial success.[or]To dream of the head of a beast, denotes that the nature of your desires will run on a low plane, and only material pleasures will concern you.[or]To wash your head, you will be sought after by prominent people for your judgment and good counsel.[cycling]"
"a"	"pine tree"	"[one of]To see a pine tree in a dream, foretells unvarying success in any undertaking.[or]Dead pine, for a woman, represents bereavement and cares.[cycling]"
"a"	"pond"	"[one of]To see a pond in your dream, denotes that events will bring no emotion, and fortune will retain a placid outlook.[or]If the pond is muddy, you will have domestic quarrels.[or]Puddle and kindred words.[cycling]"
"a"	"poor-house"	"[one of]To see a poor-house in your dream, denotes you have unfaithful friends, who will care for you only as they can use your money and belongings.[cycling]"
"a"	"porcupine"	"[one of]To see a porcupine in your dreams, denotes that you will disapprove any new enterprise and repel new friendships with coldness.[or]For a young woman to dream of a porcupine, portends that she will fear her lover.[or]To see a dead one, signifies your abolishment of ill feelings and possessions.[cycling]"
"a"	"porpoise"	"[one of]To see a porpoise in your dreams, denotes enemies are thrusting your interest aside, through your own inability to keep people interested in you.[cycling]"
"a"	"potter's field"	"[one of]To see a potter's field in your dreams, denotes you will have poverty and misery to distress you.[or]For a young woman to walk through a potter's field with her lover, she will give up the one she loves in the hope of mercenary gain.[cycling]"
"a"	"printer"	"[one of]To see a printer in your dreams, is a warning of poverty, if you neglect to practice economy and cultivate energy.[or]For a woman to dream that her lover or associate is a printer, foretells she will fail to please her parents in the selection of a close friend.[cycling]"
"a"	"prize fight"	"[one of]To see a prize fight in your dreams, denotes your affairs will give you trouble in controlling them.[cycling]"
"a"	"pump"	"[one of]To see a pump in a dream, denotes that energy and faithfulness to business will produce desired riches, good health also is usually betokened by this dream.[or]To see a broken pump, signifies that the means of advancing in life will be absorbed by family cares.[or]To the married and the unmarried, it intimates blasted energies.[or]If you work a pump, your life will be filled with pleasure and profitable undertakings.[cycling]"
"a"	"quack doctor"	"[one of]To see a quack doctor in your dreams, denotes you will be alarmed over some illness and its improper treatment.[cycling]"
"a"	"rainbow"	"[one of]To see a rainbow in a dream, is prognostic of unusual happenings.[or]Affairs will assume a more promising countenance, and crops will give promise of a plentiful yield.[or]For lovers to see the rainbow, is an omen of much happiness from their union.[or]To see the rainbow hanging low over green trees, signifies unconditional success in any undertaking.[cycling]"
"a"	"refrigerator"	"[one of]To see a refrigerator in your dreams, portends that your selfishness will offend and injure some one who endeavors to gain an honest livelihood.[or]To put ice in one, brings the dreamer into disfavor.[cycling]"
"a"	"rocket"	"[one of]To see a rocket ascending in your dream, foretells sudden and unexpected elevation, successful wooing, and faithful keeping of the marriage vows.[or]To see them falling, unhappy unions may be expected.[cycling]"
"a"	"rosebush"	"[one of]To see a rosebush in foliage but no blossoms, denotes prosperous circumstances are enclosing you.[or]To see a dead rosebush, foretells misfortune and sickness for you or relatives.[cycling]"
"a"	"shoemaker"	"[one of]To see a shoemaker in your dream, warns you that indications are unfavorable to your advancement.[or]For a woman to dream that her husband or lover is a shoemaker, foretells competency will be hers; her wishes will be gratified.[cycling]"
"a"	"shovel"	"[one of]To see a shovel in a dream, signifies laborious but withal pleasant work will be undertaken.[or]A broken or old one, implies frustration of hopes.[cycling]"
"a"	"sleigh"	"[one of]To see a sleigh in your dreams, foretells you will fail in some love adventure, and incur the displeasure of a friend.[or]To ride in one, foretells injudicious engagements will be entered into by you.[cycling]"
"a"	"socialist"	"[one of]To see a socialist in your dreams, your unenvied position among friends and acquaintances is predicted.[or]Your affairs will be neglected for other imaginary duties.[cycling]"
"a"	"steeple"	"[one of]To see a steeple rising from a church, is a harbinger of sickness and reverses.[or]A broken one, points to death in your circle, or friends.[or]To climb a steeple, foretells that you will have serious difficulties, but will surmount them.[or]To fall from one, denotes losses in trade and ill health.[cycling]"
"a"	"swan"	"[one of]To see a swan in your dream, signifies joy, revealing of secrets and health to the dreamer; but if it sings, it foretells death.[cycling]"
"a"	"tarantula"	"[one of]To see a tarantula in your dream, signifies enemies are about to overwhelm you with loss.[or]To kill one, denotes you will be successful after much ill-luck.[cycling]"
"a"	"train"	"[one of]To see a train of cars moving in your dreams, you will soon have cause to make a journey.[or]To be on a train and it appears to move smoothly along, though there is no track, denotes that you will be much worried over some affair which will eventually prove a source of profit to you.[or]To see freight trains in your dreams, is an omen of changes which will tend to your elevation.[or]To find yourself, in a dream, on top of a sleeping car, denotes you will make a journey with an unpleasant companion, with whom you will spend money and time that could be used in a more profitable and congenial way, and whom you will seek to avoid.[cycling]"
"a"	"traitor"	"[one of]To see a traitor in your dream, foretells you will have enemies working to despoil you.[or]If some one calls you one, or if you imagine yourself one, there will be unfavorable prospects of pleasure for you.[cycling]"
"an"	"uniform"	"[one of]To see a uniform in your dream, denotes that you will have influential friends to aid you in obtaining your desires.[or]For a young woman to dream that she wears a uniform, foretells that she will luckily confer her favors upon a man who appreciated them, and returns love for passion.[or]If she discards it, she will be in danger of public scandal by her notorious love for adventure.[or]To see people arrayed in strange uniforms, foretells the disruption of friendly relations with some other.[or]Power by your own government.[or]This may also apply to families or friends.[or]To see a friend or relative looking sad while dressed in uniform, or as a soldier, predicts ill fortune or continued absence.[cycling]"
"an"	"united states mail box"	"[one of]To see a United.[or]States mail box, in a dream, denotes that you are about to enter into transactions which will be claimed to be illegal.[or]To put a letter in one, denotes you will be held responsible for some irregularity of another.[cycling]"
"a"	"vat"	"[one of]To see a vat in your dreams, foretells anguish and suffering from the hands of cruel persons, into which you have unwittingly fallen.[cycling]"
"a"	"volcano"	"[one of]To see a volcano in your dreams, signifies that you will be in violent disputes, which threaten your reputation as a fair dealing and honest citizen.[or]For a young woman, it means that her selfishness and greed will lead her into intricate adventures.[cycling]"
"a"	"wagtail"	"[one of]To see a wagtail in a dream, foretells that you will be the victim of unpleasant gossip, and your affairs will develop unmistakable loss.[cycling]"
"a"	"walking stick"	"[one of]To see a walking stick in a dream, foretells you will enter into contracts without proper deliberation, and will consequently suffer reverses.[or]If you use one in walking, you will be dependent upon the advice of others.[or]To admire handsome ones, you will entrust your interest to others, but they will be faithful.[cycling]"
"a"	"washboard"	"[one of]To see a washboard in your dreams, is indicative of embarrassment.[or]If you see a woman using one, it predicts that you will let women rob you of energy and fortune.[or]A broken one, portends that you will come to grief and disgraceful deeds through fast living.[cycling]"
"a"	"weasel"	"[one of]To see a weasel bent on a marauding expedition in your dreams, warns you to beware of the friendships of former enemies, as they will devour you at an unseemly time.[or]If you destroy them, you will succeed in foiling deep schemes laid for your defeat.[cycling]"
"an"	"ox"	"[one of]To see a well-fed ox, signifies that you will become a leading person in your community, and receive much adulation from women.[or]To see fat oxen in green pastures, signifies fortune, and your rise to positions beyond your expectations.[or]If they are lean, your fortune will dwindle, and your friends will fall away from you.[or]If you see oxen well-matched and yoked, it betokens a happy and wealthy marriage, or that you are already joined to your true mate.[or]To see a dead ox, is a sign of bereavement.[or]If they are drinking from a clear pond, or stream, you will possess some long-desired estate, perhaps it will be in the form of a lovely and devoted woman.[or]If a woman she will win the embraces of her lover.[cycling]"
"a"	"wild man"	"[one of]To see a wild man in your dream, denotes that enemies will openly oppose you in your enterprises.[or]To think you are one foretells you will be unlucky in following out your designs.[cycling]"
"a"	"windmill"	"[one of]To see a windmill in operation in your dreams, foretells abundant accumulation of fortune and marked contentment.[or]To see one broken or idle, signifies adversity coming unawares.[cycling]"
"a"	"yacht"	"[one of]To see a yacht in a dream, denotes happy recreation away from business and troublesome encumbrances.[or]A stranded one, represents miscarriage of entertaining engagements.[cycling]"
"a"	"yellow bird"	"[one of]To see a yellow bird flitting about in your dreams, foretells that some great event will cast a sickening fear of the future around you.[or]To see it sick or dead, foretells that you will suffer for another's wild folly.[cycling]"
"an"	"agate"	"[one of]To see agate in a dream, signifies a slight advancement in business affairs.[cycling]"
"an"	"abbey"	"[one of]To see an abbey in ruins, foretells that your hopes and schemes will fall into ignoble incompletion.[or]To dream that a priest bars your entrance into an abbey, denotes that you will be saved from a ruinous state by enemies mistaking your embarrassment for progress.[or]For a young woman to get into an abbey, foretells her violent illness.[or]If she converses with a priest in an abbey, she will incur the censure of true friends for indiscretion.[cycling]"
"an"	"attorney"	"[one of]To see an attorney at the bar, denotes that disputes of a serious nature will arise between parties interested in worldly things.[or]Enemies are stealing upon you with false claims.[or]If you see an attorney defending you, your friends will assist you in coming trouble, but they will cause you more worry than enemies.[cycling]"
"a"	"bird's nest"	"[one of]To see an empty bird's nest, denotes gloom and a dull outlook for business.[or]With eggs in the nest, good results will follow all engagements.[or]If young ones are in the nest, it denotes successful journeys and satisfactory dealings.[or]If they are lonely and deserted, sorrow, and folly of yours will cause you anxiety.[cycling]"
"an"	"engineer"	"[one of]To see an engineer, forebodes weary journeys but joyful reunions.[cycling]"
"a"	"beggar"	"[one of]To see an old, decrepit beggar, is a sign of bad management, and unless you are economical, you will lose much property.[or]Scandalous reports will prove detrimental to your fame.[or]To give to a beggar, denotes dissatisfaction with present surroundings.[or]To dream that you refuse to give to a beggar is altogether bad.[cycling]"
"an"	"organist"	"[one of]To see an organist in your dreams, denotes a friend will cause you much inconvenience from hasty action.[or]For a young woman to dream that she is an organist, foretells she will be so exacting in her love that she will be threatened with desertion.[cycling]"
"an"	"ulcer"	"[one of]To see an ulcer in your dream, signifies loss of friends and removal from loved ones.[or]Affairs will remain unsatisfactory.[or]To dream that you have ulcers, denotes that you will become unpopular with your friends by giving yourself up to foolish pleasures.[cycling]"
"a"	"storm"	"[one of]To see and hear a storm approaching, foretells continued sickness, unfavorable business, and separation from friends, which will cause added distress.[or]If the storm passes, your affliction will not be so heavy.[or]Hurricane and.[cycling]"
"a"	"scaldhead"	"[one of]To see any one with a scaldhead in your dreams, there will be uneasiness felt over the sickness or absence of some one near to you.[or]If you dream that your own head is thus afflicted, you are in danger of personal illness or accidents.[cycling]"
"a"	"form"	"[one of]To see anything ill formed, denotes disappointment.[or]To have a beautiful form, denotes favorable conditions to health and business.[cycling]"
"an"	"augur"	"[one of]To see augurs in your dreams, is a forecast of labor and toil.[cycling]"
"a"	"bantam"	"[one of]To see bantam chickens in your dream, denotes your fortune will be small, yet you will enjoy contentment.[or]If they appear sickly, or exposed to wintry storms, your interests will be impaired.[cycling]"
"a"	"baseball"	"[one of]To see baseball in your dream, denotes you will be easily contented, and your cheerfulness will make you a popular companion.[or]For a young woman to dream that she is playing baseball, means much pleasure for her, but no real profit or comfort.[cycling]"
"a"	"calm"	"[one of]To see calm seas, denotes successful ending of doubtful undertaking.[or]To feel calm and happy, is a sign of a long and well-spent life and a vigorous old age.[cycling]"
"a"	"cane"	"[one of]To see cane growing in your dream, foretells favorable advancement will be made toward fortune.[or]To see it cut, denotes absolute failure in all undertakings.[cycling]"
"a"	"carpenter"	"[one of]To see carpenters at their labor, foretells you will engage in honest endeavors to raise your fortune, to the exclusion of selfish pastime or so-called recreation.[cycling]"
"a"	"grazing"	"[one of]To see cattle grazing denotes that you will be fortunate; to the lover it is a sign he will marry a rich wife and to the merchant it foretells a great increase of business.[cycling]"
"a"	"chaff"	"[one of]To see chaff, denotes an empty and fruitless undertaking and ill health causing much anxiety.[or]Women dreaming of piles of chaff, portends many hours spent in useless and degrading gossip, bringing them into notoriety and causing them to lose husbands who would have maintained them without work on their part.[cycling]"
"a"	"coke oven"	"[one of]To see coke ovens burning, foretells some unexpected good fortune will result from failure in some enterprise.[cycling]"
"a"	"cornmeal"	"[one of]To see cornmeal, foretells the consummation of ardent wishes.[or]To eat it made into bread, denotes that you will unwittingly throw obstructions in the way of your own advancement.[cycling]"
"a"	"cotton cloth"	"[one of]To see cotton cloth in a dream, denotes easy circumstances.[or]No great changes follow this dream.[or]For a young woman to dream of weaving cotton cloth, denotes that she will have a thrifty and enterprising husband.[or]To the married it denotes a pleasant yet a humble abode.[cycling]"
"a"	"dahlia"	"[one of]To see dahlias in a dream, if they are fresh and bright, signifies good fortune to the dreamer.[cycling]"
"a"	"poultry"	"[one of]To see dressed poultry in a dream, foretells extravagant habits will reduce your security in money matters.[or]For a young woman to dream that she is chasing live poultry, foretells she will devote valuable time to frivolous pleasure.[cycling]"
"a"	"dynamite"	"[one of]To see dynamite in a dream, is a sign of approaching change and the expanding of one's affairs.[or]To be frightened by it, indicates that a secret enemy is at work against you, and if you are not careful of your conduct he will disclose himself at an unexpected and helpless moment.[cycling]"
"an"	"embalming"	"[one of]To see embalming in process, foretells altered positions in social life and threatened poverty.[or]To dream that you are looking at yourself embalmed, omens unfortunate friendships for you, which will force you into lower classes than you are accustomed to move in.[cycling]"
"a"	"flax"	"[one of]To see flax in a dream, prosperous enterprises are denoted.[cycling]"
"a"	"gleaning"	"[one of]To see gleaners at work at harvest time, denotes prosperous business, and, to the farmer, a bountiful yield of crops.[or]If you are working with the gleaners, you will come into an estate, after some trouble in establishing rights.[or]For a woman, this dream foretells marriage with a stranger.[cycling]"
"a"	"gravel"	"[one of]To see heaps of clean gravel denotes that you will soon go a journey by land which will be a pleasant or profitable one.[cycling]"
"a"	"garbage"	"[one of]To see heaps of garbage in your dreams, indicates thoughts of social scandal and unfavorable business of every character.[or]For females this dream is ominous of disparagement and desertion by lovers.[cycling]"
"a"	"hemp seed"	"[one of]To see hemp seed in dreams, denotes the near approach of a deep and continued friendship.[or]To the business man, is shown favorable opportunity for money-making.[cycling]"
"an"	"anvil"	"[one of]To see hot iron with sparks flying, is significant of a pleasing work; to the farmer, an abundant crop; favorable indeed to women.[or]Cold, or small, favors may be expected from those in power.[or]The means of success is in your power, but in order to obtain it you will have to labor under difficulty.[or]If the anvil is broken, it foretells that you have, through your own neglect, thrown away promising opportunities that cannot be recalled.[cycling]"
"a"	"bracelet"	"[one of]To see in your dreams a bracelet encircling your arm, the gift of lover or friend, is assurance of an early marriage and a happy union.[or]If a young woman lose her bracelet she will meet with sundry losses and vexations.[or]To find one, good property will come into her possession.[cycling]"
"an"	"actor"	"[one of]To see in your dreams an actress, denotes that your present state will be one of unbroken pleasure and favor.[or]To see one in distress, you will gladly contribute your means and influence to raise a friend from misfortune and indebtedness.[or]If you think yourself one, you will have to work for subsistence, but your labors will be pleasantly attended.[or]If you dream of being in love with one, your inclination and talent will be allied with pleasure and opposed to downright toil.[or]To see a dead actor, or actress, your good luck will be overwhelmed in violent and insubordinate misery.[or]To see them wandering and penniless, foretells that your affairs will undergo a change from promise to threatenings of failure.[or]To those enjoying domestic comforts, it is a warning of revolution and faithless vows.[or]For a young woman to dream that she is engaged to an actor, or about to marry one, foretells that her fancy will bring remorse after the glamor of pleasure has vanished.[or]If a man dreams that he is sporting with an actress, it foretells that private broils with his wife, or sweetheart, will make him more misery than enjoyment.[cycling]"
"a"	"blackboard"	"[one of]To see in your dreams writing in white chalk on a blackboard, denotes ill tidings of some person prostrated with some severe malady, or your financial security will be swayed by the panicky condition of commerce.[cycling]"
"an"	"indigo"	"[one of]To see indigo in a dream, denotes you will deceive friendly persons in order to cheat them out of their be longings.[or]To see indigo water, foretells you will be involved in an ugly love affair.[cycling]"
"an"	"ink"	"[one of]To see ink spilled over one's clothing, many small and spiteful meannesses will be wrought you through envy.[or]If a young woman sees ink, she will be slandered by a rival.[or]To dream that you have ink on your fingers, you will be jealous and seek to injure some one unless you exercise your better nature.[or]If it is red ink, you will be involved in a serious trouble.[or]To dream that you make ink, you will engage in a low and debasing business, and you will fall into disreputable associations.[or]To see bottles of ink in your dreams, indicates enemies and unsuccessful interests.[cycling]"
"a"	"kettle"	"[one of]To see kettles in your dream, denotes great and laborious work before you.[or]To see a kettle of boiling water, your struggles will soon end and a change will come to you.[or]To see a broken kettle, denotes failure after a mighty effort to work out a path to success.[or]For a young woman to dream of handling dark kettles, foretells disappointment in love and marriage; but a light-colored kettle brings to her absolute freedom from care, and her husband will be handsome and worthy.[cycling]"
"a"	"krishna"	"[one of]To see krishna in your dreams, denotes that your greatest joy will be in pursuit of occult knowledge, and you will school yourself to the taunts of friends, and cultivate a philosophical bearing toward life and sorrow.[cycling]"
"a"	"lamp"	"[one of]To see lamps filled with oil, denotes the demonstration of business activity, from which you will receive gratifying results.[or]Empty lamps, represent depression and despondency.[or]To see lighted lamps burning with a clear flame, indicates merited rise in fortune and domestic bliss.[or]If they give out a dull, misty radiance, you will have jealousy and envy, coupled with suspicion, to combat, in which you will be much pleased to find the right person to attack.[or]To drop a lighted lamp, your plans and hopes will abruptly turn into failure.[or]If it explodes, former friends will unite with enemies in damaging your interests.[or]Broken lamps, indicate the death of relatives or friends.[or]To light a lamp, denotes that you will soon make a change in your affairs, which will lead to profit.[or]To carry a lamp, portends that you will be independent and self-sustaining, preferring your own convictions above others.[or]If the light fails, you will meet with unfortunate conclusions, and perhaps the death of friends or relatives.[or]If you are much affrighted, and throw a bewildering light from your window, enemies will ensnare you with professions of friendship and interest in your achievements.[or]To ignite your apparel from a lamp, you will sustain humiliation from sources from which you expected encouragement and sympathy, and your business will not be fraught with much good.[cycling]"
"a"	"wheat"	"[one of]To see large fields of growing wheat in your dreams, denotes that your interest will take on encouraging prospects.[or]If the wheat is ripe, your fortune will be assured and love will be your joyous companion.[or]To see large clear grains of wheat running through the thresher, foretells that prosperity has opened her portals to the fullest for you.[or]To see it in sacks or barrels, your determination to reach the apex of success is soon to be crowned with victory and your love matters will be firmly grounded.[or]If your granary is not well covered and you see its contents getting wet, foretells that while you have amassed a fortune, you have not secured your rights and you will see your interests diminishing by the hand of enemies.[or]If you rub wheat from the head into your hand and eat it, you will labor hard for success and will obtain and make sure of your rights.[or]To dream that you climb a steep hill covered with wheat and think you are pulling yourself up by the stalks of wheat, denotes you will enjoy great prosperity and thus be able to distinguish yourself in any chosen pursuit.[cycling]"
"a"	"lark"	"[one of]To see larks flying, denotes high aims and purposes through the attainment of which you will throw off selfishness and cultivate kindly graces of mind.[or]To hear them singing as they fly, you will be very happy in a new change of abode, and business will flourish.[or]To see them fall to the earth and singing as they fall, despairing gloom will overtake you in pleasure's bewildering delights.[or]A wounded or dead lark, portends sadness or death.[or]To kill a lark, portends injury to innocence through wantonness.[or]If they fly around and light on you,.[or]Fortune will turn her promising countenance towards you.[or]To catch them in traps, you will win honor and love easily.[or]To see them eating, denotes a plentiful harvest.[cycling]"
"a"	"lettuce"	"[one of]To see lettuce growing green and thrifty, denotes that you will enjoy some greatly desired good, after an unimportant embarrassment.[or]If you eat lettuce, illness will separate you from your lover or companion, or perhaps it may be petty jealousy.[or]For a woman to dream of sowing lettuce, portends she will be the cause of her own early sickness or death.[or]To gather it, denotes your superabundant sensitiveness, and that your jealous disposition will cause you unmitigated distress and pain.[or]To buy lettuce, denotes that you will court your own downfall.[cycling]"
"a"	"life-insurance man"	"[one of]To see life-insurance men in a dream, means that you are soon to meet a stranger who will contribute to your business interests, and change in your home life is foreshadowed, as interests will be mutual.[or]If they appear distorted or unnatural, the dream is more unfortunate than good.[cycling]"
"a"	"linen"	"[one of]To see linen in your dream, augurs prosperity and enjoyment.[or]If a person appears to you dressed in linen garments, you will shortly be the recipient of joyful tidings in the nature of an inheritance.[or]If you are apparelled in clean, fine linen, your fortune and fullest enjoyment in life is assured.[or]If it be soiled, sorrow and ill luck will be met with occasionally, mingled with the good in your life.[cycling]"
"a"	"linseed oil"	"[one of]To see linseed oil in your dreams, denotes your impetuous extravagance will be checked by the kindly interference of a friend.[cycling]"
"an"	"apparel"	"[one of]To see many colored apparel, foretells swift changes, and intermingling of good and bad influences in your future.[or]To dream of misfitting apparel, intimates crosses in your affections, and that you are likely to make a mistake in some enterprise.[or]To see old or young in appropriate apparel, denotes that you will undertake some engagement for which you will have no liking, and which will give rise to many cares.[or]For a woman to dream that she is displeased with her apparel, foretells that she will find many vexatious rivalries in her quest for social distinction.[or]To admire the apparel of others, denotes that she will have jealous fears of her friends.[or]To dream of the loss of any article of apparel, denotes disturbances in your business and love affairs.[or]For a young woman to dream of being attired in a guazy black costume, foretells she will undergo chastening sorrow and disappointment.[or]For a young woman to dream that she meets another attired in a crimson dress with a crepe mourning veil over her face, foretells she will be outrivaled by one she hardly considers her equal, and bitter disappointment will sour her against women generally.[or]The dreamer interpreting the dream of apparel should be careful to note whether the objects are looking natural.[or]If the faces are distorted and the light unearthly, though the colors are bright, beware; the miscarriage of some worthy plan will work you harm.[or]There are few dreams in which the element of evil is wanting, as there are few enterprises in waking life from which the element of chance is obviated.[cycling]"
"a"	"morocco"	"[one of]To see morocco in your dreams, foretells that you will receive substantial aid from unexpected sources.[or]Your love will be rewarded by faithfulness.[cycling]"
"a"	"mosquito"	"[one of]To see mosquitoes in your dreams, you will strive in vain to remain impregnable to the sly attacks of secret enemies.[or]Your patience and fortune will both suffer from these designing persons.[or]If you kill mosquitoes, you will eventually overcome obstacles and enjoy fortune and domestic bliss.[cycling]"
"a"	"murder"	"[one of]To see murder committed in your dreams, foretells much sorrow arising from the misdeeds of others.[or]Affair will assume dulness.[or]Violent deaths will come under your notice.[or]If you commit murder, it signifies that you are engaging in some dishonorable adventure, which will leave a stigma upon your name.[or]To dream that you are murdered, foretells that enemies are secretly working to overthrow you.[or]Killing and kindred words.[cycling]"
"a"	"mushroom"	"[one of]To see mushrooms in your dreams, denotes unhealthy desires, and unwise haste in amassing wealth, as it may vanish in law suits and vain pleasures.[or]To eat them, signifies humiliation and disgraceful love.[or]For a young woman to dream of them, foretells her defiance of propriety in her pursuit of foolish pleasures.[cycling]"
"a"	"mustard"	"[one of]To see mustard growing, and green, foretells success and joy to the farmer, and to the seafaring it prognosticates wealth.[or]To eat mustard seed and feel the burning in your mouth, denotes that you will repent bitterly some hasty action, which has caused you to suffer.[or]To dream of eating green mustard cooked, indicates the lavish waste of fortune, and mental strain.[or]For a young woman to eat newly grown mustard, foretells that she will sacrifice wealth for personal desires.[cycling]"
"a"	"myrrh"	"[one of]To see myrrh in a dream, signifies your investments will give satisfaction.[or]For a young woman to dream of myrrh, brings a pleasing surprise to her in the way of a new and wealthy acquaintance.[cycling]"
"a"	"myrtle"	"[one of]To see myrtle in foliage and bloom in your dream, denotes that your desires will be gratified, and pleasures will possess you.[or]For a young woman to dream of wearing a sprig of myrtle, foretells to her an early marriage with a well-to do and intelligent man.[or]To see it withered, denotes that she will miss happiness through careless conduct.[cycling]"
"a"	"painting"	"[one of]To see newly painted houses in dreams, foretells that you will succeed with some devised plan.[or]To have paint on your clothing, you will be made unhappy by the thoughtless criticisms of others.[or]To dream that you use the brush yourself, denotes that you will be well pleased with your present occupation.[or]To dream of seeing beautiful paintings, denotes that friends will assume false positions towards you, and you will find that pleasure is illusive.[or]For a young woman to dream of painting a picture, she will be deceived in her lover, as he will transfer his love to another.[cycling]"
"a"	"nymph"	"[one of]To see nymphs bathing in clear water, denotes that passionate desires will find an ecstatic realization.[or]Convivial entertainments will enchant you.[or]To see them out of their sphere, denotes disappointment with the world.[or]For a young woman to see them bathing, denotes that she will have great favor and pleasure, but they will not rest strictly within the moral code.[or]To dream that she impersonates a nymph, is a sign that she is using her attractions for selfish purposes, and thus the undoing of men.[cycling]"
"an"	"omelet"	"[one of]To see omelet being served in your dream, warns you of flattery and deceit, which is about to be used against you.[or]To eat it, shows that you will be imposed upon by some one seemingly worthy of your confidence.[cycling]"
"a"	"cask"	"[one of]To see one filled, denotes prosperous times and feastings.[or]If empty, your life will be void of any joy or consolation from outward influences.[cycling]"
"a"	"bed-chamber"	"[one of]To see one newly furnished, a happy change for the dreamer.[or]Journeys to distant places, and pleasant companions.[cycling]"
"an"	"employee"	"[one of]To see one of your employees denotes crosses and disturbances if he assumes a disagreeable or offensive attitude.[or]If he is pleasant and has communications of interest, you will find no cause for evil or embarrassing conditions upon waking.[cycling]"
"a"	"bull"	"[one of]To see one pursuing you, business trouble, through envious and jealous competitors, will harass you.[or]If a young woman meets a bull, she will have an offer of marriage, but, by declining this offer, she will better her fortune.[or]To see a bull goring a person, misfortune from unwisely using another's possessions will overtake you.[or]To dream of a white bull, denotes that you will lift yourself up to a higher plane of life than those who persist in making material things their.[or][or]It usually denotes gain.[cycling]"
"a"	"bier"	"[one of]To see one, indicates disastrous losses and the early dissolution of a dear relative.[or]To see one, strewn with flowers in a church, denotes an unfortunate marriage.[cycling]"
"a"	"banner"	"[one of]To see one's country's banner floating in a clear sky, denotes triumph over foreign foes.[or]To see it battered, is significant of wars and loss of military honors on land and sea.[cycling]"
"a"	"roast"	"[one of]To see or eat roast in a dream, is an omen of domestic infelicity and secret treachery.[cycling]"
"a"	"rye bread"	"[one of]To see or eat rye bread in your dreams, foretells you will have a cheerful and well-appointed home.[cycling]"
"an"	"earthquake"	"[one of]To see or feel the earthquake in your dream, denotes business failure and much distress caused from turmoils and wars between nations.[cycling]"
"a"	"honeysuckle"	"[one of]To see or gather, honeysuckles, denotes that you will be contentedly prosperous and your marriage will be a singularly happy one.[cycling]"
"a"	"mocking-bird"	"[one of]To see or hear a mocking-bird, signifies you will be invited to go on a pleasant visit to friends, and your affairs will move along smoothly and prosperously.[or]For a woman to see a wounded or dead one, her disagreement with a friend or lover is signified.[cycling]"
"a"	"chiffonier"	"[one of]To see or search through a chiffonier, denotes you will have disappointing anticipations.[or]To see one in order, indicates pleasant friends and entertainments.[cycling]"
"a"	"rogue"	"[one of]To see or think yourself a rogue, foretells you are about to commit some indiscretion which will give your friends uneasiness of mind.[or]You are likely to suffer from a passing malady.[or]For a woman to think her husband or lover is a rogue, foretells she will be painfully distressed over neglect shown her by a friend.[cycling]"
"a"	"draw-knife"	"[one of]To see or use a draw-knife, portends unfulfiled hopes or desires.[or]Some fair prospect will loom before you, only to go down in mistake and disappointment.[cycling]"
"a"	"coffee house"	"[one of]To see or visit a coffee house in your dreams, foretells that you will unwisely entertain friendly relations with persons known to be your enemies.[or]Designing women may intrigue against your morality and possessions.[cycling]"
"a"	"whalebone"	"[one of]To see or work with whalebone in your dreams, you still form an alliance which will afford you solid benefit.[cycling]"
"a"	"jail"	"[one of]To see others in jail, you will be urged to grant privileges to persons whom you believe to be unworthy.[or]To see negroes in jail, denotes worries and loss through negligence of underlings.[or]For a young woman to dream that her lover is in jail, she will be disappointed in his character, as he will prove a deceiver.[cycling]"
"an"	"otter"	"[one of]To see otters diving and sporting in limpid streams is certain to bring the dreamer waking happiness and good fortune.[or]You will find ideal enjoyment in an early marriage, if you are single; wives may expect unusual tenderness from their spouses after this dream.[cycling]"
"an"	"itch"	"[one of]To see persons with the itch, and you endeavor to escape contact, you will stand in fear of distressing results when your endeavors will bring pleasant success.[or]If you dream you have the itch yourself, you will be harshly used, and will defend yourself by incriminating others.[or]For a young woman to have this dream, omens she will fall into dissolute companionship.[or]To dream that you itch, denotes unpleasant avocations.[cycling]"
"a"	"pony"	"[one of]To see ponies in your dreams, signifies moderate speculations will be rewarded with success.[cycling]"
"a"	"powder"	"[one of]To see powder in your dreams, denotes unscrupulous people are dealing with you.[or]You may detect them through watchfulness.[cycling]"
"a"	"quail"	"[one of]To see quails in your dream, is a very favorable omen, if they are alive; if dead, you will undergo serious ill luck.[or]To shoot quail, foretells that ill feelings will be shown by you to your best friends.[or]To eat them, signifies extravagance in your personal living.[cycling]"
"a"	"raspberry"	"[one of]To see raspberries in a dream, foretells you are in danger of entanglements which will prove interesting before you escape from them.[or]For a woman to eat them, means distress over circumstantial evidence in some occurrence causing gossip.[cycling]"
"a"	"rye"	"[one of]To see rye, is a dream of good, as prosperity envelopes your future in brightest promises.[or]To see coffee made of rye, denotes that your pleasures will be tempered with sound judgment, and your affairs will be managed without disagreeable friction.[or]To see stock entering rye fields, denotes that you will be prosperous.[cycling]"
"a"	"sheet iron"	"[one of]To see sheet iron in your dream, denotes you are unfortunately listening to the admonition of others.[or]To walk on it, signifies distasteful engagements.[cycling]"
"a"	"shepherd"	"[one of]To see shepherds in your dreams watching their flocks, portends bounteous crops and pleasant relations for the farmer, also much enjoyment and profit for others.[or]To see them in idleness, foretells sickness and bereavement.[cycling]"
"a"	"snow"	"[one of]To see snow in your dreams, denotes that while you have no real misfortune, there will be the appearance of illness, and unsatisfactory enterprises.[or]To find yourself in a snow storm, denotes sorrow and disappointment in failure to enjoy some long-expected pleasure.[or]There always follows more or less discouragement after this dream.[or]If you eat snow, you will fail to realize ideals.[or]To see dirty snow, foretells that your pride will be humbled, and you will seek reconciliation with some person whom you held in haughty contempt.[or]To see it melt, your fears will turn into joy.[or]To see large, white snowflakes falling while looking through a window, foretells that you will have an angry interview with your sweetheart, and the estrangement will be aggravated by financial depression.[or]To see snow-capped mountains in the distance, warns you that your longings and ambitions will bring no worthy advancement.[or]To see the sun shining through landscapes of snow, foretells that you will conquer adverse fortune and possess yourself of power.[or]For a young woman to dream of sleighing, she will find much opposition to her choice of a lover, and her conduct will cause her much ill-favor.[or]To dream of snowballing, denotes that you will have to struggle with dishonorable issues, and if your judgment is not well grounded, you will suffer defeat.[or]If snowbound or lost, there will be constant waves of ill luck breaking in upon you.[cycling]"
"a"	"spider-web"	"[one of]To see spider-webs, denotes pleasant associations and fortunate ventures.[cycling]"
"a"	"spirit or specter"	"[one of]To see spirits in a dream, denotes that some unexpected trouble will confront you.[or]If they are white-robed, the health of your nearest friend is threatened, or some business speculation will be disapproving.[or]If they are robed in black, you will meet with treachery and unfaithfulness.[or]If a spirit speaks, there is some evil near you, which you might avert if you would listen to the counsels of judgment.[or]To dream that you hear spirits knocking on doors or walls, denotes that trouble will arise unexpectedly.[or]To see them moving draperies, or moving behind them, is a warning to hold control over your feelings, as you are likely to commit indiscretions.[or]Quarrels are also threatened.[or]To see the spirit of your friend floating in your room, foretells disappointment and insecurity.[or]To hear music supposedly coming from spirits, denotes unfavorable changes and sadness in the household.[cycling]"
"a"	"stag"	"[one of]To see stags in your dream, foretells that you will have honest and true friends, and will enjoy delightful entertainments.[cycling]"
"a"	"stain"	"[one of]To see stain on your hands, or clothing, while dreaming, foretells that trouble over small matters will assail you.[or]To see a stain on the garments of others, or on their flesh, foretells that some person will betray you.[cycling]"
"a"	"stone mason"	"[one of]To see stone masons at work while dreaming, foretells disappointment.[or]To dream that you are a stone mason, portends that your labors will be unfruitful, and your companions will be dull and uncongenial.[cycling]"
"a"	"stone"	"[one of]To see stones in your dreams, foretells numberless perplexities and failures.[or]To walk among rocks, or stones, omens that an uneven and rough pathway will be yours for at least a while.[or]To make deals in ore-bearing rock lands, you will be successful in business after many lines have been tried.[or]If you fail to profit by the deal, you will have disappointments.[or]If anxiety is greatly felt in closing the trade, you will succeed in buying or selling something that will prove profitable to you.[or]Small stones or pebbles, implies that little worries and vexations will irritate you.[or]If you throw a stone, you will have cause to admonish a person.[or]If you design to throw a pebble or stone at some belligerent person, it denotes that some evil feared by you will pass because of your untiring attention to right principles.[cycling]"
"a"	"dye"	"[one of]To see the dyeing of cloth or garments in process, your bad or good luck depends on the color.[or]Blues, reds and gold, indicate prosperity; black and white, indicate sorrow in all forms.[cycling]"
"a"	"morning"	"[one of]To see the morning dawn clear in your dreams, prognosticates a near approach of fortune and pleasure.[or]A cloudy morning, portends weighty affairs will overwhelm you.[cycling]"
"a"	"waltz"	"[one of]To see the waltz danced, foretells that you will have pleasant relations with a cheerful and adventuresome person.[or]For a young woman to waltz with her lover, denotes that she will be the object of much admiration, but none will seek her for a wife.[or]If she sees her lover waltzing with a rival, she will overcome obstacles to her desires with strategy.[or]If she waltzes with a woman, she will be loved for her virtues and winning ways.[or]If she sees persons whirling in the waltz as if intoxicated, she will be engulfed so deeply in desire and pleasure that it will be a miracle if she resists the impassioned advances of her lover and male acquaintances.[cycling]"
"a"	"canal"	"[one of]To see the water of a canal muddy and stagnant-looking, portends sickness and disorders of the stomach and dark designs of enemies.[or]But if its waters are clear a placid life and the devotion of friends is before you.[or]For a young woman to glide in a canoe across a canal, denotes a chaste life and an adoring husband.[or]If she crossed the canal on a bridge over clear water and gathers ferns and other greens on the banks, she will enjoy a life of ceaseless rounds of pleasure and attain to high social distinction.[or]But if the water be turbid she will often find herself tangled in meshes of perplexity and will be the victim of nervous troubles.[cycling]"
"a"	"suckle"	"[one of]To see the young taking suckle, denotes contentment and favorable conditions for success is unfolding to you.[cycling]"
"a"	"butcher"	"[one of]To see them slaughtering cattle and much blood, you may expect long and fatal sickness in your family.[or]To see a butcher cutting meat, your character will be dissected by society to your detriment.[or]Beware of writing letters or documents.[cycling]"
"a"	"timber"	"[one of]To see timber in your dreams, is an augury of prosperous times and peaceful surroundings.[or]If the timber appears dead, there are great disappointments for you.[cycling]"
"a"	"topaz"	"[one of]To see topaz in a dream, signifies.[or]Fortune will be liberal in her favors, and you will have very pleasing companions.[or]For a woman to lose topaz ornaments, foretells she will be injured by jealous friends who court her position.[or]To receive one from another beside a relative, foretells an interesting love affair will occupy her attention.[cycling]"
"a"	"tray"	"[one of]To see trays in your dream, denotes your wealth will be foolishly wasted, and surprises of unpleasant nature will shock you.[or]If the trays seem to be filled with valuables, surprises will come in the shape of good fortune.[cycling]"
"a"	"tripe"	"[one of]To see tripe in a dream, means sickness and danger.[or]To eat tripe, denotes that you will be disappointed in some serious matter.[cycling]"
"a"	"trophy"	"[one of]To see trophies in a dream, signifies some pleasure or fortune will come to you through the endeavors of mere acquaintances.[or]For a woman to give away a trophy, implies doubtful pleasures and fortune.[cycling]"
"a"	"twine"	"[one of]To see twine in your dream, warns you that your business is assuming complications which will be hard to overcome.[cycling]"
"a"	"type"	"[one of]To see type in a dream, portends unpleasant transactions with friends.[or]For a woman to clean type, foretells she will make fortunate speculations which will bring love and fortune.[cycling]"
"a"	"bank"	"[one of]To see vacant tellers, foretells business losses.[or]Giving out gold money, denotes carelessness; receiving it, great gain and prosperity.[or]To see silver and bank-notes accumulated, increase of honor and fortune.[or]You will enjoy the highest respect of all classes.[cycling]"
"a"	"wallet"	"[one of]To see wallets in a dream, foretells burdens of a pleasant nature will await your discretion as to assuming them.[or]An old or soiled one, implies unfavorable results from your labors.[cycling]"
"a"	"water-carrier"	"[one of]To see water-carriers passing in your dreams, denotes that your prospects will be favorable in fortune, and love will prove no laggard in your chase for pleasure.[or]If you think you are a water-carrier, you will rise above your present position.[cycling]"
"a"	"bathroom"	"[one of]To see white roses in a bathroom, and yellow ones in a box, denote that sickness will interfere with pleasure; but more lasting joys will result from this disappointment.[or]For a young woman to dream of a bathroom, foretells that her inclinations trend too much toward light pleasures and frivolities.[cycling]"
"a"	"window"	"[one of]To see windows in your dreams, is an augury of fateful culmination to bright hopes.[or]You will see your fairest wish go down in despair.[or]Fruitless endeavors will be your portion.[or]To see closed windows is a representation of desertion.[or]If they are broken, you will be hounded by miserable suspicions of disloyalty from those you love.[or]To sit in a window, denotes that you will be the victim of folly.[or]To enter a house through a window, denotes that you will be found out while using dishonorable means to consummate a seemingly honorable purpose.[or]To escape by one, indicates that you will fall into a trouble whose toils will hold you unmercifully close.[or]To look through a window when passing and strange objects appear, foretells that you will fail in your chosen avocation and lose the respect for which you risked health and contentment.[cycling]"
"a"	"workshop"	"[one of]To see workshops in your dreams, foretells that you will use extraordinary schemes to undermine your enemies.[cycling]"
"an"	"abdomen"	"[one of]To see your abdomen in a dream, foretells that you will have great expectations, but you must curb hardheadedness and redouble your energies on your labor, as pleasure is approaching to your hurt.[or]To see your abdomen shriveled, foretells that you will be persecuted and defied by false friends.[or]To see it swollen, you will have tribulations, but you will overcome them and enjoy the fruits of your labor.[or]To see blood oozing from the abdomen, foretells an accident or tragedy in your family.[or]The abdomen of children in an unhealthy state, portends that contagion will pursue you.[cycling]"
"a"	"tattoo"	"[one of]To see your body appearing tattooed, foretells that some difficulty will cause you to make a long and tedious absence from your home.[or]To see tattooes on others, foretells that strange loves will make you an object of jealousy.[or]To dream you are a tattooist, is a sign that you will estrange yourself from friends because of your fancy for some strange experience.[cycling]"
"a"	"mother"	"[one of]To see your mother in dreams as she appears in the home, signifies pleasing results from any enterprise.[or]To hold her in conversation, you will soon have good news from interests you are anxious over.[or]For a woman to dream of mother, signifies pleasant duties and connubial bliss.[or]To see one's mother emaciated or dead, foretells sadness caused by death or dishonor.[or]To hear your mother call you, denotes that you are derelict in your duties, and that you are pursuing the wrong course in business.[or]To hear her cry as if in pain, omens her illness, or some affliction is menacing you.[cycling]"
"a"	"neighbor"	"[one of]To see your neighbors in your dreams, denotes many profitable hours will be lost in useless strife and gossip.[or]If they appear sad, or angry, it foretells dissensions and quarrels.[cycling]"
"a"	"brain"	"[one of]To see your own brain in a dream, denotes uncongenial surroundings will irritate and dwarf you into an unpleasant companion.[or]To see the brains of animals, foretells that you will suffer mental trouble.[or]If you eat them, you will gain knowledge, and profit unexpectedly.[cycling]"
"a"	"nose"	"[one of]To see your own nose, indicates force of character, and consciousness of your ability to accomplish whatever enterprise you may choose to undertake.[or]If your nose looks smaller than natural, there will be failure in your affairs.[or]Hair growing on your nose, indicates extraordinary undertakings, and that they will be carried through by sheer force of character, or will.[or]A bleeding nose, is prophetic of disaster, whatever the calling of the dreamer may be.[cycling]"
"a"	"vein"	"[one of]To see your veins in a dream, insures you against slander, if they are normal.[or]To see them bleeding, denotes that you will have a great sorrow from which there will be no escape.[or]To see them swollen, you will rise hastily to distinction and places of trust.[cycling]"
"a"	"handsome"	"[one of]To see yourself handsome-looking in your dreams, you will prove yourself an ingenious flatterer.[or]To see others appearing handsome, denotes that you will enjoy the confidence of fast people.[cycling]"
"a"	"violin"	"[one of]To see, or hear a violin in dreams, foretells harmony and peace in the family, and financial affairs will cause no apprehension.[or]For a young woman to play on one in her dreams, denotes that she will be honored and receive lavish gifts.[or]If her attempt to play is unsuccessful, she will lose favor, and aspire to things she never can possess.[or]A broken one, indicates sad bereavement and separation.[cycling]"
"a"	"roman candle"	"[one of]To see.[or]Roman candles while dreaming, is a sign of speedy attainment of coveted pleasures and positions.[or]To imagine that you have a loaded candle and find it empty, denotes that you will be disappointed with the possession of some object which you have long striven to obtain.[cycling]"
"a"	"pier"	"[one of]To stand upon a pier in your dream, denotes that you will be brave in your battle for recognition in prosperity's realm, and that you will be admitted to the highest posts of honor.[or]If you strive to reach a pier and fail, you will lose the distinction you most coveted.[cycling]"
"a"	"medicine"	"[one of]To take medicine foretells poverty to give any one medicine gain.[cycling]"
"a"	"rosemary"	"[one of]To the married denotes loss of their mates and children; to the lover trouble through his or her sweetheart.[cycling]"
"a"	"dressing"	"[one of]To think you are having trouble in dressing, while dreaming, means some evil persons will worry and detain you from places of amusement.[or]If you can't get dressed in time for a train, you will have many annoyances through the carelessness of others.[or]You should depend on your own efforts as far as possible, after these dreams, if you would secure contentment and full success.[cycling]"
"a"	"seat"	"[one of]To think, in a dream, that some one has taken your seat, denotes you will be tormented by people calling on you for aid.[or]To give a woman your seat, implies your yielding to some fair one's artfulness.[cycling]"
"a"	"needle"	"[one of]To use a needle in your dream, is a warning of approaching affliction, in which you will suffer keenly the loss of sympathy, which is rightfully yours.[or]To dream of threading a needle, denotes that you will be burdened with the care of others than your own household.[or]To look for a needle, foretells useless worries.[or]To find a needle, foretells that you will have friends who will appreciate you.[or]To break one, signifies loneliness and poverty.[cycling]"
"a"	"book store"	"[one of]To visit a book store in your dream, foretells you will be filled with literary aspirations, which will interfere with your other works and labors.[cycling]"
"a"	"fish market"	"[one of]To visit a fish market in your dream, brings competence and pleasure.[or]To see decayed fish, foretells distress will come in the guise of happiness.[cycling]"
"an"	"academy"	"[one of]To visit an academy in your dreams, denotes that you will regret opportunities that you have let pass through sheer idleness and indifference.[or]To think you own, or are an inmate of one, you will find that you are to meet easy defeat of aspirations.[or]You will take on knowledge, but be unable to rightly assimilate and apply it.[or]For a young woman or any person to return to an academy after having finished there, signifies that demands will be made which the dreamer may find himself or her self unable to meet.[cycling]"
"an"	"art gallery"	"[one of]To visit an art gallery, portends unfortunate unions in domestic circles.[or]You will struggle to put forth an appearance of happiness, but will secretly care for other associations.[cycling]"
"a"	"ferry"	"[one of]To wait at a ferry for a boat and see the waters swift and muddy, you will be baffled in your highest wishes and designs by unforeseen circumstances.[or]To cross a ferry while the water is calm and clear, you will be very lucky in carrying out your plans, and fortune will crown you.[cycling]"
"a"	"swamp"	"[one of]To walk through swampy places in dreams, foretells that you will be the object of adverse circumstances.[or]Your inheritance will be uncertain, and you will undergo keen disappointments in your love matters.[or]To go through a swamp where you see clear water and green growths, you will take hold on prosperity and singular pleasures, the obtaining of which will be attended with danger and intriguing.[cycling]"
"a"	"barefoot"	"[one of]To wander in the night barefoot with torn garments, denotes that you will be crushed in expectation, and evil influences will surround your every effort.[cycling]"
"a"	"rosette"	"[one of]To wear or see rosettes on others while in dreams, is significant of frivolous waste of time; though you will experience the thrills of pleasure, they will bring disappointments.[cycling]"
"a"	"road"	"[one of]Traveling over a rough, unknown road in a dream, signifies new undertakings, which will bring little else than grief and loss of time.[or]If the road is bordered with trees and flowers, there will be some pleasant and unexpected fortune for you.[or]If friends accompany you, you will be successful in building an ideal home, with happy children and faithful wife, or husband.[or]To lose the road, foretells that you will make a mistake in deciding some question of trade, and suffer loss in consequence.[cycling]"
"a"	"vermin"	"[one of]Vermin crawling in your dreams, signifies sickness and much trouble.[or]If you succeed in ridding yourself of them, you will be fairly successful, but otherwise death may come to you, or your relatives.[cycling]"
"a"	"wafer"	"[one of]Wafer, if seen in a dream, purports an encounter with enemies.[or]To eat one, suggests impoverished fortune.[or]For a young woman to bake them, denotes that she will be tormented and distressed by fears of remaining in the unmarried state.[cycling]"
"a"	"clover"	"[one of]Walking through fields of fragrant clover is a propitious dream.[or]It brings all objects desired into the reach of the dreamer.[or]Fine crops is portended for the farmer and wealth for the young.[or]Blasted fields of clover brings harrowing and regretful sighs.[or]To dream of clover, foretells prosperity will soon enfold you.[or]For a young woman to dream of seeing a snake crawling through blossoming clover, foretells she will be early disappointed in love, and her surroundings will be gloomy and discouraging, though to her friends she seems peculiarly fortunate.[cycling]"
"a"	"palace"	"[one of]Wandering through a palace and noting its grandeur, signifies that your prospects are growing brighter and you will assume new dignity.[or]To see and hear fine ladies and men dancing and conversing, denotes that you will engage in profitable and pleasing associations.[or]For a young woman of moderate means to dream that she is a participant in the entertainment, and of equal social standing with others, is a sign of her advancement through marriage, or the generosity of relatives.[or]This is often a very deceitful and misleading dream to the young woman of humble circumstances; as it is generally induced in such cases by the unhealthy day dreams of her idle, empty brain.[or]She should strive after this dream, to live by honest work, and restrain deceitful ambition by observing the fireside counsels of mother, and friends.[cycling]"
"a"	"wasp"	"[one of]Wasps, if seen in dreams, denotes that enemies will scourge and spitefully villify you.[or]If one stings you, you will feel the effect of envy and hatred.[or]To kill them, you will be able to throttle your enemies, and fearlessly maintain your rights.[cycling]"
"an"	"oath"	"[one of]Whenever you take an oath in your dreams, prepare for dissension and altercations on waking.[cycling]"
"a"	"wood-pile"	"To dream of a wood-pile, denotes unsatisfactory business and misunderstandings in love."
"a"	"wadding"	"Wadding, if seen in a dream, brings consolation to the sorrowing, and indifference to unfriendly criticism."
"a"	"lioness"	"[one of]Dreaming of seeing a lioness is good to the rich or poor.[or]Marriage is also hereby signified.[or]Those that have children upon this dream shall lose them.[or]But if you dream that she destroys you it is death to the dreamer.[or]For persons at sea to dream of this animal is a sign of storm.[cycling]"
"a"	"looking-glass"	"[one of]For a woman to dream of a looking-glass, denotes that she is soon to be confronted with shocking deceitfulness and discrepancies, which may result in tragic scenes or separations.[or][cycling]"
"an"	"illness"	"[one of]For a woman to dream of her own illness, foretells that some unforeseen event will throw her into a frenzy of despair by causing her to miss some anticipated visit or entertainment.[or][cycling]"
"an"	"abbess"	"[one of]For a young woman to dream that she sees an abbess, denotes that she will be compelled to perform distasteful tasks, and will submit to authority only after unsuccessful rebellion.[or]To dream of an abbess smiling and benignant, denotes you will be surrounded by true friends and pleasing prospects.[cycling]"
"a"	"grass"	"[one of]Green grass denotes long life; to cut grass great trouble.[cycling]"
"a"	"chess"	"[one of]If any one dreams that he plays at chess with an acquaintance, it is a sign that he will fall out with somebody he knows, and if he imagines in his dream he wins, he shall overcome his enemies.[or]And on the contrary, if he dream that he loses, he will be overcome and worsted in the combat.[cycling]"
"a"	"fortress"	"[one of]If you are confined in a fortress in your dream, your plans in life will suffer from undue influence of others.[or]If you dream of placing others in confinement, look for valuable goods, which will enrich you.[cycling]"
"an"	"abscess"	"[one of]If you dream you have an abscess or running sore on your person it foretells good fortune and good health to be preceded by sickness.[cycling]"
"a"	"sickness"	"[one of]If you dream you have had a long sickness and are recovering it foretells bad luck and difficulties: should you imagine that you are sick and are going to die the omen is the reverse for some good fortune awaits you: if a girl dreams that she is sick abed and her lover visits her it foretells a smooth courtship and happy marriage.[cycling]"
"an"	"actress"	"[one of]If you dream you love her it is a sign you will meet with adversities.[or]If you dream you see her on the stage you will be successful in all your undertakings.[cycling]"
"a"	"grass"	"[one of]This is a very propitious dream indeed.[or]It gives promise of a happy and well advanced life to the tradesman, rapid accumulation of wealth, fame to literary and artistic people, and a safe voyage through the turbulent sea of love is promised to all lovers.[or]To see a rugged mountain beyond the green expanse of grass, is momentous of remote trouble.[or]If in passing through green grass, you pass withered places, it denotes your sickness or embarrassments in business.[or]To be a perfect dream, the grass must be clear of obstruction or blemishes.[or]If you dream of withered grass, the reverse is predicted.[cycling]"
"a"	"compass"	"[one of]To dream of a compass, denotes you will be forced to struggle in narrow limits, thus making elevation more toilsome but fuller of honor.[or]To dream of the compass or mariner's needle, foretells you will be surrounded by prosperous circumstances and honest people will favor you.[or]To see one pointing awry, foretells threatened loss and deception.[cycling]"
"a"	"looking-glass"	"[one of]To dream of a looking-glass is a bad omen and signifies that you will be surrounded with false friends who will rob you until your property dwindles to a shadow.[or]To dream you see your face in a looking-glass is a sign of sickness.[or]To break a looking-glass portends death.[or]If a girl dreams she sees her lover in a looking-glass it is a sign he will desert or seduce her.[cycling]"
"a"	"mattress"	"[one of]To dream of a mattress, denotes that new duties and responsibilities will shortly be assumed.[or]To sleep on a new mattress, signifies contentment with present surroundings.[or]To dream of a mattress factory, denotes that you will be connected in business with thrifty partners and will soon amass wealth.[cycling]"
"a"	"wine-glass"	"[one of]To dream of a wine-glass, foretells that a disappointment will affect you seriously, as you will fail to see anything pleasing until shocked into the realization of trouble.[cycling]"
"an"	"empress"	"[one of]To dream of an empress, denotes that you will be exalted to high honors, but you will let pride make you very unpopular.[or]To dream of an empress and an emperor is not particularly bad, but brings one no substantial good.[cycling]"
"a"	"business"	"[one of]To dream of being full of business is significant of some unexpected good fortune; to finish it marriage; if the business appears to be bad it is a good sign.[cycling]"
"a"	"madness"	"[one of]To dream of being mad, shows trouble ahead for the dreamer.[or]Sickness, by which you will lose property, is threatened.[or]To see others suffering under this malady, denotes inconstancy of friends and gloomy ending of bright expectations.[or]For a young woman to dream of madness, foretells disappointment in marriage and wealth.[cycling]"
"a"	"brass"	"[one of]To dream of brass, denotes that you will rise rapidly in your profession, but while of apparently solid elevation you will secretly fear a downfall of fortune.[cycling]"
"a"	"glass"	"[one of]To dream of glass, marks inconstancy in your sweetheart, and in business of bad success in your undertakings in life.[or]To dream you break glass, shows that your sweetheart will forsake you, and that you will unexpectedly meet with misfortunes and troubles.[or]To dream you receive a glassful of water, is indicative of a speedy marriage and that you will have many children, who will all do well.[or]If the glass appears broken, the death of your sweetheart, or, if married, of your spouse, is predicted.[or]For a woman with child, or a married man whilst his wife is with child, to dream of breaking a glass of wine or water, denotes that the child in the womb will be preserved after much danger, and perhaps the death of the mother.[or]If either of them dream that they spill wine or water, it is indicative that the mother will live but the child will die.[cycling]"
"a"	"mass"	"[one of]To dream of going to this religious celebration is a sign that some one will either cheat you or rob your house.[or]If a girl dreams this let her look out that her lover does not prove to be a worthless scamp.[cycling]"
"a"	"lookingglass"	"[one of]To dream of looking in a glass, denotes children to the married and to the unmarried it promises a lover speedily.[cycling]"
"an"	"abyss"	"[one of]To dream of looking into an abyss, means that you will be confronted by threats of seizure of property, and that there will be quarrels and reproaches of a personal nature which will unfit you to meet the problems of life.[or]For a woman to be looking into an abyss, foretells that she will burden herself with unwelcome cares.[or]If she falls into the abyss her disappointment will be complete; but if she succeeds in crossing, or avoiding it, she will reinstate herself.[cycling]"
"a"	"spy-glass"	"[one of]To dream of looking through one of these instruments and observing objects at a distance is a sign that you will enlarge your possessions; if you are a farmer you will add to your farm; if a man of business enlarge your business &c.; but to a poor devil who hasn’t got much of anything it predicts that he will increase his family for the want of something else to enlarge.[cycling]"
"a"	"moss"	"[one of]To dream of moss, denotes that you will fill dependent positions, unless the moss grows in rich soil, when you will be favored with honors.[cycling]"
"a"	"chess"	"[one of]To dream of playing chess, denotes stagnation of business, dull companions, and poor health.[or]To dream that you lose at chess, worries from mean sources will ensue; but if you win, disagreeable influences may be surmounted.[cycling]"
"a"	"harness"	"[one of]To dream of possessing bright new harness, you will soon prepare for a pleasant journey.[cycling]"
"a"	"glass"	"[one of]To dream of receiving a glass of water signifies that you will soon be married; if you break it your lover will forsake you.[cycling]"
"a"	"cross"	"[one of]To dream of seeing a cross, indicates trouble ahead for you.[or]Shape your affairs accordingly.[or]To dream of seeing a person bearing a cross, you will be called on by missionaries to aid in charities.[cycling]"
"an"	"eyeglass"	"[one of]To dream of seeing or wearing an eyeglass, denotes you will be afflicted with disagreeable friendships, from which you will strive vainly to disengage yourself.[or]For a young woman to see her lover with an eyeglass on, omens disruption of love affairs.[cycling]"
"a"	"sickness"	"[one of]To dream of sickness, is a sign of trouble and real sickness in your family.[or]Discord is sure to find entrance also.[or]To dream of your own sickness, is a warning to be unusually cautious of your person.[or]To see any of your family pale and sick, foretells that some event will break unexpectedly upon your harmonious hearthstone.[or]Sickness is usually attendant upon this dream.[cycling]"
"a"	"sickness"	"[one of]To dream one is sick, signifies idleness and want of work.[or]To dream one comforts the sick, and prescribes them medicine, denotes profit and felicity.[cycling]"
"a"	"fortress"	"[one of]To dream that you are confined in a fortress, denotes that enemies will succeed in placing you in an undesirable situation.[or]To put others in a fortress, denotes your ability to rule in business or over women.[cycling]"
"an"	"illness"	"[one of]To dream that you are ill and confined to your bed is a sign that some one will overreach you in a bargain or cheat you in some way.[or]Such a dream is a bad omen to loves as it predicts false vows.[cycling]"
"a"	"spy-glass"	"[one of]To dream that you are looking through a spy-glass, denotes that changes will soon occur to your disadvantage.[or]To see a broken or imperfect one, foretells unhappy dissensions and loss of friends.[cycling]"
"a"	"glass"	"[one of]To dream that you are looking through glass, denotes that bitter disappointments will cloud your brightest hopes.[or]To see your image in a mirror, foretells unfaithfulness and neglect in marriage, and fruitless speculations.[or]To see another face with your own in a mirror indicates that you are leading a double life.[or]You will deceive your friends.[or]To break a mirror, portends an early and accidental death.[or]To break glass dishes, or windows, foretells the unfavorable termination to enterprises.[or]To receive cut glass, denotes that you will be admired for your brilliancy and talent.[or]To make presents of cut glass ornaments, signifies that you will fail in your undertakings.[or]For a woman to see her lover in a mirror, denotes that she will have cause to institute a breach of promise suit.[or]For a married woman to see her husband in a mirror, is a warning that she will have cause to feel anxiety for her happiness and honor.[or]To look clearly through a glass window, you will have employment, but will have to work subordinately.[or]If the glass is clouded, you will be unfortunately situated.[or]If a woman sees men, other than husband or lover, in a looking glass, she will be discovered in some indiscreet affair which will be humiliating to her and a source of worry to her relations.[or]For a man to dream of seeing strange women in a mirror, he will ruin his health and business by foolish attachments.[cycling]"
"a"	"toothless"	"[one of]To dream that you are toothless, denotes your inability to advance your interests, and ill health will cast goom{sic} over your prospects.[or]To see others toothless, foretells that enemies are trying in vain to calumniate you.[cycling]"
"an"	"undress"	"[one of]To dream that you are undressing, foretells, scandalous gossip will overshadow you.[or]For a woman to dream that she sees the ruler of her country undressed, signifies sadness will overtake anticipated pleasures.[or]She will suffer pain through the apprehension of evil to those dear to her.[or]To see others undressed, is an omen of stolen pleasures, which will rebound with grief.[cycling]"
"a"	"witness"	"[one of]To dream that you bear witness against others, signifies you will have great oppression through slight causes.[or]If others bear witness against you, you will be compelled to refuse favors to friends in order to protect your own interest.[or]If you are a witness for a guilty person, you will be implicated in a shameful affair.[cycling]"
"a"	"numbness"	"[one of]To dream that you feel a numbness creeping over you, in your dreams, is a sign of illness, and disquieting conditions.[cycling]"
"a"	"pane of glass"	"[one of]To dream that you handle a pane of glass, denotes that you are dealing in uncertainties.[or]If you break it, your failure will be accentuated.[or]To talk to a person through a pane of glass, denotes that there are obstacles in your immediate future, and they will cause you no slight inconvenience.[cycling]"
"an"	"abscess"	"[one of]To dream that you have an abscess which seems to have reached a chronic stage, you will be overwhelmed with misfortune of your own; at the same time your deepest sympathies will be enlisted for the sorrows of others.[cycling]"
"a"	"brass"	"[one of]To dream that you see a brass ornament is a sign your sweetheart will be false to you.[or]To see any one working in brass or cleaning that metal is a sign you will hear of the death of a distant relative who will leave you a legacy.[cycling]"
"a"	"faithless"	"[one of]To dream that your friends are faithless, denotes that they will hold you in worthy esteem.[or]For a lover to dream that his sweetheart is faithless, signifies a happy marriage.[cycling]"
"a"	"drunkenness"	"[one of]To dream you are drunk is loss in business; but success in love; to a woman it denotes she will be beloved by a stranger; and to a man that he will be married to a rich young widow.[or]To the married it denotes domestic bliss.[or]To see a drunken man shows that you will be guilty of some foolish action.[cycling]"
"a"	"drunkenness"	"[one of]To dream you are drunk, is one of those dreams by which the dreamer is forewarned of that of which at present he knows nothing.[or]It denotes that some person whom yet you do not know, will become a very good friend and promote your welfare.[or]To a woman, it denotes that she will be beloved by an excellent man whom yet she has not seen; and to a man it denotes that he is tenderly beloved by a woman whom he does not at present think of, who will make him extremely happy, and bring him money.[cycling]"
"a"	"darkness"	"[one of]To dream you are in a dark place is an unfavorable omen; to the lovers it denotes loss of sweethearts to the trader loss of goods; but to dream of getting out of darkness into light is good; if you are in poverty it foretells riches; if in love a happy marriage.[cycling]"
"a"	"darkness"	"[one of]To dream you are in a very dark place, or that you are in the dark, is a very unfavorable omen.[or]To dream you get out of darkness into light, denotes good to the dreamer.[or]Expect also to hear some glad tidings from a far distant country.[cycling]"
"a"	"meanness"	"[one of]To dream you are treated in a mean and shabby manner by anybody is a sign you will have unexpected honors thrust upon you.[or]If a girl dreams that her lover has behaved meanly she may be sure he will do something to command her admiration.[cycling]"
"an"	"ass"	"[one of]To dream you hear an ass bray shows you will meet with some loss; to see an ass run signifies misfortune.[cycling]"
"a"	"cross"	"[one of]To dream you see a cross carried along, signifies sadness.[cycling]"
"a"	"cross"	"[one of]To dream you see a cross signifies sadness.[cycling]"
"a"	"magnifying-glass"	"[one of]To look through a magnifying-glass in your dreams, means failure to accomplish your work in a satisfactory manner.[or]For a woman to think she owns one, foretells she will encourage the attention of persons who will ignore her later.[cycling]"
"a"	"chess"	"[one of]To play at denotes gain by lying and deceit; to see another play loss by craftiness.[or][or]Julianus regarded this dream as indicative of the success which would attend the dreamer in his undertaking according to his fancied success in his dream.[cycling]"
"a"	"seamstress"	"[one of]To see a seamstress in a dream, portends you will be deterred from making pleasant visits by unexpected luck.[cycling]"
"a"	"truss"	"[one of]To see a truss in your dream, your ill health and unfortunate business engagements are predicted.[cycling]"
"an"	"abyss"	"[one of]To see an abyss or deep hole is a warning; avoid after such a dream taking a journey by land or a voyage by sea for eight-and forty hours because it forebodes accidents by travelling.[cycling]"
"an"	"ass"	"[one of]To see an ass in a dream, you will meet many annoyances, and delays will accrue in receiving news or goods.[or]To see donkeys carrying burdens, denotes that, after patience and toil, you will succeed in your undertakings, whether of travel or love.[or]If an ass pursues you, and you are afraid of it, you will be the victim of scandal or other displeasing reports.[or]If you unwillingly ride on one, or, as jockey, unnecessary quarrels may follow.[cycling]"


Table of Acting
Act	Interpretation
"fighting"	"[one of]To dream you are fighting, denotes to the lover that you will lose the object of your affections through a foolish quarrel.[or]It also forebodes much opposition to your wishes, with loss of character and property.[or]After such a dream, you are urgently recommended to quit your present situation, because such a dream indicates that you will not prosper in it.[or]To the sailor it denotes storm and shipwreck, with disappointment in love.[cycling]"
"fishing"	"[one of]To dream you are fishing, is a sure sign of sorrow and trouble.[or]If you catch any fish, you will be successful in love and business.[or]If you catch none, you will never marry your present sweetheart, nor succeed in your present undertakings.[or]If they slip out of your hands after you have caught them, the person you marry will be of a roving disposition, and some pretended friend will deceive you.[cycling]"
"kissing"	"[one of]To dream that you see children kissing, denotes happy reunions in families and satisfactory work.[or]To dream that you kiss your mother, you will be very successful in your enterprises, and be honored and beloved by your friends.[or]To kiss a brother or sister, denotes much pleasure and good in your association.[or]To kiss your sweetheart in the dark, denotes dangers and immoral engagements.[or]To kiss her in the light, signifies honorable intentions occupy your mind always in connection with women.[or]To kiss a strange woman, denotes loose morals and perverted integrity.[or]To dream of kissing illicitly, denotes dangerous past-times.[or]The indulgence of a low passion may bring a tragedy into well-thought-of homes.[or]To see your rival kiss your sweetheart, you are in danger of losing her esteem.[or]For married people to kiss each other, denotes that harmony is prized in the home life.[or]To dream of kissing a person on the neck, denotes passionate inclinations and weak mastery of self.[or]If you dream of kissing an enemy, you will make advance towards reconciliation with an angry friend.[or]For a young woman to dream that some person sees her kiss her lover, indicates that spiteful envy is entertained for her by a false friend.[or]For her to see her lover kiss another, she will be disappointed in her hopes of marriage.[cycling]"
"separating"	"[one of]To dream of being separated from one whom you highly esteem and value, betokens much enjoyment to the dreamer from an unexpected source.[cycling]"
"selling"	"[one of]To dream of being sold, or set up for sale, is fair to those who wish to change their condition and to those who are in poverty and servitude.[or]But to the rich, and the sick, and those who are placed in honor and authority, it is ill.[cycling]"
"stinging"	"[one of]To dream of being stung by a bee or wasp foretells an injury by unjust and scandalous reports: a young lady who dreams that a bee stings her will probably have her chastity questioned.[cycling]"
"tickling"	"[one of]To dream of being tickled, denotes insistent worries and illness.[or]If you tickle others, you will throw away much enjoyment through weakness and folly.[cycling]"
"scratching"	"[one of]To dream of being scratched, betokens to him that is in debt, that he shall acquit himself.[or]To others it foretells hurt.[cycling]"
"rescuing"	"[one of]To dream of being rescued from any danger, denotes that you will be threatened with misfortune, and will escape with a slight loss.[or]To rescue others, foretells that you will be esteemed for your good deeds.[cycling]"
"divorcing"	"[one of]To dream of being divorced, denotes that you are not satisfied with your companion, and should cultivate a more congenial atmosphere in the home life.[or]It is a dream of warning.[or]For women to dream of divorce, denotes that a single life may be theirs through the infidelity of lovers.[cycling]"
"leaping"	"To dream you are leaping over walls, doors or gates, is a sign that you will
encounter many difficulties in your present pursuits, and that your
sweetheart will not marry you. "
"awaking"	"[one of]To dream you awake yourself is a happy end to all sorrow.[or]To awake another is a sign you will inspire with love the one you wish.[cycling]"
"awaking"	"[one of]To dream that you are awake, denotes that you will experience strange happenings which will throw you into gloom.[or]To pass through green, growing fields, and look upon landscape, in your dreams, and feel that it is an awaking experience, signifies that there is some good and brightness in store for you, but there will be disappointments intermingled between the present and that time.[cycling]"
"baking"	"[one of]Baking is unpropitious for a woman.[or]Ill health and the care of many children; meanness and poverty of supporters are indicated.[cycling]"
"baking"	"[one of]For a woman to dream she is baking bread foretells thrift.[or]If she is a farmer’s wife it is a sign of good crops.[or]If she burns her bread it is a sign that she will have a miscarriage.[cycling]"
"bathing"	"[one of]To dream of a bath is a very unpropitious omen; expect after it to experience many mishaps and much sorrow.[or]If you are in love, your sweetheart will experience many crosses and losses; but to dream you are bathing yourself in clear water, denotes happiness, prosperity and success in love--if the water is dirty, then it foretells shame and sorrow, and a disappointment in love.[cycling]"
"beating"	"[one of]For married people to dream of beating some one shows that they will live a peaceful life; to bachelors good fortune in their amours; if a lover beats his mistress or a lady her suitor it shows that the match will be broken off.[cycling]"
"beheading"	"[one of]To dream you see any one beheaded, is a good omen; if you are in love, you will marry the object of your affections.[or]If you are in prison, you will speedily gain your liberty.[cycling]"
"beheading"	"[one of]To dream of being beheaded, overwhelming defeat or failure in some undertaking will soon follow.[or]To see others beheaded, if accompanied by a large flow of blood, death and exile are portended.[cycling]"
"beheading"	"[one of]To dream that you see a person that is going to be beheaded or if you see one beheaded it is an excellent sign; in love you will be successful; in prison you will be released; and any trouble you have will soon vanish; it is also a sign you will soon meet a long absent friend who will be glad to see you.[cycling]"
"borrowing"	"[one of]Borrowing is a sign of loss and meagre support.[or]For a banker to dream of borrowing from another bank, a run on his own will leave him in a state of collapse, unless he accepts this warning.[or]If another borrows from you, help in time of need will be extended or offered you.[or]True friends will attend you.[cycling]"
"brewing"	"[one of]To dream of being in a vast brewing establishment, means unjust persecution by public officials, but you will eventually prove your innocence and will rise far above your persecutors.[or]Brewing in any way in your dreams, denotes anxiety at the outset, but usually ends in profit and satisfaction.[cycling]"
"brewing"	"[one of]To dream of brewing is a sign you should be up and doing; in love it denotes idleness in your sweetheart; if in trade you will sustain losses.[cycling]"
"brewing and baking"	"[one of]To dream of brewing and baking is the sign of an ill housewife, who lies dreaming in bed, when she should be at work and doing her business.[cycling]"
"burning"	"[one of]To dream of burning doth imply,.[or]A sudden danger, ripe and nigh;.[or]Of all escapes you then beware,.[or]For though fate threatens, it may spare.[cycling]"
"burning"	"[one of]To see in your dream one or more houses burning but not wholly destroyed signifies for the poor that they will become rich and for the rich man that his riches will be augmented; but if the fire is furious and the houses fall down the dreamer may expect losses disappointments shame and death.[or]To dream you burn yourself is a sign the malice of a stupid enemy will be foiled.[or]Play your age first.[cycling]"
"buying"	"[one of]To dream you buy all sorts of things that one uses is good; to buy that which is only for victuals and relief is good for the poor; but to the rich it signifies expenses and great charges.[cycling]"
"carrying"	"[one of]To dream that one is carrying another is better than to dream one is carried; to be carried by a woman a child or a poor person means profit and success; by a rich person the contrary.[cycling]"
"carving"	"[one of]To dream of carving a fowl, indicates you will be poorly off in a worldly way.[or]Companions will cause you vexation from continued ill temper.[or]Carving meat, denotes bad investments, but, if a change is made, prospects will be brighter.[cycling]"
"christening"	"[one of]To dream that you are present at a christening is a good sign you will get what you hope for; to a maid it signifies that she will soon be married.[cycling]"
"churning"	"[one of]To dream of churning, you will have difficult tasks set you, but by diligence and industry you will accomplish them and be very prosperous.[or]To the farmer, it denotes profit from a plenteous harvest; to a young woman, it denotes a thrifty and energetic husband.[cycling]"
"climbing"	"[one of]To dream that you are climbing up a tree, denotes that you will be successful in life.[or]To dream you are climbing up a very steep hill or place, foretells many difficulties in life, and much sickness.[or]If you reach the top, you will get over all your difficulties and recover from your illness; but if you awake before you have attained the top, you will be disappointed in love and all other projects and die in your next illness.[cycling]"
"hunting"	"[one of]To dream you are hunting and that the game is killed, shows much trouble through the pretensions of false friends, but that you will discover them and overcome all their machinations.[or]To dream of going a hunting brings an accusation of dishonesty: if you are returning from the chase good fortune awaits you.[cycling]"
"hugging"	"[one of]If you dream of hugging, you will be disappointed in love affairs and in business.[or]For a woman to dream of hugging a man, she will accept advances of a doubtful character from men.[or]For a married woman to hug others than her husband, she will endanger her honor in accepting attentions from others in her husband's absence.[cycling]"
"ironing"	"[one of]To dream of ironing, denotes domestic comforts and orderly business.[or]If a woman dreams that she burns her hands while ironing, it foretells she will have illness or jealousy to disturb her peace.[or]If she scorches the clothes, she will have a rival who will cause her much displeasure and suspicions.[or]If the irons seem too cold, she will lack affection in her home.[cycling]"
"jumping"	"[one of]If you dream of jumping over any object, you will succeed in every endeavor; but if you jump and fall back, disagreeable affairs will render life almost intolerable.[or]To jump down from a wall, denotes reckless speculations and disappointment in love.[cycling]"
"interceding for"	"[one of]To intercede for some one in your dreams, shows you will secure aid when you desire it most.[cycling]"
"killing"	"[one of]To dream of killing a defenseless man, prognosticates sorrow and failure in affairs.[or]If you kill one in defense, or kill a ferocious beast, it denotes victory and a rise in position.[cycling]"
"leaking"	"[one of]To dream of seeing a leak in anything, is usually significant of loss and vexations.[cycling]"
"leaping"	"[one of]To dream you are leaping over walls, doors or gates, is a sign that you will encounter many difficulties in your present pursuits, and that your sweetheart will not marry you.[cycling]"
"leaping"	"[one of]For a young woman to dream of leaping over an obstruction, denotes that she will gain her desires after much struggling and opposition.[cycling]"
"leaping"	"[one of]To dream you are leaping over walls doors or gates is a sign that you will encounter many difficulties in your present pursuits and that your sweetheart will not marry you.[cycling]"
"learning"	"[one of]To dream of learning, denotes that you will take great interest in acquiring knowledge, and if you are economical of your time, you will advance far into the literary world.[or]To enter halls, or places of learning, denotes rise from obscurity, and finance will be a congenial adherent.[or]To see learned men, foretells that your companions will be interesting and prominent.[or]For a woman to dream that she is associated in any way with learned people, she will be ambitious and excel in her endeavors to rise into prominence.[cycling]"
"lending"	"[one of]To dream that you are lending money, foretells difficulties in meeting payments of debts and unpleasant influence in private.[or]To lend other articles, denotes impoverishment through generosity.[or]To refuse to lend things, you will be awake to your interests and keep the respect of friends.[or]For others to offer to lend you articles, or money, denotes prosperity and close friendships.[cycling]"
"lying"	"[one of]To tell a lie in a dream is not good, except by players and jesters, who practise it, and deceive people.[cycling]"
"lying"	"[one of]To dream that you are lying to escape punishment, denotes that you will act dishonorably towards some innocent person.[or]Lying to protect a friend from undeserved chastisement, denotes that you will have many unjust criticisms passed upon your conduct, but you will rise above them and enjoy prominence.[or]To hear others lying, denotes that they are seeking to entrap you.[or]To dream of seeing a lynx, enemies are undermining your business and disrupting your home affairs.[or]For a woman, this dream indicates that she has a wary woman rivaling her in the affections of her lover.[or]If she kills the lynx, she will overcome her rival.[cycling]"
"mending"	"[one of]To dream of mending soiled garments, denotes that you will undertake to right a wrong at an inopportune moment; but if the garment be clean, you will be successful in adding to your fortune.[or]For a young woman to dream of mending, foretells that she will be a systematic help to her husband.[cycling]"
"milking"	"[one of]To dream of milking, and it flows in great streams from the udder, while the cow is restless and threatening, signifies you will see great opportunities withheld from you, but which will result in final favor for you.[cycling]"
"mining"	"[one of]To see mining in your dreams, denotes that an enemy is seeking your ruin by bringing up past immoralities in your life.[or]You will be likely to make unpleasant journeys, if you stand near the mine.[or]If you dream of hunting for mines, you will engage in worthless pursuits.[cycling]"
"mourning"	"[one of]To dream that you wear mourning, omens ill luck and unhappiness.[or]If others wear it, there will be disturbing influences among your friends causing you unexpected dissatisfaction and loss.[or]To lovers, this dream foretells misunderstanding and probable separation.[cycling]"
"mourning"	"[one of]To dream that you are dressed in mourning for the death of a relative is a sign that a wedding will soon take place in your family or that of some blood relation.[or]To see people dressed in black and be among them foretells an invitation to a wedding or to be present at a marriage ceremony.[cycling]"
"moving"	"[one of]To dream of moving your residence or place of business under any circumstances is a sign of poverty: if in your dream you see other people moving it foretells that some one of your relatives will come to poverty and you will have to assist him.[cycling]"
"nursing"	"[one of]For a woman to dream of nursing her baby, denotes pleasant employment.[or]For a young woman to dream of nursing a baby, foretells that she will occupy positions of honor and trust.[or]For a man to dream of seeing his wife nurse their baby, denotes harmony in his pursuits.[cycling]"
"offering"	"[one of]To bring or make an offering, foretells that you will be cringing and hypocritical unless you cultivate higher views of duty.[cycling]"
"painting"	"[one of]To dream of painting your house is a sign of sickness in the family but at the same time thrift and good luck in business: if in your dream you see a white house newly painted outside you will probably soon be summoned to attend a funeral: to see any other colored house newly painted foretells that you will hear of the sickness of a friend or relative: dreaming of beautiful paintings of landscapes portraits &c is an omen of bad luck and poverty.[cycling]"
"parting"	"[one of]To dream of parting with friends and companions, denotes that many little vexations will come into your daily life.[or]If you part with enemies, it is a sign of success in love and business.[cycling]"
"parting"	"[one of]To dream of parting from friends with regret is a sign of disappointment: if a girl dreams that her lover is going away anywhere and she feels bad when he takes his leave it predicts that he will not 'go raving distracted with delight' the next time he comes to see her and she will consequently be disappointed at his supposed coolness; but all this may not amount to anything more than to make her feel bad for the time being.[cycling]"
"ploughing"	"[one of]To dream of ploughing is good; but if the horse seems to sink into the ground, it portends loss of labor, dearth of corn, and ill harvest weather.[cycling]"
"plowing"	"[one of]For a farmer to dream that he is plowing on smooth and even ground denotes heavy crops and good luck generally: if he plows up stones it is all the better but if his plow gets hitched into a rock or stump it denotes vexation and trouble with his good luck.[cycling]"
"polishing"	"[one of]To dream of polishing any article, high attainments will place you in enviable positions.[cycling]"
"quilting"	"[one of]To dream you are quilting, foretells to an unmarried female that she will soon be wedded.[or]It is also a good and lucky dream to a man.[or]To be at a quilting party is good.[cycling]"
"quilting"	"[one of]If a lady dreams of going to a quilting party it foretells for her and her family thrift and good luck: gentlemen who dream of being much entertained at such a party will have the very best success in love matters.[cycling]"
"racing"	"[one of]To dream you are running a race, is a token of good; presages much success in life, and that you will speedily hear some joyful news.[or]In love, it denotes that you will conquer all your rivals, and be happy in the union with the object of your affections.[or]To dream you are riding a race, shows disappointment and anger, bad success in trade and in love.[or]To a married woman, it denotes the loss of her husband’s affections, and that her children will be in trouble.[cycling]"
"raking"	"[one of]For a girl to dream of raking newly mown hay is a sign she will be married before the hay is eaten: young fellows who dream of raking hay with their sweethearts had better get ready their necks for the matrimonial noose as they are past praying for.[cycling]"
"reading"	"[one of]To dream you are reading an agreeable book, shows you will be successful in love, and that you will become rich.[or]In trade, it is propitious.[cycling]"
"reading"	"[one of]To be engaged in reading in your dreams, denotes that you will excel in some work, which appears difficult.[or]To see others reading, denotes that your friends will be kind, and are well disposed.[or]To give a reading, or to discuss reading, you will cultivate your literary ability.[or]Indistinct, or incoherent reading, implies worries and disappointments.[cycling]"
"reading"	"[one of]To dream you are reading indicates you will be successful in your love; in trade it is particularly propitious; but if it appear to be painful or irksome to read it signifies that you shall not succeed without exertion.[cycling]"
"reaping"	"[one of]To dream of reaping grain is an excellent omen as it foretells thrift and abundance as well as plenty of money in gold; this applies to a prolific field of ripe yellow grain; if the grain is meagre and looks rusty the sign is entirely different as it betokens scarcity and penury.[cycling]"
"riding"	"[one of]To dream you are riding, if it be with a woman, is very fortunate.[or]If you are in trade, business will decay.[cycling]"
"riding"	"[one of]To dream you are riding if it be with a woman is unfortunate: in trade decay of business; in love disappointments; but if it be with men then by care the reverse of these things will happen.[or]Riding in a railcar or a stage foretells success in business matters.[cycling]"
"rising"	"[one of]To dream of rising to high positions, denotes that study and advancement will bring you desired wealth.[or]If you find yourself rising high into the air, you will come into unexpected riches and pleasures, but you are warned to be careful of your engagements, or you may incur displeasing prominence.[cycling]"
"rowing"	"[one of]To dream that you are rowing in a boat, signifies that you will be successful in love and business.[cycling]"
"rowing"	"[one of]To dream of rowing a boat in clear water is a sign of good luck generally: if the water is muddy it shows trouble and difficulties which may be overcome; if a lover dreams of rowing a boat with his lady-love in it he will doubtless make a happy match.[cycling]"
"running"	"[one of]To dream of running in company with others, is a sign that you will participate in some festivity, and you will find that your affairs are growing towards fortune.[or]If you stumble or fall, you will lose property and reputation.[or]Running alone, indicates that you will outstrip your friends in the race for wealth, and you will occupy a higher place in social life.[or]If you run from danger, you will be threatened with losses, and you will despair of adjusting matters agreeably.[or]To see others thus running, you will be oppressed by the threatened downfall of friends.[or]To see stock running, warns you to be careful in making new trades or undertaking new tasks.[cycling]"
"sailing"	"[one of]To dream of sailing on calm waters, foretells easy access to blissful joys, and immunity from poverty and whatever brings misery.[or]To sail on a small vessel, denotes that your desires will not excel your power of possessing them.[or]Ocean and.[cycling]"
"sailing"	"[one of]To dream of fair sailing on clear water is an excellent omen as it foretells abundance and success: heavy winds that endanger your boat or muddy waters point out difficulties which will probably be overcome .[cycling]"
"sawing"	"[one of]To dream of sawing wood or boards foretells that you will do something that you will afterwards regret: if a young fellow dreams this he will probably offer some indignity to his sweetheart which he will find it hard work to get overlooked.[cycling]"
"scalding"	"[one of]To dream of being scalded, portends that distressing incidents will blot out pleasurable anticipations.[cycling]"
"sewing"	"[one of]To dream of sewing on new garments, foretells that domestic peace will crown your wishes.[cycling]"
"shaving"	"[one of]To dream you are being shaved, or that your head has been shaved, is a very unfavorable omen; in love, it denotes treachery and disappointment; and in the married state, infidelity and discord.[or]To the tradesman, it denotes loss of goods and business; to the sailor, an unpleasant and stormy voyage; to the farmer, it prefigures bad crops and diseases amongst his live stock.[cycling]"
"shaving"	"[one of]To dream that you are being shaved, portends that you will let imposters defraud you.[or]To shave yourself, foretells that you will govern your own business and dictate to your household, notwithstanding that the presence of a shrew may cause you quarrels.[or]If your face appears smooth, you will enjoy quiet, and your conduct will hot be questioned by your companions.[or]If old and rough, there will be many squalls or, the matrimonial sea.[or]If your razor is dull and pulls your face, you will give your friends cause to criticize your private life.[or]If your beard seems gray, you will be absolutely devoid of any sense of justice to those having claims upon you.[or]For a woman to see men shaving, foretells that her nature will become sullied by indulgence in gross pleasures.[or]If she dreams of being shaved, she will assume so much masculinity that men will turn from her in disgust.[cycling]"
"shooting"	"[one of]To dream you are out shooting, is very favorable, if you kill much game.[or]To the lover, it shows a mistress kind and good humored, who will make him an excellent and notable wife.[or]To the tradesman and farmer, success and riches.[or]To the sailor, wealth acquired in a distant country.[or]But if you dream you kill little or no game, then it presages bad luck, and disappointment in love.[or]To dream you are shooting with a bow and arrow, is a very favorable dream, particularly to the lover and tradesman.[cycling]"
"shooting"	"[one of]To dream that you see or hear shooting, signifies unhappiness between married couples and sweethearts because of over-weaning selfishness, also unsatisfactory business and tasks because of negligence.[cycling]"
"skating"	"[one of]To dream of skating over smooth ice and gliding along without much effort is a sign of success and good luck: if you are skating with ladies it foretells that your love matters will go smoothly; if the ice be broken or lumpy it denotes difficulties; and if you imagine you fall down you will probably experience a misfortune or have great trouble.[cycling]"
"sliding"	"[one of]To dream of sliding, portends disappointments in affairs, and sweethearts will break vows.[or]To slide down a hillside covered with green grass, foretells that you will be deceived into ruin by flattering promises.[cycling]"
"sliding"	"[one of]To dream of sliding on smooth ice foretells good luck: if a girl dreams that a young man assists her in sliding and that she enjoys it she will soon get an agreeable lover: ragged or wet ice or holes in the ice foreshadow difficulties.[or]If a girl dreams of falling down on the ice and that her lover falls with her and overtops her they may as well go to the parson at once and have the knot tied as it is a sure thing to happen.[cycling]"
"sowing"	"[one of]To dream that you are sowing seed, foretells to the farmer fruitful promises, if he sows in new ploughed soil.[or]To see others sowing, much business activity is portended, which will bring gain to all.[cycling]"
"spinning"	"[one of]To dream of spinning is good, and shows a person to be diligent and industrious.[cycling]"
"spinning"	"[one of]To dream that you are spinning, means that you will engage in some enterprise, which will be all you could wish.[cycling]"
"spitting"	"[one of]To dream of spitting, denotes unhappy terminations of seemingly auspicious undertakings.[or]For some one to spit on you, foretells disagreements and alienation of affections.[cycling]"
"squinting"	"[one of]To dream that you see some person with squinting eyes, denotes that you will be annoyed with unpleasant people.[or]For a man to dream that his sweetheart, or some good-looking girl, squints her eyes at him, foretells that he is threatened with loss by seeking the favors of women.[or]For a young woman to have this dream about men, she will be in danger of losing her fair reputation.[cycling]"
"squinting"	"[one of]If a girl dreams of seeing a good-looking young man who squints it is a sign that some one has fallen in love with her and only waits an opportunity to demonstrate his passion: if a gentleman dreams that his sweetheart squints it foretells that she is thinking about some one else rather than him and would not break her heart if he refused to 'come to tea.'[cycling]"
"starching"	"[one of]To dream you are starching linen, shows you will be married to an industrious person, and you will be successful in life and save money.[or]It also shows that you are about to receive a letter containing some pleasant news.[cycling]"
"stealing"	"[one of]If you dream of being robbed it is a sign that you will make a good speculation of some kind; to dream of stealing any particular article yourself foretells that you will soon want just that thing; thus if you imagine that you steal money you will be badly in want of some.[cycling]"
"suffocating"	"[one of]To dream that you are suffocating, denotes that you will experience deep sorrow and mortification at the conduct of some one you love.[or]You should be careful of your health after this dream.[cycling]"
"swearing"	"[one of]To dream of swearing, denotes some unpleasant obstructions in business.[or]A lover will have cause to suspect the faithfulness of his affianced after this dream.[or]To dream that you are swearing before your family, denotes that disagreements will soon be brought about by your unloyal conduct.[cycling]"
"swearing"	"[one of]To dream that you hear violent altercations and profane swearing is a sign that you will lose caste and go down in the world: if a man dreams that in his anger he curses and swears it foretells that he will come to poverty.[cycling]"
"sweeping"	"[one of]To dream of sweeping, denotes that you will gain favor in the eyes of your husband, and children will find pleasure in the home.[or]If you think the floors need sweeping, and you from some cause neglect them, there will be distresses and bitter disappointments awaiting you in the approaching days.[or]To servants, sweeping is a sign of disagreements and suspicion of the intentions of others.[cycling]"
"sweeping"	"[one of]For a girl to dream of sweeping the house foretells that a lover will soon make his appearance: if a married woman dreams this it shows that some outsider is charmed with her and may venture to make dishonorable proposals.[cycling]"
"teasing"	"[one of]To find yourself teasing any person while dreaming, denotes that you will be loved and sought after because of your cheerful and amiable manners.[or]Your business will be eventually successful.[or]To dream of being teased, denotes that you will win the love of merry and well-to-do persons.[or]For a young woman to dream of being teased, foretells that she will form a hasty attachment, but will not be successful in consummating an early marriage.[cycling]"
"threshing"	"[one of]To dream of threshing grain, denotes great advancement in business and happiness among families.[or]But if there is an abundance of straw and little grain, unsuccessful enterprises will be undertaken.[or]To break down or have an accident while threshing, you will have some great sorrow in the midst of prosperity.[cycling]"
"traveling"	"[one of]If one dreams that he is traveling through a wood and that he sticketh in the briars and bushes, it betokens many troubles and hindrances.[or]To travel over high hills and mountains and rocky places, signifies advancement, but with much difficulty obtained.[cycling]"
"traveling"	"[one of]To dream of traveling, signifies profit and pleasure combined.[or]To dream of traveling through rough unknown places, portends dangerous enemies, and perhaps sickness.[or]Over bare or rocky steeps, signifies apparent gain, but loss and disappointment will swiftly follow.[or]If the hills or mountains are fertile and green, you will be eminently prosperous and happy.[or]To dream you travel alone in a car, denotes you may possibly make an eventful journey, and affairs will be worrying.[or]To travel in a crowded car, foretells fortunate adventures, and new and entertaining companions.[cycling]"
"traveling"	"[one of]To dream of traveling by railroad or steamboat is a very good omen as it denotes thrift and success in your business; but if you dream you are journeying in your own private coach it foreshadows poverty in the end though you may have temporary good luck: if you dream you have crossed the ocean and find yourself in a foreign country you may be sure that goodfortune will attend all your business transactions.[cycling]"
"varnishing"	"[one of]To dream of varnishing anything, denotes that you will seek to win distinction by fraudulent means.[or]To see others varnishing, foretells that you are threatened with danger from the endeavor of friends to add to their own possessions.[cycling]"
"varnishing"	"[one of]To dream that your house or furniture is being or has been newly varnished is a sign of a funeral; but if you imagine that you are varnishing anything it merely foretells a loss with out a death.[cycling]"
"vomiting"	"[one of]To dream of vomiting is usually a sign of health: if you imagine that you vomit up worms it foretells that you will have good luck in preventing a loss or a robbery.[cycling]"
"wading"	"[one of]If you wade in clear water while dreaming, you will partake of evanescent, but exquisite joys.[or]If the water is muddy, you are in danger of illness, or some sorrowful experiences.[or]To see children wading in clear water is a happy prognostication, as you will be favored in your enterprises.[or]For a young woman to dream of wading in clear foaming water, she will soon gain the desire nearest her heart.[cycling]"
"wading"	"[one of]If a girl dreams of wading in clear water it is a sign that she will soon marry and be delighted with her husband’s embraces: if she imagines that the water is rily or muddy it foretells that she will enjoy the pleasures of illicit love.[or]If a man dreams of wading it denotes that he will be engaged in some intrigue with a female—thedeeper the water the more difficult the realization of his wishes: muddy water denotes loose women.[cycling]"
"walking"	"[one of]To dream one is walking in the dirt, or among thorns, signifies sickness.[or]To dream one is walking in the water, or some torrent, signifies adversity and grief.[cycling]"
"walking"	"[one of]To dream of walking through rough brier, entangled paths, denotes that you will be much distressed over your business complications, and disagreeable misunderstandings will produce coldness and indifference.[or]To walk in pleasant places, you will be the possessor of fortune and favor.[or]To walk in the night brings misadventure, and unavailing struggle for contentment.[or]For a young woman to find herself walking rapidly in her dreams, denotes that she will inherit some property, and will possess a much desired object.[cycling]"
"walking"	"[one of]To dream you are walking in a dirty and muddy place foretells sickness and vexation: in love it denotes bad temper and disappointment.[cycling]"
"waltzing"	"[one of]To dream you are waltzing with some agreeable partner, is an indication that you will be subjected to some unpleasant treatment from one from whom you expected nothing but kindness.[cycling]"
"washing"	"[one of]For a man to dream he washes or bathes himself in baths or hot-houses, signifies riches, prosperity and health to the sick.[or]But to dream he washes or bathes himself contrary to the common custom, or in his clothes, is evil and betokeneth sickness and great danger.[or]To dream that you were in fountains, ponds or current water, and in fair and clear floods, is good, but not that you swim, for that is a sign of danger and sickness.[or]Washing is a sure sign of removal.[cycling]"
"washing"	"[one of]To dream that you are washing yourself, signifies that you pride yourself on the numberless liaisons you maintain.[or]Bowl or.[cycling]"
"washing"	"[one of]To dream of washing foretells change of abode and if you wash in clear cold water the dream is an omen of good; but.[or]If the water is dirty or turbid it is the reverse.[or]If a woman dream she is washing clothes it is a sign she will hear good news within twenty-four hours.[cycling]"
"weaving"	"[one of]To dream that you are weaving, denotes that you will baffle any attempt to defeat you in the struggle for the up-building of an honorable fortune.[or]To see others weaving shows that you will be surrounded by healthy and energetic conditions.[cycling]"
"weeding"	"[one of]To dream that you are weeding, foretells that you will have difficulty in proceeding with some work which will bring you distinction.[or]To see others weeding, you will be fearful that enemies will upset your plans.[cycling]"
"weeping"	"[one of]To dream one weeps or grieves, whether it be for a friend departed or any other cause, is joy and mirth.[cycling]"
"weeping"	"[one of]Weeping in your dreams, foretells ill tidings and disturbances in your family.[or]To see others weeping, signals pleasant reunion after periods of saddened estrangements.[or]This dream for a young woman is ominous of lovers' quarrels, which can only reach reconciliation by self-abnegation.[or]For the tradesman, it foretells temporary discouragement and reverses.[cycling]"
"weighing"	"[one of]To dream of weighing, denotes that you are approaching a prosperous period, and if you set yourself determinedly toward success you will victoriously reap the full fruition of your labors.[or]To weigh others, you will be able to subordinate them to your interest.[or]For a young woman to weigh with her lover, foretells that he will be ready at all times to comply with her demands.[cycling]"
"writing"	"[one of]Dreaming of writing ever means nerve; ’Twill grant or deny, will give or refuse.[or]To dream that you are writing, foretells that you will make a mistake which will almost prove your undoing.[or]To see writing, denotes that you will be upbraided for your careless conduct and a lawsuit may cause you embarrassment.[or]To try to read strange writing, signifies that you will escape enemies only by making no new speculation after this dream.[or]To dream of writing a letter foretells that absent friends are about to visit you: if a girl dreams of writing a love-letter it is a sign that her lover will soon return and clasp her in his arms if she allows any such familiarities.[or]To dream you make a blot while writing is a sign of sickness.[cycling]"
"abhoring"	"[one of]To dream that you abhor a person, denotes that you will entertain strange dislike for some person, and your suspicion of his honesty will prove correct.[or]To think yourself held in abhorrence by others, predicts that your good intentions to others will subside into selfishness.[or]For a young woman to dream that her lover abhors her, foretells that she will love a man who is in no sense congenial.[cycling]"
"accusing"	"[one of]To dream that you accuse any one of a mean action, denotes that you will have quarrels with those under you, and your dignity will be thrown from a high pedestal.[or]If you are accused, you are in danger of being guilty of distributing scandal in a sly and malicious way.[or]See similar words in following chapters.[or]To dream a person accuses you of any thing is favorable to the dreamer.[cycling]"
"admiring"	"[one of]To dream that you are an object of admiration, denotes that you will retain the love of former associates, though your position will take you above their circle.[cycling]"
"admonishing"	"[one of]To admonish your child, or son, or some young person, denotes that your generous principles will keep you in favor, and fortune will be added to your gifts.[cycling]"
"adulating"	"[one of]To dream that you seek adulation, foretells that you will pompously fill unmerited positions of honor.[or]If you offer adulation, you will expressly part with some dear belonging in the hope of furthering material interests.[cycling]"
"advising"	"[one of]To dream that you receive advice, denotes that you will be enabled to raise your standard of integrity, and strive by honest means to reach independent competency and moral altitude.[or]To dream that you seek legal advice, foretells that there will be some transactions in your affairs which will create doubt of their merits and legality.[cycling]"
"advocating"	"[one of]To dream that you advocate any cause, denotes that you will be faithful to your interests, and endeavor to deal honestly with the public, as your interests affect it, and be loyal to your promises to friends.[cycling]"
"stealing"	"[one of]To dream that you are accused of stealing something, is an indication that you will have a handsome present given you.[cycling]"
"stealing"	"[one of]To dream of stealing, or of seeing others commit this act, foretells bad luck and loss of character.[or]To be accused of stealing, denotes that you will be misunderstood in some affair, and suffer therefrom, but you will eventually find that this will bring you favor.[or]To accuse others, denotes that you will treat some person with hasty inconsideration.[cycling]"
"afflicting"	"[one of]To dream that affliction lays a heavy hand upon you and calls your energy to a halt, foretells that some disaster is surely approaching you.[or]To see others afflicted, foretells that you will be surrounded by many ills and misfortunes.[cycling]"
"ascending"	"[one of]For one to dream they ascend towards the skies is favorable, particularly so if the clouds appear bright.[cycling]"
"ascending"	"[one of]If you reach the extreme point of ascent, or top of steps, without stumbling, it is good; otherwise, you will have obstacles to overcome before the good of the day is found.[cycling]"
"assisting"	"[one of]Giving assistance to any one in a dream, foretells you will be favored in your efforts to rise to higher position.[or]If any one assists you, you will be pleasantly situated, and loving friends will be near you.[cycling]"
"banishing"	"[one of]Evil pursues the unfortunate dreamer.[or]If you are banished to foreign lands, death will be your portion at an early date.[or]To banish a child, means perjury of business allies.[or]It is a dream of fatality.[cycling]"
"beating"	"[one of]It bodes no good to dream of being beaten by an angry person; family jars and discord are signified.[or]To beat a child, ungenerous advantage is taken by you of another; perhaps the tendency will be to cruelly treat a child.[cycling]"
"blaspheming"	"[one of]Blasphemy, denotes an enemy creeping into your life, who under assumed friendship will do you great harm.[or]To dream you are cursing yourself, means evil fortune.[or]To dream you are cursed by others, signifies relief through affection and prosperity.[or]The interpretation of this dream here given is not satisfactory.[cycling]"
"blaspheming"	"[one of]If you dream that you are cursing it foretells bad fortune; if you are cursed all your expectations will be fulfilled.[cycling]"
"break"	"[one of]Breakage is a bad dream.[or]To dream of breaking any of your limbs, denotes bad management and probable failures.[or]To break furniture, denotes domestic quarrels and an unquiet state of the mind.[or]To break a window, signifies bereavement.[or]To see a broken ring order will be displaced by furious and dangerous uprisings, such as jealous contentions often cause.[cycling]"
"cheating"	"[one of]To dream of being cheated in business, you will meet designing people who will seek to close your avenues to fortune.[or]For young persons to dream that they are being cheated in games, portend they will lose their sweethearts through quarrels and misunderstandings.[cycling]"
"chastising"	"[one of]To dream of being chastised, denotes that you have not been prudent in conducting your affairs.[or]To dream that you administer chastisement to another, signifies that you will have an ill-tempered partner either in business or marriage.[or]For parents to dream of chastising their children, indicates they will be loose in their manner of correcting them, but they will succeed in bringing them up honorably.[cycling]"
"climbing"	"[one of]If you dream of climbing it is a sign you will have some dignity conferred upon you or that your circumstances in life will improve.[or]To unmarried people it predicts that they will marry above their station.[cycling]"
"climbing"	"[one of]To dream of climbing up a hill or mountain and reaching the top, you will overcome the most formidable obstacles between you and a prosperous future; but if you should fail to reach the top, your dearest plans will suffer being wrecked.[or]To climb a ladder to the last rung, you will succeed in business; but if the ladder breaks, you will be plunged into unexpected straits, and accidents may happen to you.[or]To see yourself climbing the side of a house in some mysterious way in a dream, and to have a window suddenly open to let you in, foretells that you will make or have made extraordinary ventures against the approbation of friends, but success will eventually crown your efforts, though there will be times when despair will almost enshroud you.[or]Hill and.[cycling]"
"combing"	"[one of]For any person to dream of combing him or herself, is good, both for man or woman, for it signifies to get out of evil times or affairs.[cycling]"
"combing"	"[one of]To dream of combing one's hair, denotes the illness or death of a friend or relative.[or]Decay of friendship and loss of property is also indicated by this dream.[cycling]"
"commanding"	"[one of]To dream you command any one, signifies trouble; to dream you see one command, signifies anger and authority.[cycling]"
"commanding"	"[one of]To dream of being commanded, denotes that you will be humbled in some way by your associates for scorn shown your superiors.[or]To dream of giving a command, you will have some honor conferred upon you.[or]If this is done in a tyrannical or boastful way disappointments will follow.[cycling]"
"commanding"	"[one of]To dream you command any one shows trouble; to dream you see one command signifies anger and authority.[cycling]"
"completing"	"[one of]To dream of completing a task or piece of work, denotes that you will have acquired a competency early in life, and that you can spend your days as you like and wherever you please.[or]For a young woman to dream that she has completed a garment, denotes that she will soon decide on a husband.[or]To dream of completing a journey, you will have the means to make one whenever you like.[cycling]"
"composing"	"[one of]To see in your dreams a composing stick, foretells that difficult problems will disclose themselves, and you will be at great trouble to meet them.[cycling]"
"conjuring"	"[one of]To dream that you are in a hypnotic state or under the power of others, portends disastrous results, for your enemies will enthrall you; but if you hold others under a spell you will assert decided will power in governing your surroundings.[or]For a young woman to dream that she is under strange influences, denotes her immediate exposure to danger, and she should beware.[or]To dream of seeing hypnotic and slight-of-hand performances, signifies worries and perplexities in business and domestic circles, and unhealthy conditions of state.[cycling]"
"cooking"	"[one of]To cook a meal, denotes some pleasant duty will devolve on you.[or]Many friends will visit you in the near future.[or]If there is discord or a lack of cheerfulness you may expect harassing and disappointing events to happen.[cycling]"
"counting"	"[one of]To dream of counting your children, and they are merry and sweet-looking, denotes that you will have no trouble in controlling them, and they will attain honorable places.[or]To dream of counting money, you will be lucky and always able to pay your debts; but to count out money to another person, you will meet with loss of some kind.[or]Such will be the case, also, in counting other things.[or]If for yourself, good; if for others, usually bad luck will attend you.[cycling]"
"decorating"	"[one of]To dream of decorating a place with bright-hued flowers for some festive occasion, is significant of favorable turns in business, and, to the young, of continued rounds of social pleasures and fruitful study.[or]To see the graves or caskets of the dead decorated with white flowers, is unfavorable to pleasure and worldly pursuits.[or]To be decorating, or see others decorate for some heroic action, foretells that you will be worthy, but that few will recognize your ability.[cycling]"
"delighting"	"[one of]To dream of experiencing delight over any event, signifies a favorable turn in affairs.[or]For lovers to be delighted with the conduct of their sweethearts, denotes pleasant greetings.[or]To feel delight when looking on beautiful landscapes, prognosticates to the dreamer very great success and congenial associations.[cycling]"
"demanding"	"[one of]To dream that a demand for charity comes in upon you, denotes that you will be placed in embarrassing situations, but by your persistency you will fully restore your good standing.[or]If the demand is unjust, you will become a leader in your profession.[or]For a lover to command you adversely, implies his, or her, leniency.[cycling]"
"disputing"	"[one of]To dream of holding disputes over trifles, indicates bad health and unfairness in judging others.[or]To dream of disputing with learned people, shows that you have some latent ability, but are a little sluggish in developing it.[cycling]"
"hating"	"[one of]To dream of hatred or being hated, whether of friends or enemies, is ill.[cycling]"
"hating"	"[one of]To dream that you hate any particular person is a sign that he or she has been talking bad about you.[or]If a girl should ever be so silly as to dream such a dream about her lover it shows that he meditates an attack upon her chastity; on the contrary if she dreams that he hates her it is a sign that she possesses his whole heart.[cycling]"
"slighting"	"[one of]To dream of slighting any person or friend, denotes that you will fail to find happiness, as you will cultivate a morose and repellent bearing.[or]If you are slighted, you will have cause to bemoan your unfortunate position.[cycling]"
"vaccinating"	"[one of]To dream of being vaccinated foretells good health; and if you imagine that you have a large sore on your arm from vaccination it is a sign that you will present to some one a liberal gift and receive much honor.[cycling]"
"whitewashing"	"[one of]To dream that you are whitewashing, foretells that you will seek to reinstate yourself with friends by ridding yourself of offensive habits and companions.[or]For a young woman, this dream is significant of well-laid plans to deceive others and gain back her lover who has been estranged by her insinuating bearing toward him.[cycling]"
"whitewashing"	"[one of]To dream of having your house or place of business whitewashed is an excellent omen as it promises you good health and a good name and repute among your friends: if a woman dreams of whitewashing her house or any part of it it foretells that she will have a son who will be distinguished or that some act of hers will attract public attention.[cycling]"
"undressing"	"[one of]To see your wife undress signifies wantonness; to undress in the presence of others slander; to undress in your room alone the discovery of secrets.[cycling]"
"torturing"	"[one of]To dream of being tortured, denotes that you will undergo disappointment and grief through the machination of false friends.[or]If you are torturing others, you will fail to carry out well-laid plans for increasing your fortune.[or]If you are trying to alleviate the torture of others, you will succeed after a struggle in business and love.[cycling]"
"vaccinating"	"[one of]To dream of being vaccinated, foretells that your susceptibility to female charms will be played upon to your sorrow.[or]To dream that others are vaccinated, shows you will fail to find contentment where it is sought, and your affairs will suffer decline in consequence.[or]For a young woman to be vaccinated on her leg, foreshadows her undoing through treachery.[cycling]"
"leaving"	"[one of]To dream of bidding cheerful adieus to people, denotes that you will make pleasant visits and enjoy much social festivity; but if they are made in a sad or doleful strain, you will endure loss and bereaving sorrow.[or]If you bid adieu to home and country, you will travel in the nature of an exile from fortune and love.[or]To throw kisses of adieu to loved ones, or children, foretells that you will soon have a journey to make, but there will be no unpleasant accidents or happenings attending your trip.[cycling]"
"leaving"	"[one of]To dream of bidding farewell, is not very favorable, as you are likely to hear unpleasant news of absent friends.[or]For a young woman to bid her lover farewell, portends his indifference to her.[or]If she feels no sadness in this farewell, she will soon find others to comfort her.[cycling]"


Table of Conditions
Affliction	Interpretation
"struggling"	"[one of]To dream of struggling, foretells that you will encounter serious difficulties, but if you gain the victory in your struggle, you will also surmount present obstacles.[cycling]"
"falling"	"[one of]To dream you are falling from an eminence shows you will have some dignity conferred upon you or else will marry above your sphere.[or]If a young girl dreams this it is a sign she will marry a rich husband.[cycling]"
"flying"	"[one of]To dream you are flying is a very excellent omen; if you are in love your sweetheart will be true to you; and if you marry you will have many children who will all do very well and be happy.[cycling]"
"flying"	"[one of]To dream you are flying, is a very excellent omen.[or]It foretells elevation of fortune.[or]That you will arrive at dignity in the state and be happy.[or]If you are in love, your sweetheart will be true to you, and if you marry, you will have many children, who will all do very well and be very happy.[or]It indicates that you will take a long journey, which will turn out advantageous to you.[cycling]"
"swimming"	"[one of]To dream you are swimming, with your head above the water, denotes great success in your undertakings, whether they be in love, trade, sea or farming.[or]To dream you are swimming with your head under water, shows that you will experience some great trouble and hear some very unpleasant news from a person you thought dead.[or]In trade, it shows loss of business.[cycling]"
"swimming"	"[one of]To dream of swimming is an excellent omen as it foretells success and good fortune generally: if you dream you are swimming or bathing in clear water with ladies it predicts that you will soon marry the one of your choice particularly if she be present; and to dream you are naked and swimming in clear water is a sign of excellent luck in business matters.[cycling]"
"talking"	"[one of]To dream that you are talking loudly of some matter or person with whom you are not on the most friendly terms, signifies that troubles are about to visit you.[or]To dream that some person is talking about you, is an indication that you will be gladdened by having a proposal made to you that will be to your interest to agree to.[cycling]"
"talking"	"[one of]To dream of talking, denotes that you will soon hear of the sickness of relatives, and there will be worries in your affairs.[or]To hear others talking loudly, foretells that you will be accused of interfering in the affairs of others.[or]To think they are talking about you, denotes that you are menaced with illness and disfavor.[cycling]"
"thirsty"	"[one of]To dream of being thirsty, shows that you are aspiring to things beyond your present reach; but if your thirst is quenched with pleasing drinks, you will obtain your wishes.[or]To see others thirsty and drinking to slake it, you will enjoy many favors at the hands of wealthy people.[cycling]"
"hanged"	"[one of]To dream of seeing people hanged, or that you are going to be hanged yourself, denotes that you will rise above your present condition by marriage.[cycling]"
"hanged"	"[one of]To dream of being hanged is an excellent omen as it foretells that you will become either rich or distinguished.[or]If you dream you are going to be hanged it is nearly as good as it betokens success in all your undertakings; but should you imagine that you eluded the officers of the law and escaped that is a bad omen as it foretells disappointment and ill-luck.[or]The theory of such dreams is that they always work by contraries.[cycling]"
"frightened"	"[one of]To dream that you are frightened at anything, denotes temporary and fleeting worries.[cycling]"
"devoted"	"[one of]For a farmer to dream of showing his devotion to.[or]God, or to his family, denotes plenteous crops and peaceful neighbors.[or]To business people, this is a warning that nothing is to be gained by deceit.[or]For a young woman to dream of being devout, implies her chastity and an adoring husband.[cycling]"
"contemptuous"	"[one of]To dream of being in contempt of court, denotes that you have committed business or social indiscretion and that it is unmerited.[or]To dream that you are held in contempt by others, you will succeed in winning their highest regard, and will find yourself prosperous and happy.[or]But if the contempt is merited, your exile from business or social circles is intimated.[cycling]"
"engaging in commerce"	"[one of]To dream that you are engaged in commerce, denotes you will handle your opportunities wisely and advantageously.[or]To dream of failures and gloomy outlooks in commercial circles, denotes trouble and ominous threatening of failure in real business life.[cycling]"
"consumptive"	"[one of]To dream that you have consumption, denotes that you are exposing yourself to danger.[or]Remain with your friends.[cycling]"
"colliding"	"[one of]To dream of a collision, you will meet with an accident of a serious type and disappointments in business.[or]For a young woman to see a collision, denotes she will be unable to decide between lovers, and will be the cause of wrangles.[cycling]"
"clairvoyant"	"[one of]To dream of being a clairvoyant and seeing yourself in the future, denotes signal changes in your present occupation, followed by a series of unhappy conflicts with designing people.[or]To dream of visiting a clairvoyant, foretells unprosperous commercial states and unhappy unions.[cycling]"
"giving to charity"	"[one of]To dream of giving charity, denotes that you will be harassed with supplications for help from the poor and your business will be at standstill.[or]To dream of giving to charitable institutions, your right of possession to paving property will be disputed.[or]Worries and ill health will threaten you.[or]For young persons to dream of giving charity, foreshows they will be annoyed by deceitful rivals.[or]To dream that you are an object of charity, omens that you will succeed in life after hard times with misfortunes.[cycling]"
"giving to charity"	"[one of]For a rich person to dream that he is charitable signifies loss of fortune; if a lady dreams it she will bestow her affections on an unworthy person.[cycling]"
"blowing the fire"	"[one of]To dream you are blowing the fire indicates to the lover, that your sweetheart is very angry with you.[cycling]"
"starving"	"[one of]To dream of being in a starving condition, portends unfruitful labors and a dearth of friends.[or]To see others in this condition, omens misery and dissatisfaction with present companions and employment.[cycling]"
"single"	"[one of]For married persons to dream that they are single, foretells that their union will not be harmonious, and constant despondency will confront them.[cycling]"
"single"	"[one of]If a married woman dreams that she is single and that attentions are being paid to her by a beau it foretells that her husband has become captivated by a new love and will probably be false to his vows: the omen is similar to a married man who dreams that he is either a bachelor or widower.[cycling]"
"successful"	"[one of]To dream that you have been successful in some enterprise in which you have been engaged, denotes that you will hear of some person’s death whom you highly esteemed.[cycling]"
"yearning"	"[one of]To feel in a dream that you are yearning for the presence of anyone, denotes that you will soon hear comforting tidings from your absent friends.[or]For a young woman to think her lover is yearning for her, she will have the pleasure of soon hearing some one making a long-wished-for proposal.[or]If she lets him know that she is yearning for him, she will be left alone and her longings will grow apace.[cycling]"
"bleating"	"[one of]To hear young animals bleating in your dreams, foretells that you will have new duties and cares, though not necessarily unpleasant ones.[cycling]"
"bleeding"	"[one of]To dream you are bleeding, denotes loss of goods and character, and that your sweetheart will not marry you.[or]To dream you see another bleeding, indicates that some person who pretends to be your friend is about to take some great advantage of you.[or]To dream you draw blood of another, denotes that you will recover a lawsuit and be successful in love and business.[or]To dream another draws blood of you, is a certain prognostic that you will be unsuccessful in love and in business, and in everything you undertake.[cycling]"
"bleeding"	"[one of]To dream of bleeding, denotes death by horrible accidents and malicious reports about you.[or]Fortune will turn against you.[cycling]"
"bleeding"	"[one of]To dream of bleeding at the nose signifies loss of goods and decay of riches; to a young girl it foretells the loss of her lover.[cycling]"
"blushing"	"[one of]For a young woman to dream of blushing, denotes she will be worried and humiliated by false accusations.[or]If she sees others blush, she will be given to flippant railery which will make her unpleasing to her friends.[cycling]"
"angling"	"[one of]To dream that you are angling, betokens much affliction and trouble in something which you desire to get.[cycling]"
"angling"	"[one of]To dream of catching fish is good.[or]If you fail to catch any, it will be bad for you.[cycling]"
"birding"	"[one of]To dream you catch birds, signifies profit and pleasure.[cycling]"
"laughing"	"[one of]To dream of laughing violently, betokens sorrow and weeping.[or]It also denotes change of circumstances and friends.[cycling]"
"laughing"	"[one of]To dream that you laugh and feel cheerful, means success in your undertakings, and bright companions socially.[or]Laughing immoderately at some weird object, denotes disappointment and lack of harmony in your surroundings.[or]To hear the happy laughter of children, means joy and health to the dreamer.[or]To laugh at the discomfiture of others, denotes that you will wilfully injure your friends to gratify your own selfish desires.[or]To hear mocking laughter, denotes illness and disappointing affairs.[cycling]"
"quarreling"	"[one of]To dream you are quarreling, denotes that some unexpected news will reach you, and that your sweetheart is about to be married to another.[cycling]"
"singing"	"[one of]If any one dreams he sings, it signifies he will be affected and weep.[or]To dream you hear singing or playing upon instruments, signifies consolation in adversity, recovery of health to those that are sick.[or]To dream you hear birds sing, signifies love, joy and delight.[cycling]"
"singing"	"[one of]To hear singing in your dreams, betokens a cheerful spirit and happy companions.[or]You are soon to have promising news from the absent.[or]If you are singing while everything around you gives promise of happiness, jealousy will insinuate a sense of insincerity into your joyousness.[or]If there are notes of sadness in the song, you will be unpleasantly surprised at the turn your affairs will take.[or]Ribald songs, signifies gruesome and extravagant waste.[cycling]"
"singing"	"[one of]To dream of singing solemn music in a choir is a sign of the death of a young girl who is your esteemed friend or relative: to lovers such a dream foretells the loss of sweethearts: if you imagine you are singing some lively tune by yourself it is a sign of sorrow though it may not be connected with any death.[cycling]"
"swelling"	"[one of]To dream that you see yourself swollen, denotes that you will amass fortune, but your egotism will interfere with your enjoyment.[or]To see others swollen, foretells that advancement will meet with envious obstructions.[or]To dream of swimming, is an augury of success if you find no discomfort in the act.[or]If you feel yourself going down, much dissatisfaction will present itself to you.[or]For a young woman to dream that she is swimming with a girl friend who is an artist in swimming, foretells that she will be loved for her charming disposition, and her little love affairs will be condoned by her friends.[or]To swim under water, foretells struggles and anxieties.[or]Diving and.[cycling]"
"yawning"	"[one of]If you yawn in your dreams, you will search in vain for health and contentment.[or]To see others yawning, foretells that you will see some of your friends in a miserable state.[or]Sickness will prevent them from their usual labors.[cycling]"
"whispering"	"[one of]To dream of whispering, denotes that you will be disturbed by the evil gossiping of people near you.[or]To hear a whisper coming to you as advice or warning, foretells that you stand in need of aid and counsel.[cycling]"
"blind"	"[one of]To dream of being blind is a sure sign that you repose your confidence in some person who is your bitter enemy; it denotes also that your sweetheart is unfaithful and prefers another; in business it denotes that you will lose money, and that your servants lack fidelity.[cycling]"
"blind"	"[one of]To dream of being blind, denotes a sudden change from affluence to almost abject poverty.[or]To see others blind, denotes that some worthy person will call on you for aid.[or]To dream of being blind shows that you are deceived in a supposed friend; this dream also threatens the dreamer with want of money; to a lover it predicts that his sweetheart is untrue to him; this dream also foretells death.[cycling]"
"abandoned"	"[one of]To dream that you are abandoned, denotes that you will have difficulty in framing your plans for future success.[or]To abandon others, you will see unhappy conditions piled thick around you, leaving little hope of surmounting them.[or]If it is your house that you abandon, you will soon come to grief in experimenting with fortune.[or]If you abandon your sweetheart, you will fail to recover lost valuables, and friends will turn aside from your favors.[or]If you abandon a mistress, you will unexpectedly come into a goodly inheritance.[or]If it is religion you abandon, you will come to grief by your attacks on prominent people.[or]To abandon children, denotes that you will lose your fortune by lack of calmness and judgment.[or]To abandon your business, indicates distressing circumstances in which there will be quarrels and suspicion.[or](This dream may have a literal fulfilment if it is impressed on your waking mind, whether you abandon a person, or that person abandons you, or, as indicated, it denotes other worries.).[or]To see yourself or friend abandon a ship, suggests your possible entanglement in some business failure, but if you escape to shore your interests will remain secure.[cycling]"
"abject"	"[one of]To dream that you are abject, denotes that you will be the recipient of gloomy tidings, which will cause a relaxation in your strenuous efforts to climb the heights of prosperity.[or]To see others abject, is a sign of bickerings and false dealings among your friends.[cycling]"
"hanging above"	"[one of]To see anything hanging above you, and about to fall, implies danger; if it falls upon you it may be ruin or sudden disappointment.[or]If it falls near, but misses you, it is a sign that you will have a narrow escape from loss of money, or other misfortunes may follow.[or]Should it be securely fixed above you, so as not to imply danger, your condition will improve after threatened loss.[or]To dream you see any thing hanging _above_ you signifies you will improve in your worldly prospects and soon be in a better situation than you were before you had the dream.[cycling]"
"acquitted"	"[one of]To dream that you are acquitted of a crime, denotes that you are about to come into possession of valuable property, but there is danger of a law suit before obtaining possession.[or]To see others acquitted, foretells that your friends will add pleasure to your labors.[cycling]"
"adopted"	"[one of]To see your adopted child, or parent, in your dreams, indicates that you will amass fortune through the schemes and speculations of strangers.[or]To dream that you or others are adopting a child, you will make an unfortunate change in your abode.[cycling]"
"commiting adultery"	"[one of]For a person to dream that they have committed it, shows they will meet great contentions and disputes.[cycling]"
"commiting adultery"	"[one of]To dream that you commit adultery, foretells that you will be arrainged for some illegal action.[or]If a woman has this dream, she will fail to hold her husband's affections, letting her temper and spite overwhelm her at the least provocation.[or]If it is with her husband's friend, she will be unjustly ignored by her husband.[or]Her rights will be cruelly trampled upon by him.[or]If she thinks she is enticing a youth into this act, she will be in danger of desertion and divorced for her open intriguing.[or]For a young woman this implies abasement and low desires, in which she will find strange adventures afford her pleasure.[or]It is always good to dream that you have successfully resisted any temptation.[or]To yield, is bad.[or]If a man chooses low ideals, vampirish influences will swarm around him ready to help him in his nefarious designs.[or]Such dreams may only be the result of depraved elementary influences.[or]If a man chooses high ideals, he will be illuminated by the deific principle within him, and will be exempt from lascivious dreams.[or]The man who denies the existence and power of evil spirits has no arcana or occult knowledge.[or]Did not the black magicians of Pharaoh's time, and.[or][or]Magnus, the.[or]Sorcerer, rival the men of God?.[or]The dreamer of amorous sweets is warned to beware of scandal.[cycling]"
"commiting adultery"	"[one of]It is in most cases a bad omen to dream that you have perpetrated this act.[or]If the person you dreamed about is married or is a prostitute you may almost be sure that some misfortune will overtake you.[or]If she is a virgin it merely predicts that you will shortly have an invitation to a wedding.[or]For a married woman to dream of adultery is a sign she will soon conceive and have a girl.[or]To an unmarried woman such a dream is a sign of misfortune.[cycling]"
"affluent"	"[one of]To dream that you are in affluence, foretells that you will make fortunate ventures, and will be pleasantly associated with people of wealth.[or]To young women, a vision of weird and fairy affluence is ominous of illusive and evanescent pleasure.[or]They should study more closely their duty to friends and parents.[or]After dreams of this nature they are warned to cultivate a love for home life.[cycling]"
"affrighted"	"[one of]To dream that you are affrighted, foretells that you will sustain an injury through an accident.[or]To see others affrighted, brings you close to misery and distressing scenes.[or]Dreams of this nature are frequently caused by nervous and feverish conditions, either from malaria or excitement.[or]When such is the case, the dreamer is warned to take immediate steps to remove the cause.[or]Such dreams or reveries only occur when sleep is disturbed.[cycling]"
"affronted"	"[one of]This is a bad dream.[or]The dreamer is sure to shed tears and weep.[or]For a young woman to dream that she is affronted, denotes that some unfriendly person will take advantage of her ignorance to place her in a compromising situation with a stranger, or to jeopardize her interests with a friend.[cycling]"
"afraid"	"[one of]To feel that you are afraid to proceed with some affair, or continue a journey, denotes that you will find trouble in your household, and enterprises will be unsuccessful.[or]To see others afraid, denotes that some friend will be deterred from performing some favor for you because of his own difficulties.[or]For a young woman to dream that she is afraid of a dog, there will be a possibility of her doubting a true friend.[cycling]"
"agony"	"[one of]This is not as good a dream, as some would wish you to believe.[or]It portends worry and pleasure intermingled, more of the former than of the latter.[or]To be in agony over the loss of money, or property, denotes that disturbing and imaginary fears will rack you over the critical condition of affairs, or the illness of some dear relative.[cycling]"
"amorous"	"[one of]To dream you are amorous, warns you against personal desires and pleasures, as they are threatening to engulf you in scandal.[or]For a young woman it portends illicit engagements, unless she chooses staid and moral companions.[or]For a married woman, it foreshadows discontent and desire for pleasure outside the home.[or]To see others amorous, foretells that you will be persuaded to neglect your moral obligations.[or]To see animals thus, denotes you will engage in degrading pleasures with fast men or women.[cycling]"
"angry"	"[one of]To dream that you have been provoked to anger shows that you have powerful enemies.[cycling]"
"angry"	"[one of]To dream of anger, denotes that some awful trial awaits you.[or]Disappointments in loved ones, and broken ties, of enemies may make new attacks upon your property or character.[or]To dreams that friends or relatives are angry with you, while you meet their anger with composure, denotes you will mediate between opposing friends, and gain their lasting favor and gratitude.[cycling]"
"angry"	"[one of]To dream that you have been provoked to anger shows that you have powerful enemies; and warns you to be careful that all you do should be strictly honorable; but it also signifies you will hear good news and be in a good humor.[cycling]"
"annoyed"	"[one of]This dream denotes that you have enemies who are at work against you.[or]Annoyances experienced in dreams are apt to find speedy fulfilment in the trifling incidents of the following day.[cycling]"
"anxious"	"[one of]A dream of this kind is occasionally a good omen, denoting, after threatening states, success and rejuvenation of mind; but if the dreamer is anxious about some momentous affair, it indicates a disastrous combination of business and social states.[cycling]"
"arrested"	"[one of]To see respectable-looking strangers arrested, foretells that you desire to make changes, and new speculations will be subordinated by the fear of failure.[or]If they resist the officers, you will have great delight in pushing to completion the new enterprise.[cycling]"
"bigamous"	"[one of]For a man to commit bigamy, denotes loss of manhood and failing mentality.[or]To a woman, it predicts that she will suffer dishonor unless very discreet.[cycling]"
"boasting"	"[one of]To hear boasting in your dreams, you will sincerely regret an impulsive act, which will cause trouble to your friends.[or]To boast to a competitor, foretells that you will be unjust, and will use dishonest means to overcome competition.[cycling]"
"suffering bronchitis"	"[one of]To dream that you are affected with bronchitis, foretells you will be detained from pursuing your views and plans by unfortunate complications of sickness in your home.[or]To suffer with bronchitis in a dream, denotes that discouraging prospects of winning desired objects will soon loom up before you.[cycling]"
"buried alive"	"[one of]For a man to dream he is buried alive, signifies he shall have much wealth.[cycling]"
"buried alive"	"[one of]To dream that you are buried alive.[or]denotes that you are about to make a great mistake, which your opponents will quickly turn to your injury.[or]If you are rescued from the grave, your struggle will eventually correct your misadventure.[cycling]"
"buried alive"	"[one of]To dream that you are buried alive denotes that you will be rich and powerful.[or]To wealthy people it is a sign of addition to their wealth.[cycling]"
"burned"	"[one of]For a man to dream he is burned, signifies (according to the interpretations of the.[or]Persians and.[or]Egyptians) that he shall be rich, honored and respected; but if he imagines that he was burned by a fire that did not quite consume him, he will inevitably perish in the end.[cycling]"
"corpulent"	"[one of]For a person to dream of being corpulent, indicates to the dreamer bountiful increase of wealth and pleasant abiding places.[or]To see others corpulent, denotes unusual activity and prosperous times.[or]If a man or woman sees himself or herself looking grossly corpulent, he or she should look well to their moral nature and impulses.[or]Beware of either concave or convex telescopically or microscopically drawn pictures of yourself or others, as they forbode evil.[cycling]"
"coughing"	"[one of]To dream that you are aggravated by a constant cough indicates a state of low health; but one from which you will recuperate if care is observed in your habits.[or]To dream of hearing others cough, indicates unpleasant surroundings from which you will ultimately emerge.[cycling]"
"at cross purposes"	"[one of]To dream one plays at cross purposes, signifies prosperity, joy, pleasure, health and concord among friends and relations.[cycling]"
"cruel"	"[one of]To dream of cruelty being shown you, foretells you will have trouble and disappointment in some dealings.[or]If it is shown to others, there will be a disagreeable task set for others by you, which will contribute to you own loss.[cycling]"
"crying"	"[one of]To dream of crying, is a forerunner of illusory pleasures, which will subside into gloom, and distressing influences affecting for evil business engagements and domestic affairs.[or]To see others crying, forbodes unexpected calls for aid from you.[cycling]"
"cunning"	"[one of]To dream of being cunning, denotes you will assume happy cheerfulness to retain the friendship of prosperous and gay people.[or]If you are associating with cunning people, it warns you that deceit is being practised upon you in order to use your means for their own advancement.[cycling]"
"currying a horse"	"[one of]To dream of currying a horse, signifies that you will have a great many hard licks to make both with brain and hand before you attain to the heights of your ambition; but if you successfully curry him you will attain that height, whatever it may be.[cycling]"
"dancing"	"[one of]To dream that you are dancing at a ball, wake, or entertainment, foretells that you will shortly receive some joyful news from a long absent friend, and that you are about to inherit some unexpected legacy; for it foretells success and happiness in love; that your sweetheart is kind.[cycling]"
"dancing"	"[one of]To dream you are dancing at a ball or entertainment foretells that you will shortly receive joyful news; it also foretells success and happiness in love.[or]To see others dance there signifies pleasure and an inheritance.[cycling]"
"in danger"	"[one of]To dream of being in a perilous situation, and death seems iminent,{sic} denotes that you will emerge from obscurity into places of distinction and honor; but if you should not escape the impending danger, and suffer death or a wound, you will lose in business and be annoyed in your home, and by others.[or]If you are in love, your prospects will grow discouraging.[cycling]"
"in danger"	"[one of]To dream of being in danger shows success in life; to shun it misfortune .[cycling]"
"in debt"	"[one of]Debt is rather a bad dream, foretelling worries in business and love, and struggles for a competency; but if you have plenty to meet all your obligations, your affairs will assume a favorable turn.[cycling]"
"in debt"	"[one of]To dream of paying a debt with money foretells that you will soon receive some.[or]If you imagine that you owe a debt and are worrying to get the money to pay it is a sign of sickness.[cycling]"
"dying"	"[one of]To dream of death, denotes that you will either be speedily married yourself, or else assist at a wedding.[or]To dream that you are dead, also denotes a speedy marriage, and that you will be successful in your undertakings.[or]To dream you see another person dead, denotes unkind usage from your friends.[cycling]"
"dying"	"[one of]To dream of seeing any of your people dead, warns you of coming dissolution or sorrow.[or]Disappointments always follow dreams of this nature.[or]To hear of any friend or relative being dead, you will soon have bad news from some of them.[or]Dreams relating to death or dying, unless they are due to spiritual causes, are misleading and very confusing to the novice in dream lore when he attempts to interpret them.[or]A man who thinks intensely fills his aura with thought or subjective images active with the passions that gave them birth; by thinking and acting on other lines, he may supplant these images with others possessed of a different form and nature.[or]In his dreams he may see these images dying, dead or their burial, and mistake them for friends or enemies.[or]In this way he may, while asleep, see himself or a relative die, when in reality he has been warned that some good thought or deed is to be supplanted by an evil one.[or]To illustrate:.[or]If it is a dear friend or relative whom he sees in the agony of death, he is warned against immoral or other improper thought and action, but if it is an enemy or some repulsive object dismantled in death, he may overcome his evil ways and thus give himself or friends cause for joy.[or]Often the end or beginning of suspense or trials are foretold by dreams of this nature.[or]They also frequently occur when the dreamer is controlled by imaginary states of evil or good.[or]A man in that state is not himself, but is what the dominating influences make him.[or]He may be warned of approaching conditions or his extrication from the same.[or]In our dreams we are closer to our real self than in waking life.[or]The hideous or pleasing incidents seen and heard about us in our dreams are all of our own making, they reflect the true state of our soul and body, and we cannot flee from them unless we drive them out of our being by the use of good thoughts and deeds, by the power of the spirit within us.[cycling]"
"dying"	"[one of]To dream you see death denotes happiness and long life; that you will be either speedily married yourself or assist at a wedding.[or]To dream you see another person dead denotes hasty news from friends.[cycling]"
"disinherited"	"[one of]To dream that you are disinherited, warns you to look well to your business and social standing.[or]For a young man to dream of losing his inheritance by disobedience, warns him that he will find favor in the eyes of his parents by contracting a suitable marriage.[or]For a woman, this dream is a warning to be careful of her conduct, lest she meet with unfavorable fortune.[cycling]"
"naked"	"[one of]To dream that you are naked, foretells scandal and unwise engagements.[or]To see others naked, foretells that you will be tempted by designing persons to leave the path of duty.[or]Sickness will be no small factor against your success.[or]To dream that you suddenly discover your nudity, and are trying to conceal it, denotes that you have sought illicit pleasure contrary to your noblest instincts and are desirous of abandoning those desires.[or]For a young woman to dream that she admires her nudity, foretells that she will win, but not hold honest men's regard.[or]She will win fortune by her charms.[or]If she thinks herself ill-formed, her reputation will be sullied by scandal.[or]If she dreams of swimming in clear water naked, she will enjoy illicit loves, but nature will revenge herself by sickness, or loss of charms.[or]If she sees naked men swimming in clear water, she will have many admirers.[or]If the water is muddy, a jealous admirer will cause ill-natured gossip about her.[cycling]"
"naked"	"[one of]To dream you see a man naked, signifies fear and terror.[or]To dream you see a woman naked, signifies honor and joy, provided she be fair skinned and handsome.[or]But if she is crooked, old, wrinkled or otherwise ill made, and black withal, it signifies shame, repentance and ill luck.[cycling]"
"naked"	"[one of]To dream you see a man naked signifies fear and terror: to dream you see a woman naked signifies honor and joy provided she be fair-skinned and handsome; but if she is crooked old wrinkled or otherwise ill made and black withal it signifies shame repentance and ill luck.[or]For a woman to dream she sees her husband naked signifies success in her enterprises and a good number of children.[cycling]"
"nearsighted"	"[one of]To dream that you are nearsighted, signifies embarrassing failure and unexpected visits from unwelcome persons.[or]For a young woman, this dream foretells unexpected rivalry.[or]To dream that your sweetheart is nearsighted, denotes that she will disappoint you.[cycling]"
"one-eyed"	"[one of]To see one-eyed creatures in your dreams, is portentous of an over-whelming intimation of secret intriguing against your fortune and happiness.[cycling]"
"overturned"	"[one of]If a woman dreams she be overturned while riding, it is ominous that she shall be greatly distressed for a short time.[or]For a man to have this dream, denotes that some animal to which he is attached will sicken and perhaps die.[cycling]"
"piss-abed"	"[one of]To dream that you wet the bed in your sleep is a sign you will lose something by fire: your house may not burn but some article will either fall in the fire or be damaged by it—perhaps your servant may spoil some clothing while ironing.[cycling]"
"ragged"	"[one of]To dream you are in a ragged dress, and that you are suffering from privations, indicates that you will shortly be raised to a higher position in society.[cycling]"
"ragged"	"[one of]To dream that your clothes are ragged indicates that a young girl will banter you: if in your dream you see ragged people it is a sign that you will suffer ridicule at your next meeting with a party of ladies and gentlemen.[or]Rags and ridicule go together in dreams.[cycling]"
"scalded"	"[one of]To dream of being scalded with hot water is usually a sign of injuries by the elements; it may foretell losses by floods by fire or by winds or by thunder-storms: if you dream of scalding your tongue with hot tea it is a sign that you will scandalize a neighbor with some ill-natured remark.[cycling]"
"scared"	"[one of]To dream that you are scared by some frightful spectacle, denotes that you will be shortly overjoyed by hearing some pleasing intelligence from one whom you dearly love.[cycling]"
"vexed"	"[one of]If you are vexed in your dreams, you will find many worries scattered through your early awakening.[or]If you think some person is vexed with you, it is a sign that you will not shortly reconcile some slight misunderstanding.[cycling]"
"vexed"	"[one of]To dream of being much vexed foretells the reverse and that you will shortly be much pleased.[cycling]"
"accepted"	"[one of]For a business man to dream that his proposition has been accepted, foretells that he will succeed in making a trade, which heretofore looked as if it would prove a failure.[or]For a lover to dream that he has been accepted by his sweetheart, denotes that he will happily wed the object of his own and others' admiration.[or]If this dream has been occasioned by overanxiety and weakness, the contrary may be expected.[or]The elementary influences often play pranks upon weak and credulous minds by lying, and deceptive utterances.[or]Therefore the dreamer should live a pure life, fortified by a strong will, thus controlling his destiny by expelling from it involuntary intrusions.[cycling]"
"called"	"[one of]To hear your name called in a dream by strange voices, denotes that your business will fall into a precarious state, and that strangers may lend you assistance, or you may fail to meet your obligations.[or]To hear the voice of a friend or relative, denotes the desperate illness of some one of them, and may be death; in the latter case you may be called upon to stand as guardian over some one, in governing whom you should use much discretion.[or]Lovers hearing the voice of their affianced should heed the warning.[or]If they have been negligent in attention they should make amends.[or]Otherwise they may suffer separation from misunderstanding.[or]To hear the voice of the dead may be a warning of your own serious illness or some business worry from bad judgment may ensue.[or]The voice is an echo thrown back from the future on the subjective mind, taking the sound of your ancestor's voice from coming in contact with that part of your ancestor which remains with you.[or]A certain portion of mind matter remains the same in lines of family descent.[cycling]"
"gangrenous"	"[one of]To dream that you see any one afflicted with gangrene, foretells the death of a parent or near relative.[cycling]"
"insane"	"[one of]To dream of being insane, forebodes disastrous results to some newly undertaken work, or ill health may work sad changes in your prospects.[or]To see others insane, denotes disagreeable contact with suffering and appeals from the poverty-stricken.[or]The utmost care should be taken of the health after this dream.[cycling]"
"intemperant"	"[one of]To dream of being intemperate in the use of your intellectual forces, you will seek after foolish knowledge fail to benefit yourself, and give pain and displeasure to your friends.[or]If you are intemperate in love, or other passions, you will reap disease or loss of fortune and esteem.[or]For a young woman to thus dream, she will lose a lover and incur the displeasure of close friends.[cycling]"
"gossiping"	"[one of]To dream of being interested in common gossip, you will undergo some humiliating trouble caused by overconfidence in transient friendships.[or]If you are the object of gossip, you may expect some pleasurable surprise.[cycling]"
"lucky"	"[one of]To dream of being lucky, is highly favorable to the dreamer.[or]Fulfilment of wishes may be expected and pleasant duties will devolve upon you.[or]To the despondent, this dream forebodes an uplifting and a renewal of prosperity.[cycling]"
"offensive"	"[one of]To dream of being offended, denotes that errors will be detected in your conduct, which will cause you inward rage while attempting to justify yourself.[or]To give offense, predicts for you many struggles before reaching your aims.[or]For a young woman to give, or take offense, signifies that she will regret hasty conclusions, and disobedience to parents or guardian.[cycling]"


Table of Places
Place	Interpretation
"California"	"[one of]If you dream of going there it predicts to you a misfortune; but if in your dream you imagine you are in.[or]California and that it is a pleasant country it foretells that you will receive a valuable present or a legacy or else that you will draw a prize in the lottery.[cycling]"
"America"	"[one of]High officials should be careful of State affairs, others will do well to look after their own person, for some trouble is at hand after this dream.[cycling]"
"Asia"	"[one of]To dream of visiting Asia is assurance of change, but no material benefits from fortune will follow.[cycling]"
"Niagara"	"[one of]As every one has heard of this great cataract and multitudes have seen it it is not strange that a good many people dream of going there: such a dream is a sign that you will be embarrassed in company by a sensation of some kind.[cycling]"
"a crowd"	"[one of]To dream of a large, handsomely dressed crowd of people at some entertainment, denotes pleasant association with friends; but anything occurring to mar the pleasure of the guests, denotes distress and loss of friendship, and unhappiness will be found where profit and congenial intercourse was expected.[or]It also denotes dissatisfaction in government and family dissensions.[or]To see a crowd in a church, denotes that a death will be likely to affect you, or some slight unpleasantness may develop.[or]To see a crowd in the street, indicates unusual briskness in trade and a general air of prosperity will surround you.[or]To try to be heard in a crowd, foretells that you will push your interests ahead of all others.[or]To see a crowd is usually good, if too many are not wearing black or dull costumes.[or]To dream of seeing a hypnotist trying to hypnotize others, and then turn his attention on you, and fail to do so, indicates that a trouble is hanging above you which friends will not succeed in warding off.[or]Yourself alone can avert the impending danger.[cycling]"
"battle"	"[one of]To dream of battle in the streets, forewarns you against secret enemies who will endeavor to harm you.[or]If you are in love, your sweetheart is false to you.[cycling]"
"Europe"	"[one of]To dream of traveling in.[or]Europe, foretells that you will soon go on a long journey, which will avail you in the knowledge you gain of the manners and customs of foreign people.[or]You will also be enabled to forward your financial standing.[or]For a young woman to feel that she is disappointed with the sights of Europe, omens her inability to appreciate chances for her elevation.[or]She will be likely to disappoint her friends or lover.[cycling]"
"a fair"	"[one of]To dream of being at a fair, denotes that you will have a pleasant and profitable business and a congenial companion.[or]For a young woman, this dream signifies a jovial and even-tempered man for a life partner.[cycling]"
"a building"	"[one of]To dream of being amongst buildings, denotes that you will change your present place of residence and that you will make many new friends in life; if you are in love it foretells your sweetheart is about to remove at a distance from you, and that you will be in danger of losing the affections of your lover by a new face.[cycling]"
"a wedding"	"[one of]To dream of being at a jolly wedding is a sign of a funeral: if you imagine that you kiss the bride it foretells the death of a dear friend or relative.[or]In an old dream-book published it is stated that to dream of kissing the bride is a sign of your own death but on referring to the best authorities.[or]I find it is necessary to dream that the bride should herself be the kissing party and that an impressive kiss from her on the occasion denotes the death of the person kissed.[cycling]"
"a comedy"	"[one of]To dream of being at a light play, denotes that foolish and short-lived pleasures will be indulged in by the dreamer.[or]To dream of seeing a comedy, is significant of light pleasures and pleasant tasks.[cycling]"
"a theater"	"[one of]To dream of being at a theater, denotes that you will have much pleasure in the company of new friends.[or]Your affairs will be satisfactory after this dream.[or]If you are one of the players, your pleasures will be of short duration.[or]If you attend a vaudeville theater, you are in danger of losing property through silly pleasures.[or]If it is a grand opera, you will succeed in you wishes and aspirations.[or]If you applaud and laugh at a theater, you will sacrifice duty to the gratification of fancy.[or]To dream of trying to escape from one during a fire or other excitement, foretells that you will engage in some enterprise, which will be hazardous.[cycling]"
"an inn"	"[one of]To dream of being at an inn is very unfavorable; it denotes poverty and unsuccessfulness in business; to the lover the unfaithfulness of his sweetheart; to the tradesman loss of business and dishonest agents.[cycling]"
"an inquest"	"[one of]To dream of being at an inquest, denotes prosperity; to dream that you are the subject on which the inquest is held, prognosticates that you will come into prosperity by the death of some rich person; to dream an inquest is held on the body of a friend is also good to the dreamer.[cycling]"
"a nightmare"	"[one of]To dream of being attacked with this hideous sensation, denotes wrangling and failure in business.[or]For a young woman, this is a dream prophetic of disappointment and unmerited slights.[or]It may also warn the dreamer to be careful of her health, and food.[cycling]"
"a funeral"	"[one of]To dream of attending a funeral shows that you will probably be soon at a wedding or some gay party.[or]If in your dream you see a funeral pass it denotes a pleasure party out of doors such as a pic-nic or excursion.[cycling]"
"a masquerade"	"[one of]To dream of attending a masquerade, denotes that you will indulge in foolish and harmful pleasures to the neglect of business and domestic duties.[or]For a young woman to dream that she participates in a masquerade, denotes that she will be deceived.[cycling]"
"a picnic"	"[one of]To dream of attending a picnic, foreshadows success and real  enjoyment.[or]Dreams of picnics, bring undivided happiness to the young.[or]Storms, or any interfering elements at a picnic, implies the temporary displacement of assured profit and pleasure in love or business.[cycling]"
"a reception"	"[one of]To dream of attending a reception, denotes that you will have pleasant engagements.[or]Confusion at a reception will work you disquietude.[cycling]"
"an opera"	"[one of]To dream of attending an opera, denotes that you will be entertained by congenial friends, and find that your immediate affairs will be favorable.[cycling]"
"a school"	"[one of]To dream of attending school is a sign of advancement and good fortune: if you dream of studying and succeed well it shadows forth that you will rise to a position in society above your present one: if you find it difficult to learn you will have trouble in getting along but will rise at last.[cycling]"
"a school"	"[one of]To dream of attending school, indicates distinction in literary work.[or]If you think you are young and at school as in your youth, you will find that sorrow and reverses will make you sincerely long for the simple trusts and pleasures of days of yore.[or]To dream of teaching a school, foretells that you will strive for literary attainments, but the bare necessities of life must first be forthcoming.[or]To visit the schoolhouse of your childhood days, portends that discontent and discouraging incidents overshadows the present.[cycling]"
"an elevator"	"[one of]To dream of ascending in an elevator, denotes you will swiftly rise to position and wealth, but if you descend in one your misfortunes will crush and discourage you.[or]If you see one go down and think you are left, you will narrowly escape disappointment in some undertaking.[or]To see one standing, foretells threatened danger.[cycling]"
"a country"	"[one of]To dream of being in a beautiful and fertile country, where abound rich fields of grain and running streams of pure water, denotes the very acme of good times is at hand.[or]Wealth will pile in upon you, and you will be able to reign in state in any country.[or]If the country be dry and bare, you will see and hear of troublous times.[or]Famine and sickness will be in the land.[cycling]"
"a cemetery"	"[one of]To dream of being in a beautiful and well-kept cemetery, you will have unexpected news of the recovery of one whom you had mourned as dead, and you will have your title good to lands occupied by usurpers.[or]To see an old bramble grown and forgotten cemetery, you will live to see all your loved ones leave you, and you will be left to a stranger's care.[or]For young people to dream of wandering through the silent avenues of the dead foreshows they will meet with tender and loving responses from friends, but will have to meet sorrows that friends are powerless to avert.[or]Brides dreaming of passing a cemetery on their way to the wedding ceremony, will be bereft of their husbands by fatal accidents occurring on journeys.[or]For a mother to carry fresh flowers to a cemetery, indicates she may expect the continued good health of her family.[or]For a young widow to visit a cemetery means she will soon throw aside her weeds for robes of matrimony.[or]If she feels sad and depressed she will have new cares and regrets.[or]Old people dreaming of a cemetery, shows they will soon make other journeys where they will find perfect rest.[or]To see little children gathering flowers and chasing butterflies among the graves, denotes prosperous changes and no graves of any of your friends to weep over.[or]Good health will hold high carnival.[cycling]"
"a brothel"	"[one of]To dream of being in a brothel, denotes you will encounter disgrace through your material indulgence.[cycling]"
"a castle"	"[one of]To dream of being in a castle, you will be possessed of sufficient wealth to make life as you wish.[or]You have prospects of being a great traveler, enjoying contact with people of many nations.[or]To see an old and vine-covered castle, you are likely to become romantic in your tastes, and care should be taken that you do not contract an undesirable marriage or engagement.[or]Business is depressed after this dream.[or]To dream that you are leaving a castle, you will be robbed of your possessions, or lose your lover or some dear one by death.[cycling]"
"a coal-mine"	"[one of]To dream of being in a coal-mine or colliery and seeing miners, denotes that some evil will assert its power for your downfall; but if you dream of holding a share in a coal-mine, it denotes your safe investment in some deal.[or]For a young woman to dream of mining coal, foreshows she will become the wife of a real-estate dealer or dentist.[cycling]"
"a cellar"	"[one of]To dream of being in a cold, damp cellar, you will be oppressed by doubts.[or]You will lose confidence in all things and suffer gloomy forebodings from which you will fail to escape unless you control your will.[or]It also indicates loss of property.[or]To see a cellar stored with wines and table stores, you will be offered a share in profits coming from a doubtful source.[or]If a young woman dreams of this she will have an offer of marriage from a speculator or gambler.[cycling]"
"a dungeon"	"[one of]To dream of being in a dungeon, foretells for you struggles with the vital affairs of life but by wise dealing you will disenthrall yourself of obstacles and the designs of enemies.[or]For a woman this is a dark foreboding; by her wilful indiscretion she will lose her position among honorable people.[or]To see a dungeon lighted up, portends that you are threatened with entanglements of which your better judgment warns you.[cycling]"
"a grotto"	"[one of]To dream of being in a grotto or cavern in the earth shows that you will soon meet a near and dear relative: if you live away from home something will occur to cause your return: such a dream always foretells meeting your absent friends.[cycling]"
"a laboratory"	"[one of]To dream of being in a laboratory, denotes great energies wasted in unfruitful enterprises when you might succeed in some more practical business.[or]If you think yourself an alchemist, and try to discover a process to turn other things into gold, you will entertain far-reaching and interesting projects, but you will fail to reach the apex of your ambition.[or]Wealth will prove a myth, and the woman you love will hold a false position towards you.[cycling]"
"a life-boat"	"[one of]To dream of being in a life-boat, denotes escape from threatened evil.[or]To see a life-boat sinking, friends will contribute to your distress.[or]To be lost in a life-boat, you will be overcome with trouble, in which your friends will be included to some extent.[or]If you are saved, you will escape a great calamity.[cycling]"
"a mine"	"[one of]To dream of being in a mine, denotes failure in affairs.[or]To own a mine, denotes future wealth.[cycling]"
"a quagmire"	"[one of]To dream of being in a quagmire, implies your inability to meet obligations.[or]To see others thus situated, denotes that the failures of others will be felt by you.[or]Illness is sometimes indicated by this dream.[cycling]"
"a quarry"	"[one of]To dream of being in a quarry and seeing the workmen busy, denotes that you will advance by hard labor.[or]An idle quarry, signifies failure, disappointment, and often death.[cycling]"
"smoke"	"[one of]To dream of being in a room full of smoke foretells that you will engage in an angry controversy and perhaps quarrel: lovers who dream of smoke will nose out the fire when they next meet and it will prove to be either one of anger or of lust.[cycling]"
"rain"	"[one of]To dream of being in a shower of rain, is particularly favorable to lovers.[or]It denotes constancy, affection and sweet temper.[or]If it be very heavy rain, accompanied by thunder and lightning, then expect to be assailed by thieves.[cycling]"
"a strange place"	"[one of]To dream of being in a strange place, denotes a good legacy from a relation while in prison.[or]To the lover, they show inconstancy and want of affection in the object of your love.[or]To the sailor, sickness on the next voyage.[cycling]"
"a tannery"	"[one of]To dream of being in a tannery is a sign of health and riches: if a girl dreams that her beau is a tanner she will probably get a good husband and one who is well off and will live to a good old age for your tanners are usually tough customers.[cycling]"
"a tent"	"[one of]To dream of being in a tent, foretells a change in your affairs.[or]To see a number of tents, denotes journeys with unpleasant companions.[or]If the tents are torn or otherwise dilapidated, there will be trouble for you.[cycling]"
"a watermill"	"[one of]To dream of being in a water-mill is a favorable omen.[or]To the tradesman it denotes great increase of business; to the farmer, abundant crops; in love, success, a rich sweetheart and a happy marriage.[cycling]"
"a slaughter-house"	"[one of]To dream of being in an empty slaughter-house shows that you are in danger but can avoid it by precaution.[or]To see animals slaughtered is a good sign if the blood flow freely; if the blood does not flow you will meet with some accident.[cycling]"
"an inn"	"[one of]To dream of being in an inn, is a very unfavorable dream.[or]It denotes poverty and want of success in undertakings; expect soon to be yourself, or some of your family, committed to prison.[or]If you are sick, it denotes you will never recover.[or]To the tradesman it shows loss of trade and bad servants.[cycling]"
"underground"	"[one of]To dream of being in an underground habitation, you are in danger of losing reputation and fortune.[or]To dream of riding on an underground railway, foretells that you will engage in some peculiar speculation which will contribute to your distress and anxiety.[cycling]"
"love"	"[one of]To dream of being in love, denotes that you are not susceptible.[or]If you dream of another loving you, you will pass through life alone and unsought.[cycling]"
"poverty"	"[one of]To dream of being in poverty, signifies good to some, but cross fortune to those that make commodity of their tongue and fair speech.[cycling]"
"quarantine"	"[one of]To dream of being in quarantine, denotes that you will be placed in a disagreeable position by the malicious intriguing of enemies.[cycling]"
"a coalpit"	"[one of]To dream of being in the bottom of a coalpit, signifies marrying with a widow; for he that marries her shall never sound the depth of her policies.[cycling]"
"ecstasy"	"[one of]To dream of feeling ecstasy, denotes you will enjoy a visit from a long-absent friend.[or]If you experience ecstasy in disturbing dreams you will be subjected to sorrow and disappointment.[cycling]"


Table of Periods
Time	Interpretation
"night"	"[one of]If you are surrounded by night in your dreams, you may expect unusual oppression and hardships in business.[or]If the night seems to be vanishing, conditions which hitherto seemed unfavorable will now grow bright, and affairs will assume prosperous phases.[cycling]"
"December"	"[one of]To dream of December, foretells accumulation of wealth, but loss of friendship.[or]Strangers will occupy the position in the affections of some friend which was formerly held by you.[cycling]"
"autumn"	"[one of]For a woman to dream of Autumn, denotes she will obtain property through the struggles of others.[or]If she thinks of marrying in Autumn, she will be likely to contract a favorable marriage and possess a cheerful home.[cycling]"
"day"	"[one of]To dream of the day, denotes improvement in your situation, and pleasant associations.[or]A gloomy or cloudy day, foretells loss and ill success in new enterprises.[cycling]"
"daybreak"	"[one of]To watch the day break in a dream, omens successful undertakings, unless the scene is indistinct and weird; then it may imply disappointment when success in business or love seems assured.[cycling]"
"daybreak"	"[one of]Good fortune in every thing you undertake.[cycling]"
"day"	"[one of]To dream of a clear sunshiny day portends long life and happiness but to dream of a dark cloudy and stormy day is an unlucky omen.[cycling]"
"November"	"[one of]To dream of November, augers a season of indifferent success in all affairs.[cycling]"
"spring"	"[one of]To dream that spring is advancing, is a sign of fortunate undertakings and cheerful companions.[or]To see spring appearing unnaturally, is a foreboding of disquiet and losses.[cycling]"
"winter"	"[one of]To dream of winter, is a prognostication of ill-health and dreary prospects for the favorable progress of fortune.[or]After this dream your efforts will not yield satisfactory results.[cycling]"
"dusk"	"[one of]This is a dream of sadness; it portends an early decline and unrequited hopes.[or]Dark outlook for trade and pursuits of any nature is prolonged by this dream.[cycling]"
"January"	"[one of]To dream of this month, denotes you will be afflicted with unloved companions or children.[cycling]"
"July"	"[one of]To dream of this month, denotes you will be depressed with gloomy outlooks, but, as suddenly, your spirits will rebound to unimagined pleasure and good fortune.[cycling]"
"February"	"[one of]To dream of February, denotes continued ill health and gloom, generally.[or]If you happen to see a bright sunshiny day in this month, you will be unexpectedly and happily surprised with some good fortune.[cycling]"
"March"	"[one of]To dream of the month of March, portends disappointing returns in business, and some woman will be suspicious of your honesty.[cycling]"
"April"	"[one of]To dream of the month of April, signifies that much pleasure and profit will be your allotment.[or]If the weather is miserable, it is a sign of passing ill luck.[cycling]"
"August"	"[one of]To dream of the month of August, denotes unfortunate deals, and misunderstandings in love affairs.[or]For a young woman to dream that she is going to be married in.[or]August, is an omen of sorrow in her early wedded life.[cycling]"
"May"	"[one of]To dream of the month of May, denotes prosperous times, and pleasure for the young.[or]To dream that nature appears freakish, denotes sudden sorrow and disappointment clouding pleasure.[cycling]"
"June"	"[one of]To dream of June, foretells unusual gains in all undertakings.[or]For a woman to think that vegetation is decaying, or that a drouth is devastating the land, she will have sorrow and loss which will be lasting in its effects.[cycling]"
"October"	"[one of]To imagine you are in October is ominous of gratifying success in your undertakings.[or]You will also make new acquaintances which will ripen into lasting friendships.[cycling]"


Table of Plurals
Plural	Interpretation
"cattle"	"[one of]To dream you see cattle feeding, denotes great prosperity and unexpected success; to a lover it foretells a happy marriage, with many children, and to a man it shows that his wife will receive some unexpected legacy.[or]To dream you are driving cattle denotes that you will become rich by industry.[or]If you are in love it shows that you have many rivals, but that you will distance them all.[or]To dream you see fat cattle also denotes a plentiful year.[or]To dream you see lean and hungry cattle, denotes scarcity and famine.[cycling]"
"cattle"	"[one of]To dream of seeing good-looking and fat cattle contentedly grazing in green pastures, denotes prosperity and happiness through a congenial and pleasant companion.[or]To see cattle lean and shaggy, and poorly fed, you will be likely to toil all your life because of misspent energy and dislike of details of work.[or]Correct your habits after this dream.[or]To see cattle stampeding, means that you will have to exert all the powers of command you have to keep your career in a profitable channel.[or]To see a herd of cows at milking time, you will be the successful owner of wealth that many have worked to obtain.[or]To a young woman this means that her affections will not suffer from the one of her choice.[or]To dream of milking cows with udders well filled, great good fortune is in store for you.[or]If the calf has stolen the milk, it signifies that you are about to lose your lover by slowness to show your reciprocity, or your property from neglect of business.[or]To see young calves in your dream, you will become a great favorite in society and win the heart of a loyal person.[or]For business, this dream indicates profit from sales.[or]For a lover, the entering into bonds that will be respected.[or]If the calves are poor, look for about the same, except that the object sought will be much harder to obtain.[or]Long-horned and dark, vicious cattle, denote enemies.[cycling]"
"cattle"	"[one of]To dream you see cattle feeding denotes great prosperity and unexpected success; to a lover it foretells a happy marriage with many children; and to a married man it shows that his wife will receive some unexpected legacy; to dream you are driving cattle denotes that you will become rich by industry; if you see fat cattle itdenotes a plentiful year; if you see lean and hungry cattle in your dream it denotes scarcity and famine.[cycling]"
"confectionary"	"[one of]To dream of impure confectionary, denotes that an enemy in the guise of a friend will enter your privacy and discover secrets of moment to your opponents.[cycling]"
"confetti"	"[one of]To dream of confetti obstructing your view in a crowd of merry-makers, denotes that you will lose much by first seeking enjoyment, and later fulfil tasks set by duty.[cycling]"
"copper"	"[one of]To dream of copper, denotes oppression from those above you in station.[cycling]"
"copper"	"[one of]To dream of copper signifies that your sweetheart is deceitful and loves another it also shows secret enemies.[cycling]"
"corn"	"[one of]To dream of husking pied ears of corn, denotes you will enjoy varied success and pleasure.[or]To see others gathering corn, foretells you will rejoice in the prosperity of friends or relatives.[cycling]"
"corn"	"[one of]To dream that you see corn eared and gather it signifies profit and riches; to dream that you see stacks of corn signifies wealth and abundance to the dreamer; and on the contrary to see a small quantity denotes poverty.[cycling]"
"cotton"	"[one of]To dream of young growing cotton-fields, denotes great business and prosperous times.[or]To see cotton ready for gathering, denotes wealth and abundance for farmers.[or]For manufacturers to dream of cotton, means that they will be benefited by the advancement of this article.[or]For merchants, it denotes a change for the better in their line of business.[or]To see cotton in bales, is a favorable indication for better times.[or]To dream that cotton is advancing, denotes an immediate change from low to high prices, and all will be in better circumstances.[cycling]"
"counterfeit money"	"[one of]To dream of counterfeit money, denotes you will have trouble with some unruly and worthless person.[or]This dream always omens evil, whether you receive it or pass it.[cycling]"
"crockery"	"[one of]To dream of having an abundance of nice, clean crockery, denotes that you will be a tidy and economical housekeeper.[or]To be in a crockery store, indicates, if you are a merchant or business man, that you will look well to the details of your business and thereby experience profit.[or]To a young woman, this dream denotes that she will marry a sturdy and upright man.[or]An untidy store, with empty shelves, implies loss.[cycling]"
"dead"	"[one of]To dream of talking with dead folks is a good, auspicious dream, and signifies a boldness of courage and a very clear conscience.[or]To dream a man is dead that is alive and in health, signifies great trouble and being overthrown at law.[cycling]"
"dead"	"[one of]To dream of the dead, is usually a dream of warning.[or]If you see and talk with your father, some unlucky transaction is about to be made by you.[or]Be careful how you enter into contracts, enemies are around you.[or]Men and women are warned to look to their reputations after this dream.[or]To see your mother, warns you to control your inclination to cultivate morbidness and ill will towards your fellow creatures.[or]A brother, or other relatives or friends, denotes that you may be called on for charity or aid within a short time.[or]To dream of seeing the dead, living and happy, signifies you are letting wrong influences into your life, which will bring material loss if not corrected by the assumption of your own will force.[or]To dream that you are conversing with a dead relative, and that relative endeavors to extract a promise from you, warns you of coming distress, unless you follow the advice given you.[or]Disastrous consequences could often be averted if minds could grasp the inner workings and sight of the higher or spiritual self.[or]The voice of relatives is only that higher self taking form to approach more distinctly the mind that lives near the material plane.[or]There is so little congeniality between common or material natures that persons should depend upon their own subjectivity for true contentment and pleasure.[or]Paracelsus says on this subject: ``It may happen that the soul of persons who have died perhaps fifty years ago may appear to us in a dream, and if it speaks to us we should pay special attention to what it says, for such a vision is not an illusion or delusion, and it is possible that a man is as much able to use his reason during the sleep of his body as when the latter is awake; and if in such a case such a soul appears to him and he asks questions, he will then hear that which is true.[or]Through these solicitous souls we may obtain a great deal of knowledge to good or to evil things if we ask them to reveal them to us.[or]Many persons have had such prayers granted to them.[or]Some people that were sick have been informed during their sleep what remedies they should use, and after using the remedies, they became cured, and such things have happened not only to Christians, but also to Persians, and heathens, to good and to bad persons.[cycling]"
"deeds"	"[one of]To sign your name to deeds is a bad sign; to a man loss in business; to a woman the inconstancy of her lover.[cycling]"
"deer"	"[one of]To dream you see deer in a park, denotes war and famine; to the lover it foretells some unpleasant dispute with his sweetheart.[cycling]"
"deer"	"[one of]This is a favorable dream, denoting pure and deep friendships for the young and a quiet and even life for the married.[or]To kill a deer, denotes that you will be hounded by enemies.[or]For farmers, or business people, to dream of hunting deer, denotes failure in their respective pursuits.[cycling]"
"deer"	"[one of]If you see these animals in your dream it shows that you will hear some unexpected news—no matter what—perhaps a marriage a death an accident or a legacy has been left to you; or that some one is in love with you.[cycling]"
"gold"	"[one of]To dream of gold, is a very good omen.[or]It denotes success in your present undertakings, after experiencing some little difficulties.[or]If you receive gold in bars, you will inherit an estate in a far distant country, and have some trouble in getting possession of it.[or]If you receive eagles or any other gold coin, your affairs will prosper, your sweetheart will be true and marry you; you will have many children and be very happy.[or]If you pay gold, it betokens an increase of friends and business.[or]If you let gold fall, it denotes an attack from thieves.[or]If you are in trade, some swindler will attempt to defraud you.[or]If you pick up gold, it denotes that some quarrel will be settled to your advantage.[or]If you are in prison, it shows you will speedily be released.[or]It also denotes the death of a husband or wife, if you are married.[or]If single, of your sweetheart.[cycling]"
"gold"	"[one of]If you handle gold in your dream, you will be unusually successful in all enterprises.[or]For a woman to dream that she receives presents of gold, either money or ornaments, she will marry a wealthy but mercenary man.[or]To find gold, indicates that your superior abilities will place you easily ahead in the race for honors and wealth.[or]If you lose gold, you will miss the grandest opportunity of your life through negligence.[or]To dream of finding a gold vein, denotes that some uneasy honor will be thrust upon you.[or]If you dream that you contemplate working a gold mine, you will endeavor to usurp the rights of others, and should beware of domestic scandals.[cycling]"
"gold"	"[one of]To dream of receiving gold is a very good omen: it denotes success in your present undertakings after experiencing some little difficulties.[or]If you pay gold it betokens increase of friends and business.[cycling]"
"gold"	"[one of]To dream of receiving gold is a good sign and shows you will be successful in all your undertakings.[or]To dream you pay gold betokens increase of friends.[cycling]"
"water"	"[one of]To dream you are drinking water, denotes great trouble and adversity.[or]In trade loss of business and being arrested; to the lover, it shows your sweetheart is false, prefers another, and will never marry you.[cycling]"
"water"	"[one of]To dream of clear water, foretells that you will joyfully realize prosperity and pleasure.[or]If the water is muddy, you will be in danger and gloom will occupy.[or]Pleasure's seat.[or]If you see it rise up in your house, denotes that you will struggle to resist evil, but unless you see it subside, you will succumb to dangerous influences.[or]If you find yourself baling it out, but with feet growing wet, foreshadows trouble, sickness, and misery will work you a hard task, but you will forestall them by your watchfulness.[or]The same may be applied to muddy water rising in vessels.[or]To fall into muddy water, is a sign that you will make many bitter mistakes, and will suffer poignant grief therefrom.[or]To drink muddy water, portends sickness, but drinking it clear and refreshing brings favorable consummation of fair hopes.[or]To sport with water, denotes a sudden awakening to love and passion.[or]To have it sprayed on your head, denotes that your passionate awakening to love will meet reciprocal consummation.[or]The following dream and its allegorical occurrence in actual life is related by a young woman student of dreams:.[or]``Without knowing how,.[or]I was (in my dream) on a boat,.[or]I waded through clear blue water to a wharfboat, which.[or]I found to be snow white, but rough and splintry.[or]The next evening.[or]I had a delightful male caller, but he remained beyond the time prescribed by mothers and.[or]I was severely censured for it.''.[or]The blue water and fairy white boat were the disappointing prospects in the symbol.[cycling]"
"water"	"[one of]To dream of being on the water is good if the water be clear; but if muddy or troubled the reverse.[or]To see a wide expanse of water over or on which you wish to get but cannot shows that you are about to embark in some undertaking without first securing the means of success.[cycling]"
"women"	"[one of]To dream of women, foreshadows intrigue.[or]To argue with one, foretells that you will be outwitted and foiled.[or]To see a dark-haired woman with blue eyes and a pug nose, definitely determines your withdrawal from a race in which you stood a showing for victory.[or]If she has brown eyes and a Roman nose, you will be cajoled into a dangerous speculation.[or]If she has auburn hair with this combination, it adds to your perplexity and anxiety.[or]If she is a blonde, you will find that all your engagements will be pleasant and favorable to your inclinations.[cycling]"
"armed men"	"[one of]To see them in your dream, is a good sign, and denotes one void of fear; to dream you see an armed man fly is a sign of victory; to see men come in arms against you, signifies sadness.[cycling]"
"children"	"[one of]To dream you see children, denotes success in your undertakings.[or]To dream you see a child born, denotes a speedy marriage and that you will be very happy with your family.[or]To dream you see a child die, imports that you will experience some very heavy misfortune, and that your sweetheart will marry another.[or]To dream you see children dirty and ragged, denotes that some friend will endeavor to prevail upon you to commit an act by which your reputation will be endangered; it also denotes that you will be in prison and experience poverty.[or]For a maiden to dream she is with child, denotes that some man will attempt to rob her of her chastity, and that if she resists she will marry and be very happy.[cycling]"
"children"	"[one of][or]``Dream of children sweet and fair,.[or]To you will come suave debonair,.[or]Fortune robed in shining dress,.[or]Bearing wealth and happiness.''.[or]To dream of seeing many beautiful children is portentous of great prosperity and blessings.[or]For a mother to dream of seeing her child sick from slight cause, she may see it enjoying robust health, but trifles of another nature may harass her.[or]To see children working or studying, denotes peaceful times and general prosperity.[or]To dream of seeing your child desperately ill or dead, you have much to fear, for its welfare is sadly threatened.[or]To dream of your dead child, denotes worry and disappointment in the near future.[or]To dream of seeing disappointed children, denotes trouble from enemies, and anxious forebodings from underhanded work of seemingly friendly people.[or]To romp and play with children, denotes that all your speculating and love enterprises will prevail.[cycling]"
"husbandmen"	"[one of]To see yourself become a husbandman in your dream, shows you shall meet with great toil, yet after awhile become rich.[or]If you dream you are ploughing, it denotes success, and, to single persons, speedy marriage; and if the fields be full of flowers, it is a sign of much happiness.[cycling]"
"tradesmen"	"[one of]To dream you see those you employ at work, signifies that they are honest in their dealings with you.[or]To dream you work yourself, betokens a happy contented life.[cycling]"
"accounts"	"[one of]To dream of having accounts presented to you for payment, you will be in a dangerous position.[or]You may have recourse to law to disentangle yourself.[or]If you pay the accounts, you will soon effect a compromise in some serious dispute.[or]To hold accounts against others, foretells that disagreeable contingencies will arise in your business, marring the smoothness of its management.[or]For a young woman book-keeper to dream of footing up accounts, denotes that she will have trouble in business, and in her love affairs; but some worthy person will persuade her to account for his happiness.[or]She will be much respected by her present employers.[cycling]"
"accounts"	"[one of]Dreams that relate to making up accounts are good omens.[or]If you dream you found an error in your money account it foretells that you will have a piece of good luck.[or]Accounts blotted with ink is a sign of sickness.[cycling]"
"aches"	"[one of]To dream that you have aches, denotes that you are halting too much in your business, and that some other person is profiting by your ideas.[or]For a young woman to dream that she has the heartache, foretells that she will be in sore distress over the laggardly way her lover prosecutes his suit.[or]If it is the backache, she will encounter illness through careless exposure.[or]If she has the headache, there will be much disquietude of mind for the risk she has taken to rid herself of rivalry.[or]This dream is usually due to physical causes and is of little significance.[cycling]"
"acorns"	"[one of]To dream of acorns do not slight,.[or]It promises both strength and might.[cycling]"
"almonds"	"[one of]To dream one sees or eats almonds, signifies difficulties and trouble.[cycling]"
"almonds"	"[one of]This is a good omen.[or]It has wealth in store.[or]However, sorrow will go with it for a short while.[or]If the almonds are defective, your disappointment in obtaining a certain wish will be complete until new conditions are brought about.[cycling]"
"almonds"	"[one of]Signify riches and happiness; to eat them shows you will have good luck in love matters.[cycling]"
"alms"	"[one of]To dream that they are begged of you, and you deny to give them, shows want and misery to the dreamer; but to dream you give them freely is a sign of joy and gladness.[cycling]"
"alms"	"[one of]Alms will bring evil if given or taken unwillingly.[or]Otherwise, a good dream.[cycling]"
"alms"	"[one of]To dream they are begged of you and you refuse them shows want and misery to the dreamer; but to dream you give them freely is a sign of joy and long life.[cycling]"
"andirons"	"[one of]Andirons seen in a dream, denotes good will among friends, if the irons support burning logs; if they are in an empty fireplace, loss of property and death are signified.[cycling]"
"angels"	"[one of]To dream of angels is prophetic of disturbing influences in the soul.[or]It brings a changed condition of the person's lot.[or]If the dream is unusually pleasing, you will hear of the health of friends, and receive a legacy from unknown relatives.[or]If the dream comes as a token of warning, the dreamer may expect threats of scandal about love or money matters.[or]To wicked people, it is a demand to repent; to good people it should be a consolation.[cycling]"
"ants"	"[one of]To dream of these industrious little insects, hath a variety of interpretations, depending on the manner in which you dream of them; if you see them running about, it denotes that you will be a great loser by some plan that you will undertake for gain.[or]If you dream you see them busily employed laying in their winter stores, it is a good omen--things will prosper with you.[or]If they appear to be devoured by other animals, and otherwise injured and trodden upon, then it is a bad omen.[or]If you dream of these insects when you are sick, you must expect to recover very slowly.[cycling]"
"ants"	"[one of]The dreamer of ants should expect many petty annoyances during the day; chasing little worries, and finding general dissatisfaction in all things.[cycling]"
"ants"	"[one of]To dream of ants is unlucky; and to dream too often of them shows the dreamer not to be long lived.[cycling]"
"apes"	"[one of]To dream you have seen or had anything to do with them, signifies malicious, weak, strange and secret enemies; also a malefactor and deceiver.[cycling]"
"apes"	"[one of]This dream brings humiliation and disease to some dear friend.[or]To see a small ape cling to a tree, warns the dreamer to beware; a false person is close to you and will cause unpleasantness in your circle.[or]Deceit goes with this dream.[cycling]"
"apes"	"[one of]To dream you have seen or had any thing to do with them signifies malicious though secret enemies; and warns you against carrying on law-suits.[cycling]"
"apparitions"	"[one of]To dream you see apparitions is of a very unfortunate nature; if you are in love, it is a certain sign of your not being beloved in return; depend upon it some one is about to deceive you and that you are friendly with one who is your most inveterate enemy.[cycling]"
"apples"	"[one of]To dream of apples betokens long life and success, a boy to a woman with child, faithfulness in your sweetheart and riches by trade.[cycling]"
"apples"	"[one of]This is a very good dream to the majority of people.[or]To see red apples on trees with green foliage is exceedingly propitious to the dreamer.[or]To eat them is not as good, unless they be faultless.[or]A friend who interprets dreams says:.[or]``Ripe apples on a tree, denotes that the time has arrived for you to realize your hopes; think over what you intend to do, and go fearlessly ahead.[or]Ripe on the top of the tree, warns you not to aim too high.[or]Apples on the ground imply that false friends, and flatterers are working you harm.[or]Decayed apples typify hopeless efforts.''.[cycling]"
"apples"	"[one of]If sweet denote joy and pleasure especially to women and maids.[or]Sour apples signify contention and sedition.[cycling]"
"apricots"	"[one of]To dream of apricots, denotes health and prosperity, a speedy marriage, dutiful children and success in love.[cycling]"
"apricots"	"[one of]Content health and pleasure if in season; if otherwise vain hopes bad fortune.[cycling]"
"arms"	"[one of]To dream your arms are withered is a certain sign that you will decay in health and fortune.[or]To dream they are growing strong signifies that some unexpected success will attend you.[or]To dream that your right arm is cut off, denotes you will lose some male relation.[or]To dream your left arm is cut off, denotes you will lose some near female relative.[or]For a married woman to dream her arms have grown lusty and strong, denotes that she will have many male children, that her husband will arrive at public honors and will grow rich and make many friends.[cycling]"
"arms"	"[one of]To dream your arms are withered or lean denotes affliction sickness and poverty; and if a woman she is in danger of being a widow.[or]If any person dream his arms are hairy it denotes increase of riches.[cycling]"
"ashes"	"[one of]Dreaming of ashes omens woe, and many bitter changes are sure to come to the dreamer.[or]Blasted crops to the farmer.[or]Unsuccessful deals for the trader.[or]Parents will reap the sorrows of wayward children.[cycling]"
"ashes"	"[one of]Great misfortune is at hand; to a lover or sweetheart such a dream forebodes that he or she will be jealous because of seeing some one in company with their intended.[cycling]"
"asparagus"	"[one of]To dream of asparagus, signifies prosperous surroundings and obedience from servants and children.[or]To eat it, denotes interrupted success.[cycling]"
"asses"	"[one of]To dream you see jackasses, is a good sign.[or]To dream you are riding on an ass, is the forerunner of some foolish quarrel.[or]To dream that you are driving an ass, denotes that you will fall into some trouble, of which you will get the better.[or]To dream an ass runs after you, denotes that some slander will be raised against you by some foolish persons, who will be themselves the victims of the scandal raised against you.[or]To dream you see an ass fall loaded, is a very good import and shows that you will be the founder of your own fortune.[cycling]"
"atlas"	"[one of]To dream you are looking at an atlas, denotes that you will carefully study interests before making changes or journeys.[cycling]"
"attorneys"	"[one of]To dream that you are speaking with them, shows hindrance of business and that a man will have little success in his affairs.[cycling]"
"attorneys"	"[one of]To dream you are speaking with them shows hindrance of business and that it requires much circumspection to insure success in your affairs.[or]It also denotes loss of property.[cycling]"
"baby carriages"	"[one of]To dream of a baby carriage, denotes that you will have a congenial friend who will devise many pleasurable surprises for you.[cycling]"
"bagpipes"	"[one of]To dream of bagpipes signifies trouble contention and loss of a lawsuit.[cycling]"
"banquets"	"[one of]To dream of banquets denotes poverty and want.[cycling]"
"barkingdogs"	"[one of]Is a sign you have enemies who will detract and insult you.[cycling]"
"barrels"	"[one of]Signify wealth if they appear full; if empty poverty.[cycling]"
"bats"	"[one of]Awful is the fate of the unfortunate dreamer of this ugly animal.[or]Sorrows and calamities from hosts of evil work against you.[or]Death of parents and friends, loss of limbs or sight, may follow after a dream of these ghoulish monsters.[or]A white bat is almost a sure sign of death.[or]Often the death of a child follows this dream.[cycling]"
"beads"	"[one of]To dream of beads, foretells attention from those in elevated position will be shown you.[or]To count beads, portends immaculate joy and contentment.[or]To string them, you will obtain the favor of the rich.[or]To scatter them, signifies loss of caste among your acquaintances.[cycling]"
"beans"	"[one of]To dream you are eating beans always signifies trouble and dissension.[cycling]"
"beans"	"[one of]This is a bad dream.[or]To see them growing, omens worries and sickness among children.[or]Dried beans, means much disappointment in worldly affairs.[or]Care should be taken to prevent contagious diseases from spreading.[or]To dream of eating them, implies the misfortune or illness of a well loved friend.[cycling]"
"beans"	"[one of]To dream of eating beans is a sign of trouble.[or]If you are picking beans it denotes poverty.[cycling]"
"bed-bugs"	"[one of]Denote strife and quarrels.[cycling]"
"bedbugs"	"[one of]Seen in your dreams, they indicate continued sickness and unhappy states.[or]Fatalities are intimated if you see them in profusion.[or]To see bedbugs simulating death, foretells unhappiness caused by illness.[or]To mash them, and water appears instead of blood, denotes alarming but not fatal illness or accident.[or]To see bedbugs crawling up white walls, and you throw scalding water upon them, denotes grave illness will distress you, but there will be useless fear of fatality.[or]If the water fails to destroy them, some serious complication with fatal results is not improbable.[cycling]"
"beech and myrtle trees"	"[one of]Signifies wanton women and are good for those who would undertake any such business; to others they are pain and labor.[cycling]"
"bees"	"[one of]To dream they sting you, denotes loss of character, and if you are in love, of your sweetheart.[or]To dream you see them at work, is a very lucky dream; it forebodes great success by your own industry.[or]To dream you see them making their honey under your own roof is the best omen in the world.[or]For the rich to dream of bees, is rather unlucky, but to the poor, they denote comfort, affluence and success.[cycling]"
"bees"	"[one of]Bees signify pleasant and profitable engagements.[or]For an officer, it brings obedient subjects and healthful environments.[or]To a preacher, many new members and a praying congregation.[or]To business men, increase in trade.[or]To parents, much pleasure from dutiful children.[or]If one stings, loss or injury will bear upon you from a friendly source.[cycling]"
"bees"	"[one of]It is good and lucky to dream of bees; to a farmer it predicts good crops; to a lover excellent success with his sweetheart; to a maid it promises a good and wealthy husband.[cycling]"
"beetles"	"[one of]To dream of seeing them on your person, denotes poverty and small ills.[or]To kill them is good.[cycling]"
"beets"	"[one of]To dream of eating beets, signifies freedom from trouble and expedition on business, because they make the body soluble.[cycling]"
"beets"	"[one of]To see them growing abundantly, harvest and peace will obtain in the land; eating them with others, is full of good tidings.[or]If they are served in soiled or impure dishes, distressful awakenings will disturb you.[cycling]"
"beggars"	"[one of]To dream of beggars is rather unfavorable, especially to lovers and persons in business.[or]To dream they beg alms of you and that you refuse it, denotes misery, want, and a prison; if you are in love, some scandalous person will ruin you with your sweetheart.[or]To dream that you give them alms, indicates success in business, and that you will obtain, after much difficulty, the object of your affections; your children will be sickly, and narrowly escape many dangers.[cycling]"
"beggars"	"[one of]To dream that a beggar annoys you is a sign of misfortune or some piece of bad luck.[or]To a young girl who has a suitor it predicts that if she marries him she will be poor.[cycling]"
"bellows"	"[one of]Working a bellows, denotes a struggle, but a final triumph over poverty and fate by energy and perseverance.[or]To dream of seeing a bellows, distant friends are longing to see you.[or]To hear one, occult knowledge will be obtained by the help of powerful means.[or]One fallen into disuse, portends you have wasted energies under misguiding impulses.[cycling]"
"bells"	"[one of]To dream you hear the bells ringing, denotes a speedy marriage and that you will receive some very good news.[cycling]"
"bells"	"[one of]To dream one hears ringing of bells, if of a sanguine complexion, brings them good news; but to others, it shows alarms, murmurings, disturbances and commotions.[cycling]"
"bells"	"[one of]To hear bells tolling in your dreams, death of distant friends will occur, and intelligence of wrong will worry you.[or]Liberty bells, indicate a joyous victory over an opponent.[cycling]"
"bells"	"[one of]To dream that you hear bells ringing merrily is a sign of a wedding or else that you will soon hear some good news.[or]If the bell tolls solemnly it foretells a funeral or bad news.[or]To a girl the tolling of a bell predicts that some one will deceive her.[cycling]"
"billiards"	"[one of]Billiards, foretell coming troubles to the dreamer.[or]Law suits and contentions over property.[or]Slander will get in her work to your detriment.[or]If you see table and balls idle, deceitful comrades are undermining you{.}.[cycling]"
"birds"	"[one of]It is a favorable dream to see birds of beautiful plumage.[or]A wealthy and happy partner is near if a woman has dreams of this nature.[or]Moulting and songless birds, denotes merciless and inhuman treatment of the outcast and fallen by people of wealth.[or]To see a wounded bird, is fateful of deep sorrow caused by erring offspring.[or]To see flying birds, is a sign of prosperity to the dreamer.[or]All disagreeable environments will vanish before the wave of prospective good.[or]To catch birds, is not at all bad.[or]To hear them speak, is owning one's inability to perform tasks that demand great clearness of perception.[or]To kill than with a gun, is disaster from dearth of harvest.[cycling]"
"birds"	"[one of]To dream of birds is much better for the rich than the poor; to dream of little birds the contrary; to dream that you hear birds chirp is a good sign; to see birds fighting signifies adversity; to see birds fly over your head signifies prejudice by enemies.[cycling]"
"birds’nests"	"[one of]To dream that you find one is a good sign; to dream that you find one without either eggs or birds shows you will meet with great disappointment.[cycling]"
"birthday presents"	"[one of]Receiving happy surprises, means a multitude of high accomplishments.[or]Working people will advance in their trades.[or]Giving birthday presents, denotes small deferences, if given at a fete or reception.[cycling]"
"biscuits"	"[one of]Eating or baking them, indicates ill health and family peace ruptured over silly disputes.[cycling]"
"blackberries"	"[one of]To dream of blackberries denotes many ills.[or]To gather them is unlucky.[or]Eating them denotes losses.[cycling]"
"blossoming of trees"	"[one of]To dream you see all sorts of trees blossoming, is a sign of joy, comfort and recreation.[cycling]"
"blossoms"	"[one of]To dream of seeing trees and shrubs in blossom, denotes a time of pleasing prosperity is nearing you.[cycling]"
"blossoms"	"[one of]If you dream you see trees or plants in blossom it predicts that you will get some money or some article that you little expected.[or]It also signifies that you will be pleased at something that will soon happen.[cycling]"
"blows"	"[one of]Denotes injury to yourself.[or]If you receive a blow, brain trouble will threaten you.[or]If you defend yourself, a rise in business will follow.[cycling]"
"boils"	"[one of]To dream of a boil running pus and blood, you will have unpleasant things to meet in your immediate future.[or]May be that the insincerity of friends will cause you great inconvenience.[or]To dream of boils on your forehead, is significant of the sickness of some one near you.[cycling]"
"bolts"	"[one of]To dream of bolts, signifies that formidable obstacles will oppose your progress.[or]If the bolts are old or broken, your expectations will be eclipsed by failures.[cycling]"
"bones"	"[one of]To see your bones protruding from the flesh, denotes that treachery is working to ensnare you.[or]To see a pile of bones, famine and contaminating influences surround you.[cycling]"
"books"	"[one of]Pleasant pursuits, honor and riches to dream of studying them.[or]For an author to dream of his works going to press, is a dream of caution; he will have much trouble in placing them before the public.[or]To dream of spending great study and time in solving some intricate subjects, and the hidden meaning of learned authors, is significant of honors well earned.[or]To see children at their books, denotes harmony and good conduct of the young.[or]To dream of old books, is a warning to shun evil in any form.[cycling]"
"books"	"[one of]To be reading serious books shows honor and station in life; to read lascivious books shame and disgrace.[cycling]"
"boots"	"[one of]To see your boots on another, your place will be usurped in the affections of your sweetheart.[or]To wear new boots, you will be lucky in your dealings.[or]Bread winners will command higher wages.[or]Old and torn boots, indicate sickness and snares before you.[cycling]"
"boots"	"[one of]To dream of new boots and shoes indicates sweethearts to the single and friends to the married; old shoes or boots show separation and dirty or old ones are a sign of poverty and sorrow.[cycling]"
"bottles"	"[one of]Bottles are good to dream of if well filled with transparent liquid.[or]You will overcome all obstacles in affairs of the heart, prosperous engagements will ensue.[or]If empty, coming trouble will envelop you in meshes of sinister design, from which you will be forced to use strategy to disengage yourself.[cycling]"
"bottles"	"[one of]To dream of bottles is a good sign; to a man success in business; to a maid speedy marriage; if they are broken they signify sorrow.[cycling]"
"brambles"	"[one of]To dream of brambles entangling you, is a messenger of evil.[or]Law suits will go against you, and malignant sickness attack you, or some of your family.[cycling]"
"briars"	"[one of]To see yourself caught among briars, black enemies are weaving cords of calumny and perjury intricately around you and will cause you great distress, but if you succeed in disengaging yourself from the briars, loyal friends will come to your assistance in every emergency.[cycling]"
"briars"	"[one of]To dream that you are among briars and get pricked foretells that you will have an angry dispute with somebody.[or]If a young girl who has a lover dreams it she will probably get vexed at him.[cycling]"
"briars and brambles"	"[one of]If you dream you are passing through places covered with these things, it portends troubles; if they prick you, secret enemies will do you an injury with your friends and unfavorable tales will make your sweetheart shy of you; if they draw blood of you, expect heavy losses in trade.[or]If you dream you pass through them without injury, then you will at last triumph over all your enemies and become happy.[cycling]"
"bridle bits"	"[one of]To see bridle bits in your dreams, foretells you will subdue and overcome any obstacle opposing your advancement or happiness.[or]If they break or are broken you will be surprised into making concessions to enemies,.[cycling]"
"brothers"	"[one of]To see your brothers, while dreaming, full of energy, you will have cause to rejoice at your own, or their good fortune; but if they are poor and in distress, or begging for assistance, you will be called to a deathbed soon, or some dire loss will overwhelm you or them.[cycling]"
"brothers"	"[one of]To dream you see your brothers and sisters signifies long life to the dreamer but it portends a death in your family.[cycling]"
"bugs"	"[one of]To dream of bugs denotes that some disgustingly revolting complications will rise in your daily life.[or]Families will suffer from the carelessness of servants, and sickness may follow.[cycling]"
"buildings"	"[one of]To see large and magnificent buildings, with green lawns stretching out before them, is significant of a long life of plenty, and travels and explorations into distant countries.[or]Small and newly built houses, denote happy homes and profitable undertakings; but, if old and filthy buildings, ill health and decay of love and business will follow.[cycling]"
"bulls"	"[one of]To dream you are pursued by a bull, denotes that many injurious reports will be spread on your character.[or]If you dream the bull gores you, or tosses you, then expect shortly to lose your liberty; it denotes that some person in power will do you an injury.[cycling]"
"burglars"	"[one of]To dream that they are searching your person, you will have dangerous enemies to contend with, who will destroy you if extreme carefulness is not practised in your dealings with strangers.[or]If you dream of your home, or place of business, being burglarized, your good standing in business or society will be assailed, but courage in meeting these difficulties will defend you.[or]Accidents may happen to the careless after this dream.[cycling]"
"burns"	"[one of]Burns stand for tidings of good.[or]To burn your hand in a clear and flowing fire, denotes purity of purpose and the approbation of friends.[or]To burn your feet in walking through coals, or beds of fire, denotes your ability to accomplish any endeavor, however impossible it may be to others.[or]Your usual good health will remain with you, but, if you are overcome in the fire, it represents that your interests will suffer through treachery of supposed friends.[cycling]"
"butchers"	"[one of]To dream of seeing butchers is in general a very unlucky omen; it always foretells some injury to the dreamer.[or]If you see them cutting up meat some of your friends will be hanged, and you will experience much misery and poverty.[cycling]"
"butterflies"	"[one of]To dream you see gaudy butterflies portends much happiness and luxury.[cycling]"
"buttons"	"[one of]To dream of bright buttons is seldom good; if rusty, it portends misfortune; if covered, sadness.[or]If a man dreams he has lost all the buttons of his clothes, it is a sign he will not live long.[cycling]"
"buttons"	"[one of]To dream of sewing bright shining buttons on a uniform, betokens to a young woman the warm affection of a fine looking and wealthy partner in marriage.[or]To a youth, it signifies admittance to military honors and a bright career.[or]Dull, or cloth buttons, denotes disappointments and systematic losses and ill health.[or]The loss of a button, and the consequent anxiety as to losing a garment, denotes prospective losses in trade.[cycling]"
"cakes"	"[one of]To dream you are eating cakes, denotes happiness and prosperity.[or]Dream that cakes you knead and make,.[or]You thrive and many profits take.[cycling]"
"cakes"	"[one of]Batter or pancakes, denote that the affections of the dreamer are well placed, and a home will be bequeathed to him or her.[or]To dream of sweet cakes, is gain for the laboring and a favorable opportunity for the enterprising.[or]Those in love will prosper.[or]Pound cake is significant of much pleasure either from society or business.[or]For a young woman to dream of her wedding cake is the only bad luck cake in the category.[or]Baking them is not so good an omen as seeing them or eating them.[cycling]"
"cakes"	"[one of]If a housewife dreams of making round cakes it predicts that her husband will have a good store of luck and will make her a present.[or]To dream of eating cakes is also a favorable dream.[cycling]"
"calves"	"[one of]To dream of calves peacefully grazing on a velvety lawn, foretells to the young, happy, festive gatherings and enjoyment.[or]Those engaged in seeking wealth will see it rapidly increasing.[cycling]"
"camels"	"[one of]To see this beast of burden, signifies that you will entertain great patience and fortitude in time of almost unbearable anguish and failures that will seemingly sweep every vestige of hope from you.[or]To own a camel, is a sign that you will possess rich mining property.[or]To see a herd of camels on the desert, denotes assistance when all human aid seems at a low ebb, and of sickness from which you will arise, contrary to all expectations.[cycling]"
"canary birds"	"[one of]To dream of this sweet songster, denotes unexpected pleasures.[or]For the young to dream of possessing a beautiful canary, denotes high class honors and a successful passage through the literary world, or a happy termination of love's young dream.[or]To dream one is given you, indicates a welcome legacy.[or]To give away a canary, denotes that you will suffer disappointment in your dearest wishes.[or]To dream that one dies, denotes the unfaithfulness of dear friends.[or]Advancing, fluttering, and singing canaries, in luxurious apartments, denotes feasting and a life of exquisite refinement, wealth, and satisfying friendships.[or]If the light is weird or unnaturally bright, it augurs that you are entertaining illusive hopes.[or]Your over-confidence is your worst enemy.[or]A young woman after this dream should beware, lest flattering promises react upon her in disappointment.[or]Fairy-like scenes in a dream are peculiarly misleading and treacherous to women.[cycling]"
"candles"	"[one of]To dream you see candles burning, if they burn clear and bright, that you will be speedily married.[or]To dream that new candles are brought in, denotes that by the interference of friends, all your disputes will be amicably adjusted and that your sweetheart will recover from a fit of sickness.[or]A light that burns both bright and clear,.[or]Denotes some pleasant letter near;.[or]But if dull the candle grows,.[or]It certain disappointment shows.[cycling]"
"candles"	"[one of]To see them burning with a clear and steady flame, denotes the constancy of those about you and a well-grounded fortune.[or]For a maiden to dream that she is molding candles, denotes that she will have an unexpected offer of marriage and a pleasant visit to distant relatives.[or]If she is lighting a candle, she will meet her lover clandestinely because of parental objections.[or]To see a candle wasting in a draught, enemies are circulating detrimental reports about you.[or]To snuff a candle, portends sorowful{sic} news.[or]Friends are dead or in distressful straits.[cycling]"
"candles"	"[one of]To dream of lighted candles is a sign that you will become religious or will be soon visited by a minister who will tell you good news.[or]To see a candle extinguished is a sign of a funeral.[or]To light a candle success in what you undertake.[cycling]"
"cards"	"[one of]To dream that you are playing at cards is a sure prognostic that you will be in love, and speedily married.[or]If you hold a great many picture cards, your marriage will be the means of making you rich and happy.[or]If your cards are mostly diamonds, the person you marry will be of a sour and disagreeable temper.[or]If they are mostly hearts, your marriage will cement love, and you will be very happy and have many children.[or]If they are mostly clubs, you will get money by your marriage.[or]If they are mostly spades, your marriage will turn out very unhappy and your children will be unfaithful and subject to many hardships.[or]If you are in expectation of a place, you will get it, and if you are in business you will be successful.[cycling]"
"cards"	"[one of]If playing them in your dreams with others for social pastime, you will meet with fair realization of hopes that have long buoyed you up.[or]Small ills will vanish.[or]But playing for stakes will involve you in difficulties of a serious nature.[or]If you lose at cards you will encounter enemies.[or]If you win you will justify yourself in the eyes of the law, but will have trouble in so doing.[or]If a young woman dreams that her sweetheart is playing at cards, she will have cause to question his good intentions.[or]In social games, seeing diamonds indicate wealth; clubs, that your partner in life will be exacting, and that you may have trouble in explaining your absence at times; hearts denote fidelity and cosy surroundings; spades signify that you will be a widow and encumbered with a large estate.[cycling]"
"cards"	"[one of]Playing at cards dice or any other game in a dream shows the party will be fortunate in love affairs; for the tables and cards allude to love.[cycling]"
"carrots"	"[one of]To dream of carrots, signifies profit and strength to them which are at law for inheritance; for we pluck them out of the ground with our hands, branches, strings and veins.[cycling]"
"carrots"	"[one of]To dream of carrots or parsnips signifies profit and strength to those who are at law for an inheritance.[cycling]"
"cars"	"[one of]To dream of seeing cars, denotes journeying and changing in quick succession.[or]To get on one shows that travel which you held in contemplation will be made under different auspices than had been calculated upon.[or]To miss one, foretells that you will be foiled in an attempt to forward your prospects.[or]To get off of one, denotes that you will succeed with some interesting schemes which will fill you with self congratulations.[or]To dream of sleeping-cars, indicates that your struggles to amass wealth is animated by the desire of gratifying selfish and lewd principles which should be mastered and controlled.[or]To see street-cars in your dreams, denotes that some person is actively interested in causing you malicious trouble and disquiet.[or]To ride on a car, foretells that rivalry and jealousy will enthrall your happiness.[or]To stand on the platform of a street-car while it is running, denotes you will attempt to carry on an affair which will be extremely dangerous, but if you ride without accident you will be successful.[or]If the platform is up high, your danger will be more apparent, but if low, you will barely accomplish your purpose.[cycling]"
"caterpillars"	"[one of]To dream you see caterpillars, signifies ill luck and misfortune by secret enemies.[cycling]"
"caterpillars"	"[one of]To dream you see caterpillars denotes misfortune by secret enemies.[cycling]"
"cats"	"[one of]To dream of these domestic animals is indicative of much trouble and vexation; it denotes to the lover that your sweetheart is treacherous.[or]If you keep servants, they are unfaithful, and will rob you.[or]To dream you kill a cat, denotes that you discover a thief and prosecute him to conviction; expect also to lose your own liberty through some pretended friend.[cycling]"
"cats"	"[one of]To dream of a cat, denotes ill luck, if you do not succeed in killing it or driving it from your sight.[or]If the cat attacks you, you will have enemies who will go to any extreme to blacken your reputation and to cause you loss of property.[or]But if you succeed in banishing it, you will overcome great obstacles and rise in fortune and fame.[or]If you meet a thin, mean and dirty-looking cat, you will have bad news from the absent.[or]Some friend lies at death's door; but if you chase it out of sight, your friend will recover after a long and lingering sickness.[or]To hear the scream or the mewing of a cat, some false friend is using all the words and work at his command to do you harm.[or]To dream that a cat scratches you, an enemy will succeed in wrenching from you the profits of a deal that you have spent many days making.[or]If a young woman dreams that she is holding a cat, or kitten, she will be influenced into some impropriety through the treachery of others.[or]To dream of a clean white cat, denotes entanglements which, while seemingly harmless, will prove a source of sorrow and loss of wealth.[or]When a merchant dreams of a cat, he should put his best energies to work, as his competitors are about to succeed in demolishing his standard of dealing, and he will be forced to other measures if he undersells others and still succeeds.[or]To dream of seeing a cat and snake on friendly terms signifies the beginning of an angry struggle.[or]It denotes that an enemy is being entertained by you with the intention of using him to find out some secret which you believe concerns yourself; uneasy of his confidences given, you will endeavor to disclaim all knowledge of his actions, as you are fearful that things divulged, concerning your private life, may become public.[cycling]"
"cats"	"[one of]To see cats is hidden enmity; to be bitten by them denotes misfortune; to be scratched care and trouble; to caress them false friends; to kill one is triumph over your enemies; to dream of cats is also a sign of loss by thieves.[cycling]"
"cedars"	"[one of]To dream of seeing them green and shapely, denotes pleasing success in an undertaking.[or]To see them dead or blighted, signifies despair.[or]No object will be attained from seeing them thus.[cycling]"
"celestial signs"	"[one of]To dream of celestial signs, foretells unhappy occurrences will cause you to make unseasonable journeys.[or]Love or business may go awry, quarrels in the house are also predicted if you are not discreet with your engagements.[cycling]"
"chains"	"[one of]To dream of being bound in chains, denotes that unjust burdens are about to be thrown upon your shoulders; but if you succeed in breaking them you will free yourself from some unpleasant business or social engagement.[or]To see chains, brings calumny and treacherous designs of the envious.[or]Seeing others in chains, denotes bad fortunes for them.[cycling]"
"checkers"	"[one of]To dream of playing checkers, you will be involved in difficulties of a serious character, and strange people will come into your life, working you harm.[or]To dream that you win the game, you will succeed in some doubtful enterprise.[cycling]"
"checks"	"[one of]To dream of palming off false checks on your friends, denotes that you will resort to subterfuge in order to carry forward your plans.[or]To receive checks you will be able to meet your payments and will inherit money.[or]To dream that you pay out checks, denotes depression and loss in business.[cycling]"
"cheeks"	"[one of]To dream one hath cheeks plump, fat and of vermilion tincture, is good to all, especially women, but to dream that you are lean, pale, and full of wrinkles, signifies grief and heaviness.[cycling]"
"cherries"	"[one of]To dream of cherries is a disappointment in life, vexation in the married state and slight in love.[cycling]"
"cherries"	"[one of]To dream of cherries, denotes you will gain popularity by your amiability and unselfishness.[or]To eat them, portends possession of some much desired object.[or]To see green ones, indicates approaching good fortune.[cycling]"
"cherries"	"[one of]To dream of ripe cherries foretells that you will hear good news or that some one will do you a favor.[or]After such a dream you can easily borrow money if you wish to.[or]If the cherries are green or mixed your news will be a mixture of good and bad.[cycling]"
"cherubs"	"[one of]To dream you see cherubs, foretells you will have some distinct joy, which will leave an impression of lasting good upon your life.[or]To see them looking sorrowful or reproachful, foretells that distress will come unexpectedly upon you.[cycling]"
"chestnuts"	"[one of]To dream of handling chestnuts, foretells losses in a business way, but indicates an agreeable companion through life.[or]Eating them, denotes sorrow for a time, but final happiness.[or]For a young woman to dream of eating or trying her fortune with them, she will have a well-to-do lover and comparative plenty.[cycling]"
"chestnuts"	"[one of]To dream you are eating raw chestnuts shows you will be fortunate in love affairs.[or]Boiled chestnuts signifies you will be fortunate in business.[or]To dream you prick your hand with a chestnut burr is a sign your confidence will be abused by a pretended friend.[cycling]"
"chickens"	"[one of]To dream of a hen and chickens is the forerunner of ill luck; your sweetheart will betray you and marry another.[or]If you are a farmer, you will have a bad crop and lose many of your poultry.[or]If you are in trade some sharper will defraud you.[or]If you go to sea, you will lose your goods and narrowly escape shipwreck.[cycling]"
"chickens"	"[one of]To dream of seeing a brood of chickens, denotes worry from many cares, some of which of which will prove to your profit.[or]Young or half grown chickens, signify fortunate enterprises, but to make them so you will have to exert your physical strength.[or]To see chickens going to roost, enemies are planning to work you evil.[or]To eat them, denotes that selfishness will detract from your otherwise good name.[or]Business and love will remain in precarious states.[cycling]"
"chimes"	"[one of]To dream of Christmas chimes, denotes fair prospects for business men and farmers.[or]For the young, happy anticipations fulfilled.[or]Ordinary chimes, denotes some small anxiety will soon be displaced by news of distant friends.[cycling]"
"clams"	"[one of]To dream of clams, denotes you will have dealings with an obstinate but honest person.[or]To eat them, foretells you will enjoy another's prosperity.[or]For a young woman to dream of eating baked clams with her sweetheart, foretells that she will enjoy his money as well as his confidence.[cycling]"
"clams"	"[one of]To a lover this dream is a sign he will be successful with his sweetheart; if the clams are large it signifies he will get through the world easy but if they are small he may get into difficulties and be caught in a tight place.[cycling]"
"clothes"	"[one of]To dream of seeing clothes soiled and torn, denotes that deceit will be practised to your harm.[or]Beware of friendly dealings with strangers.[or]For a woman to dream that her clothing is soiled or torn, her virtue will be dragged in the mire if she is not careful of her associates.[or]Clean new clothes, denotes prosperity.[or]To dream that you have plenty, or an assortment of clothes, is a doubtful omen; you may want the necessaries of life.[or]To a young person, this dream denotes unsatisfied hopes and disappointments.[cycling]"
"clouds"	"[one of]To dream of white clouds, signifies prosperity; clouds mounting high from the earth, denotes voyages, the return of the absent, and revealing of secrets; clouds red and inflamed, show an ill issue of affairs; to dream of dark and obscure clouds, shows an ill time of anger.[cycling]"
"clouds"	"[one of]To dream of seeing dark heavy clouds, portends misfortune and bad management.[or]If rain is falling, it denotes troubles and sickness.[or]To see bright transparent clouds with the sun shining through them, you will be successful after trouble has been your companion.[or]To see them with the stars shining, denotes fleeting joys and small advancements.[cycling]"
"clouds"	"[one of]To dream of white clouds signifies prosperity clouds mounting high from the earth denotes voyages the return of the absent and revealing of secrets; clouds red and inflamed show an ill-issue of affairs; dark and obscure clouds obstructions in love.[cycling]"
"coals"	"[one of]To dream of coals is a very unlucky omen.[or]It denotes much affliction and trouble.[or]To dream you see coals burning, if they are very clear and bright, is a good sign.[or]To dream you see the coals extinguished and reduced to cinders, denotes death, either to yourself or some near relation or friend; it also indicates great losses, and forewarns you of beggary and prison.[cycling]"
"coals"	"[one of]To see bright coals of fire, denotes pleasure and many pleasant changes.[or]To dream you handle them yourself, denotes unmitigated joy.[or]To see dead coals implies trouble and disappointments.[cycling]"
"coat-of-arms"	"[one of]To dream of seeing your coat-of-arms, is a dream of ill luck.[or]You will never possess a title.[cycling]"
"coins"	"[one of]To dream of gold, denotes great prosperity and much pleasure derived from sight-seeing and ocean voyages.[or]Silver coin is unlucky to dream about.[or]Dissensions will arise in the most orderly families.[or]For a maiden to dream that her lover gives her a silver coin, signifies she will be jilted by him.[or]Copper coins, denotes despair and physical burdens.[or]Nickel coins, imply that work of the lowest nature will devolve upon you.[or]If silver coins are your ideal of money, and they are bright and clean, or seen distinctly in your possession, the dream will be a propitious one.[cycling]"
"comets"	"[one of]To dream you see one of these extraordinary ethereal substances, is ominous of war, plague, famine, and death; to the lover it forebodes an entire frustration of his hopes; to the farmer, failure of crops; and to the seaman, storms and shipwrecks.[or]After such a dream change, if possible, your present place of residence.[cycling]"
"comic songs"	"[one of]To hear comic songs in dreams, foretells you will disregard opportunity to advance your affairs and enjoy the companionship of the pleasure loving.[or]To sing one, proves you will enjoy much pleasure for a time, but difficulties will overtake you.[cycling]"
"convicts"	"[one of]To dream of seeing convicts, denotes disasters and sad news.[or]To dream that you are a convict, indicates that you will worry over some affair; but you will clear up all mistakes.[or]For a young woman to dream of seeing her lover in the garb of a convict, indicates she will have cause to question the character of his love.[cycling]"
"copperas"	"[one of]To dream of copperas, foretells unintentional wrong will be done you which will be distressing and will cause you loss.[cycling]"
"corns"	"[one of]For a man to dream his flesh is full of corns, shows he will grow rich proportionately to his corns.[cycling]"
"corns"	"[one of]To dream that your corns hurt your feet, denotes that some enemies are undermining you, and you will have much distress; but if you succeed in clearing your feet of corns, you will inherit a large estate from some unknown source.[or]For a young woman to dream of having corns on her feet, indicates she will have to bear many crosses and be coldly treated by her sex.[cycling]"
"corns"	"[one of]For a man to dream his flesh is full of corns shows he will grow rich proportionably to his corns.[cycling]"
"cows"	"[one of]To dream of seeing cows waiting for the milking hour, promises abundant fulfilment of hopes and desires.[cycling]"
"cows"	"[one of]If you dream of seeing large herds of cows it predicts prosperity and wealth.[or]To see one cow in your dream is a sign of a good piece of luck of some kind.[or]If a young girl dreams of cows it is a sign she will marry a rich man and have numerous children.[cycling]"
"crabs"	"[one of]To dream of crabs, indicates that you will have many complicated affairs, for the solving of which you will be forced to exert the soundest judgment.[or]This dream portends to lovers a long and difficult courtship.[cycling]"
"crabs"	"[one of]a friend.[or]To the married this dream is a sign of separation.[cycling]"
"cries"	"[one of]To hear cries of distress, denotes that you will be engulfed in serious troubles, but by being alert you will finally emerge from these distressing straits and gain by this temporary gloom.[or]To hear a cry of surprise, you will receive aid from unexpected sources.[or]To hear the cries of wild beasts, denotes an accident of a serious nature.[or]To hear a cry for help from relatives, or friends, denotes that they are sick or in distress.[cycling]"
"cross roads"	"[one of]To dream of cross roads, denotes you will be unable to hold some former favorable opportunity for reaching your desires.[or]If you are undecided which one to take, you are likely to let unimportant matters irritate you in a distressing manner.[or]You will be better favored by fortune if you decide on your route.[or]It may be after this dream you will have some important matter of business or love to decide.[cycling]"
"cross-bones"	"[one of]To dream of cross-bones, foretells you will be troubled by the evil influence of others, and prosperity will assume other than promising aspects.[or]To see cross-bones as a monogram on an invitation to a funeral, which was sent out by a secret order, denotes that unnecessary fears will be entertained for some person, and events will transpire seemingly harsh, but of good import to the dreamer.[cycling]"
"crowns"	"[one of]To dream you see these emblems of royalty, portends success and elevation to dignities, either in the church or state.[or]For a maid to dream of a crown, shows she will marry a very industrious man, or one who is rich.[cycling]"
"crutches"	"[one of]To dream you are walking on crutches, is a very unfavorable omen.[or]To dream you see another walking on crutches, denotes that these things will happen to some friend.[or]If you are a married man, then that your wife is inconstant; if a married woman, then that the husband is ruining himself with some harlot.[cycling]"
"crutches"	"[one of]To dream that you go on crutches, denotes that you will depend largely on others for your support and advancement.[or]To see others on crutches, denotes unsatisfactory results from labors.[cycling]"
"crutches"	"[one of]If you dream you use them your love will forsake you; if you only see them some infirmity will press upon you; if you break them you will recover from sickness.[cycling]"
"cucumbers"	"[one of]To dream of cucumbers, denotes recovery to the sick, and that you will speedily fall in love, or that if you are in love, you will marry the object of your affection.[or]It also denotes moderate success in trade.[or]To the sailor it foretells a pleasant voyage and a sweetheart in a distant climate.[cycling]"
"cucumbers"	"[one of]To dream of these vegetables signifies that your business will not be very prosperous; for a sick person to dream of them foretells a speedy recovery.[cycling]"
"currants"	"[one of]To dream of currants prefigures happiness in life, success in undertakings, constancy in your sweetheart, handsome children to the married, riches to the farmer and tradesman.[cycling]"
"currants"	"[one of]Red currants denote happiness in life and success in love.[or]White currants portend that your partner will fall into difficulties and will have a long illness.[cycling]"
"curtains"	"[one of]To dream of curtains, foretells that unwelcome visitors will cause you worry and unhappiness.[or]Soiled or torn curtains seen in a dream means disgraceful quarrels and reproaches.[cycling]"
"cypress trees"	"[one of]To dream you see a cypress tree denotes affliction in business.[cycling]"
"dandelions"	"[one of]To dream of gathering dandelions is ominous to one.[or]To dream you see a large bed of them denotes that you have many new enemies forming, who will do you much injury in secret.[or]If one in love dreams of dandelions, be sure their sweetheart is playing them false.[cycling]"
"dates"	"[one of]To dream of seeing them on their parent trees, signifies prosperity and happy union; but to eat them as prepared for commerce, they are omens of want and distress.[cycling]"
"dates"	"[one of]Dates denote many enemies and you will receive much injury by a person you little expect.[cycling]"
"diamonds"	"[one of]To dream of owning diamonds is a very propitious dream, signifying great honor and recognition from high places.[or]For a young woman to dream of her lover presenting her with diamonds, foreshows that she will make a great and honorable marriage, which will fill her people with honest pride; but to lose diamonds, and not find them again, is the most unlucky of dreams, foretelling disgrace, want and death.[or]For a sporting woman to dream of diamonds, foretells for her many prosperous days and magnificent presents.[or]For a speculator, it denotes prosperous transactions.[or]To dream of owning diamonds, portends the same for sporting men or women.[or]Diamonds are omens of good luck, unless stolen from the bodies of dead persons, when they foretell that your own unfaithfulness will be discovered by your friends.[cycling]"
"diamonds"	"[one of]To dream you wear a diamond denotes that you will be crossed in love and that your lover is unfaithful.[or]For a man of business to dream that he is dealing in diamonds is good it is a sure thing with him that he will become wealthy and retire to private life much respected.[cycling]"
"ditches"	"[one of]To dream of deep ditches, steep mountains, rocks, and other eminences, surely foretells danger and misfortune.[or]Expect thieves to rob your dwelling; that your children will be undutiful and bring you into trouble.[or]If you are in love, it foretells unhappiness if you marry your present sweetheart.[or]If you are in trade, it denotes loss of goods, if not of liberty.[cycling]"
"ditches"	"[one of]To dream of ditches steep mountains rocks and other eminences foretells danger and misfortune: expect thieves to rob your dwelling or that your children will be undutiful and bring you into trouble; if you are in love it foretells unhappiness if you marry your present sweetheart: if you are in trade it denotes loss of goods and other trouble: to farmers it foretells accidents to their live stock loss of sheep &c.[cycling]"
"divining rods"	"[one of]To see a divining rod in your dreams, foretells ill luck will dissatisfy you with present surroundings.[cycling]"
"docks"	"[one of]To dream of being on docks, denotes that you are about to make an unpropitious journey.[or]Accidents will threaten you.[or]If you are there, wandering alone, and darkness overtakes you, you will meet with deadly enemies, but if the sun be shining, you will escape threatening dangers.[cycling]"
"dogs"	"[one of]To dream of these faithful and domestic animals has very different significations, according to the manner in which you see them.[or]If they fawn and fondle upon you, then it is a very lucky omen.[or]If you are in love, your sweetheart will marry you and be very happy.[or]If they are barking and snarling at you, then depend that enemies are secretly endeavoring to destroy your reputation and happiness; if you are in love, be careful of your sweetheart.[cycling]"
"dogs"	"[one of]To dream of a vicious dog, denotes enemies and unalterable misfortune.[or]To dream that a dog fondles you, indicates great gain and constant friends.[or]To dream of owning a dog with fine qualities, denotes that you will be possessed of solid wealth.[or]To dream that a blood-hound is tracking you, you are likely to fall into some temptation, in which there is much danger of your downfall.[or]To dream of small dogs, indicates that your thoughts and chief pleasures are of a frivolous order.[or]To dream of dogs biting you, foretells for you a quarrelsome companion either in marriage or business.[or]Lean, filthy dogs, indicate failure in business, also sickness among children.[or]To dream of a dog-show, is indicative of many and varied favors from fortune.[or]To hear the barking of dogs, foretells news of a depressing nature.[or]Difficulties are more than likely to follow.[cycling]"
"dogs"	"[one of]To see dogs on the chase of foxes, and other large game, denotes an unusual briskness in all affairs.[or]To see fancy pet dogs, signifies a love of show, and that the owner is selfish and narrow.[or]For a young woman, this dream foretells a fop for a sweetheart.[or]To feel much fright upon seeing a large mastiff, denotes that you will experience inconvenience because of efforts to rise above mediocrity.[or]If a woman dreams this, she will marry a wise and humane man.[or]To hear the growling and snarling of dogs, indicates that you are at the mercy of designing people, and you will be afflicted with unpleasant home surroundings.[or]To hear the lonely baying of a dog, foretells a death or a long separation from friends.[or]To hear dogs growling and fighting, portends that you will be overcome by your enemies, and your life will be filled with depression.[or]To see dogs and cats seemingly on friendly terms, and suddenly turning on each other, showing their teeth and a general fight ensuing, you will meet with disaster in love and worldly pursuits, unless you succeed in quelling the row.[or]If you dream of a friendly white dog approaching you, it portends for you a victorious engagement whether in business or love.[or]For a woman, this is an omen of an early marriage.[or]To dream of a many-headed dog, you are trying to maintain too many branches of business at one time.[or]Success always comes with concentration of energies.[or]A man who wishes to succeed in anything should be warned by this dream.[or]To dream of a mad dog, your most strenuous efforts will not bring desired results, and fatal disease may be clutching at your vitals.[or]If a mad dog succeeds in biting you, it is a sign that you or some loved one is on the verge of insanity, and a deplorable tragedy may occur.[or]To dream of traveling alone, with a dog following you, foretells stanch friends and successful undertakings.[or]To dream of dogs swimming, indicates for you an easy stretch to happiness and fortune.[or]To dream that a dog kills a cat in your presence, is significant of profitable dealings and some unexpected pleasure.[or]For a dog to kill a snake in your presence, is an omen of good luck.[cycling]"
"dogs"	"[one of]To dream of those animals has very different significations; if they fawn and fondle upon you it is a lucky omen; if you are in love it portends marriage and happiness; but if they bark and snarl at you it denotes that enemies are endeavoring to destroy your reputation and happiness; if in love crosses.[cycling]"
"dolphins"	"[one of]To dream of seeing these beautiful fishes playing in the water denotes the death of some dear friend or relative.[cycling]"
"domestics"	"[one of]To dream of having a great number of servants is illness.[cycling]"
"dominoes"	"[one of]To dream of playing at dominoes, and lose, you will be affronted by a friend, and much uneasiness for your safety will be entertained by your people, as you will not be discreet in your affairs with women or other matters that engage your attention.[or]If you are the winner of the game, it foretells that you will be much courted and admired by certain dissolute characters, bringing you selfish pleasures, but much distress to your relatives.[cycling]"
"doors"	"[one of]To dream you knock at a door and gain admittance shows success in your undertakings; if you cannot obtain entrance it shows disappointment.[cycling]"
"doves"	"[one of]Dreaming of doves mating and building their nests, indicates peacefulness of the world and joyous homes where children render obedience, and mercy is extended to all.[or]To hear the lonely, mournful voice of a dove, portends sorrow and disappointment through the death of one to whom you looked for aid.[or]Often it portends the death of a father.[or]To see a dead dove, is ominous of a separation of husband and wife, either through death or infidelity.[or]To see white doves, denotes bountiful harvests and the utmost confidence in the loyalty of friends.[or]To dream of seeing a flock of white doves, denotes peaceful, innocent pleasures, and fortunate developments in the future.[or]If one brings you a letter, tidings of a pleasant nature from absent friends is intimated, also a lovers' reconciliation is denoted.[or]If the dove seems exhausted, a note of sadness will pervade the reconciliation, or a sad touch may be given the pleasant tidings by mention of an invalid friend; if of business, a slight drop may follow.[or]If the letter bears the message that you are doomed, it foretells that a desperate illness, either your own or of a relative, may cause you financial misfortune.[cycling]"
"dreams"	"[one of]To dream you relate your dreams to any one shows something unlooked for will take place.[cycling]"
"ducks"	"[one of]To dream of seeing wild ducks on a clear stream of water, signifies fortunate journeys, perhaps across the sea.[or]White ducks around a farm, indicate thrift and a fine harvest.[or]To hunt ducks, denotes displacement in employment in the carrying out of plans.[or]To see them shot, signifies that enemies are meddling with your private affairs.[or]To see them flying, foretells a brighter future for you.[or]It also denotes marriage, and children in the new home.[cycling]"
"eagles"	"[one of]To dream you see an eagle soaring very high in the air, denotes prosperity, riches and honor; to the lover it foretells success in love and a happy marriage.[or]To dream you see an eagle perched on the steeple of a church, or on any high eminence, is a very good omen; it denotes that in some arduous undertaking you will be successful and thereby arrive at riches and honor; it also denotes that the dreamer will make his fortune beyond the sea.[or]If a woman with child dreams of an eagle, then it denotes that her offspring will marry well and be very happy.[cycling]"
"eagles"	"[one of]To see one soaring above you, denotes lofty ambitions which you will struggle fiercely to realize, nevertheless you will gain your desires.[or]To see one perched on distant heights, denotes that you will possess fame, wealth and the highest position attainable in your country.[or]To see young eagles in their eyrie, signifies your association with people of high standing, and that you will profit from wise counsel from them.[or]You will in time come into a rich legacy.[or]To dream that you kill an eagle, portends that no obstacles whatever would be allowed to stand before you and the utmost heights of your ambition.[or]You will overcome your enemies and be possessed of untold wealth.[or]Eating the flesh of one, denotes the possession of a powerful will that would not turn aside in ambitious struggles even for death.[or]You will come immediately into rich possessions.[or]To see a dead eagle killed by others than yourself, signifies high rank and fortune will be wrested from you ruthlessly.[or]To ride on an eagle's back, denotes that you will make a long voyage into almost unexplored countries in your search for knowledge and wealth which you will eventually gain.[cycling]"
"eagles"	"[one of]To dream you see an eagle soaring very high in the air denotes prosperity riches and honors: to the lover it foretells success in love and marriage.[cycling]"
"ear-rings"	"[one of]To dream of purchasing a pair of ear-rings is a good dream to the fair sex; to widows and maids they signify marriage; to those that have no children that they shall have children; and to those that have husbands and children purchases and riches; for as women are provided with these deckings so shall they be stored with husbands children and goods.[cycling]"
"earrings"	"[one of]To see earrings in dreams, omens good news and interesting work is before you.[or]To see them broken, indicates that gossip of a low order will be directed against you.[cycling]"
"ears"	"[one of]To dream of seeing ears, an evil and designing person is keeping watch over your conversation to work you harm.[cycling]"
"ears"	"[one of]To dream of boring many ears denotes obedience and readiness; to dream of cleansing them good news; of having your ears boxed ill news; of having large ears prosperity and honor; of being hurt or slit offence and treachery; of loss of ears loss of friendship; of loss of hearing betrayal of secrets; and to a woman ruin.[cycling]"
"earthquakes"	"[one of]Change of estate injuries death; to see a town destroyed by famine war and desolation.[cycling]"
"earthworms"	"[one of]To dream of earthworms, signifies secret enemies that endeavor to ruin and destroy us.[cycling]"
"eels"	"[one of]To dream of eels, signifies to beware of slippery pursuits and uncertain speculations.[or]If the eels escape you, you will be jilted in love; if you hold them, honor and happiness will be in store for you.[cycling]"
"eels"	"[one of]To dream of catching or handling eels denotes that you will have good fortune but difficulty.[or]If the eels slip through your hands and escape from you it shows that you will experience a loss.[cycling]"
"eggs"	"[one of]To dream you are buying or selling eggs, is a very favorable omen; whatever you are then about will succeed, whether it be love, trade, or getting a place.[or]To dream that you are eating eggs, denotes that you will shortly have a child and that your affairs will go well.[or]To dream your eggs are broken, denotes loss of goods, quarrels and poverty; if you are in love, it forebodes a separation between you and your sweetheart.[cycling]"
"eggs"	"[one of]To dream of finding a nest of eggs, denotes wealth of a substantial character, happiness among the married and many children.[or]This dream signifies many and varied love affairs to women.[or]To eat eggs, denotes that unusual disturbances threaten you in your home.[or]To see broken eggs and they are fresh, fortune is ready to shower upon you her richest gifts.[or]A lofty spirit and high regard for justice will make you beloved by the world.[or]To dream of rotten eggs, denotes loss of property and degradation.[or]To see a crate of eggs, denotes that you will engage in profitable speculations.[or]To dream of being spattered with eggs, denotes that you will sport riches of doubtful origin.[or]To see bird eggs, signifies legacies from distant relations, or gain from an unexpected rise in staple products.[cycling]"
"eggs"	"[one of]If married people dream of eggs it is a sign they will be prolific of children.[or]If a newly married lady dreams of finding a nest full of eggs it foretells that her first born will be twins or triplets.[or]If a young girl dreams such a dream it is a sign that she will soon be married or get ina condition that she ought to be a wife.[cycling]"
"elbows"	"[one of]To see elbows in a dream, signifies that arduous labors will devolve upon you, and for which you will receive small reimbursements.[or]For a young woman, this is a prognostic of favorable opportunities to make a reasonably wealthy marriage.[or]If the elbows are soiled, she will lose a good chance of securing a home by marriage.[cycling]"
"elderberries"	"[one of]To dream of elderberries augurs content and riches; to a maiden they bespeak a speedy marriage; to a married woman, that she will shortly be with child; to the tradesman, success in business; to the farmer, good crops.[cycling]"
"elderberries"	"[one of]To dream of seeing elderberries on bushes with their foliage, denotes domestic bliss and an agreeable county home with resources for travel and other pleasures.[or]Elderberries is generally a good dream.[cycling]"
"elderberries"	"[one of]To dream of elderberries augurs content and riches: to a maiden they bespeak a speedy marriage; to a married woman that she will shortly be with child; to the tradesman success in business; to the farmer good crops.[cycling]"
"elephants"	"[one of]To dream of an elephant is a very fortunate dream; it denotes acquirement of riches.[or]If you are in love, it denotes a speedy marriage with your sweetheart, and many children, chiefly boys, who will distinguish themselves by their learning.[cycling]"
"entrails"	"[one of]To dream of the human entrails, denotes horrible misery and despair, shutting out all hope of happiness.[or]To dream of the entrails of a wild beast, signifies the overthrow of your mortal enemy.[or]To tear the entrails of another, signifies cruel persecutions to further your own interests.[or]To dream of your own entrails, the deepest despair will overwhelm you.[or]To dream of the entrails of your own child, denotes that the child's, or your own, dissolution is at hand.[cycling]"
"entrails"	"[one of]This is a good dream for the poor but to the rich it portends loss of riches.[or]To sweethearts and beaus it shows that they will be happy in their loves.[cycling]"
"errands"	"[one of]To go on errands in your dreams, means congenial associations and mutual agreement in the home circle.[or]For a young woman to send some person on an errand, denotes she will lose her lover by her indifference to meet his wishes.[cycling]"
"evil spirits"	"[one of]To dream evil spirits obstruct your doing good under a show of devotion, denotes obstruction in your affairs by a hypocrite; and if you dream that you see hideous physiognomies, something vulgar will be revealed to you.[cycling]"
"eyebrows"	"[one of]To dream the eyebrows are hairy and of a good grace, is good, especially to a woman.[or]But if either men or women dream their eyebrows are more large or comely than they used to be, it is a sign they will succeed in the matrimonial way.[cycling]"
"eyebrows"	"[one of]Eyebrows, denotes that you will encounter sinister obstacles in your immediate future.[cycling]"
"eyebrows"	"[one of]Thick eyebrows are a sign of friends; thin ill-will and vexation; black good luck.[cycling]"
"eyes"	"[one of]To dream you lose your eyes, is a very unfortunate omen.[or]It denotes decay of circumstances, loss of friends, death of relations and miscarriage in love.[or]If a woman with child dreams of it, it denotes that the child will be very unhappy and lose its liberty.[cycling]"
"fables"	"[one of]To dream of reading or telling fables, denotes pleasant tasks and a literary turn of mind.[or]To the young, it signifies romantic attachments.[or]To hear, or tell, religious fables, denotes that the dreamer will become very devotional.[cycling]"
"fairs"	"[one of]To dream of going to fairs threatens the person so dreaming with having his pockets picked, or robbed in some other way.[cycling]"
"fates"	"[one of]To dream of the fates, unnecessary disagreements and unhappiness is foretold.[or]For a young woman to dream of juggling with fate, denotes she will daringly interpose herself between devoted friends or lovers.[cycling]"
"fears"	"[one of]To dream that you feel fear from any cause, denotes that your future engagements will not prove so successful as was expected.[or]For a young woman, this dream forebodes disappointment and unfortunate love.[cycling]"
"ferns"	"[one of]To see ferns in dreams, foretells that pleasant hours will break up gloomy forebodings.[or]To see them withered, indicates that much and varied illness in your family connections will cause you grave unrest.[cycling]"
"fields"	"[one of]To dream you are in green fields, is a very favorable omen.[or]To dream you are in ploughed fields, forebodes some severe disputes that will be brought upon you by some person who has no children.[or]To the lover, it denotes disappointment; to the married, unhappiness and undutiful children; to the tradesman, loss of business and a prison.[or]To dream you are in a meadow covered with flowers, is a very favorable omen.[or]If you are soliciting a place or favor, it portends you will surely obtain it.[cycling]"
"fields"	"[one of]To dream you are in a ploughed field forebodes some severe disputes that will be brought upon you by some person who has no children; to dream you are in a meadow covered with flowers is a very handsome wife who will bring you lovely children and make you very happy; to a woman it denotes that she will marry a handsome young fellow bywhom she will have beautiful children that they will become rich and live to a good old age.[cycling]"
"figs"	"[one of]To dream of figs, is the forerunner of prosperity and happiness.[or]To the lover, they denote the accomplishment of your wishes.[or]To the tradesman, increase of trade.[or]They are also indicative of legacy.[cycling]"
"figs"	"[one of]Figs, signifies a malarious condition of the system, if you are eating them, but usually favorable to health and profit if you see them growing.[or]For a young woman to see figs growing, signifies that she will soon wed a wealthy and prominent man.[cycling]"
"figs"	"[one of]To dream of eating good figs signifies joy and happiness; if the figs are mouldy or defective your pleasure will be marred by some disagreeable event.[cycling]"
"figures"	"[one of]Any number above _one_ and below _seventy-eight_ is deemed to portend good fortune to the dreamer but _forty-nine_ is the most lucky.[or]All numbers above _seventy-eight_ are uncertain except _three hundred and forty-three_ and that is a very lucky number.[cycling]"
"filberts"	"[one of]To dream of filberts, forebodes much trouble and anger from friends.[or]To the tradesman, they denote a prison, and decay of trade; to the lover, a complete disappointment; to the married, care and undutiful children.[cycling]"
"files"	"[one of]To dream of dealing in files, prognosticates activity.[or]To purchase files, shows you will have many applications to attend to business.[or]To sell files, shows you will have others to work for you, yielding profitably.[cycling]"
"finger-nails"	"[one of]To dream of soiled finger-nails, forbodes disgrace in your family by the wild escapades of the young.[or]To see well-kept nails, indicates scholarly tastes and some literary attainments; also, thrift.[cycling]"
"fingers"	"[one of]To dream you cut your fingers, if they bleed, is a very good omen.[or]You will be successful in love, and your sweetheart will prove kind and true.[or]You will get money from a quarter that you least expect, and be successful in your enterprises.[or]If you dream that they do not bleed, then it denotes damage by a variety of accidents.[or]That lawsuits will attend you, and that you will be unsuccessful in most of your pursuits.[or]In love you will not succeed with your present sweetheart, who prefers another.[or]To dream you lose your fingers, denotes the loss of friends, servants, goods, trade and sweethearts.[cycling]"
"fingers"	"[one of]To dream of seeing your fingers soiled or scratched, with the blood exuding, denotes much trouble and suffering.[or]You will despair of making your way through life.[or]To see beautiful hands, with white fingers, denotes that your love will be requited and that you will become renowned for your benevolence.[or]To dream that your fingers are cut clean off, you will lose wealth and a legacy by the intervention of enemies.[cycling]"
"fingers"	"[one of]To dream that you cut your fingers if they bleed is a very good omen; you will be successful in love and your sweetheart will prove kind and true.[cycling]"
"fire-arms"	"[one of][or]Pistol and.[cycling]"
"fireworks"	"[one of]To see fireworks, indicates enjoyment and good health.[or]For a young woman, this dream signifies entertainments and pleasant visiting to distant places.[cycling]"
"fish-ponds"	"[one of]To dream of fishponds, denotes thriving.[cycling]"
"fishhooks"	"[one of]To dream of fishhooks, denotes that you have opportunities to make for yourself a fortune and an honorable name if you rightly apply them.[cycling]"
"fits"	"[one of]To dream of having fits, denotes that you will fall a prey to ill health and will lose employment.[or]To see others in this plight, denotes that you will have much unpleasantness in your circle, caused by quarrels from those under you.[cycling]"
"fleas"	"[one of]To dream you are tormented with these little insects is unfavorable.[cycling]"
"fleas"	"[one of]To dream of fleas, indicates that you will be provoked to anger and retaliation by the evil machinations of those close to you.[or]For a woman to dream that fleas bite her, foretells that she will be slandered by pretended friends.[or]To see fleas on her lover, denotes inconstancy.[cycling]"
"fleas"	"[one of]To dream you are tormented with these little insects is of an unfavorable kind; evil and malicious enemies will do you much injury; your sweetheart will prove false.[cycling]"
"flies"	"[one of]To dream of a swarm of flies, denotes that you have many enemies; it also denotes that your sweetheart is not sincere, and cares but little about you.[or]To dream you kill them is a very good omen.[cycling]"
"flies"	"[one of]To dream of flies, denotes sickness and contagious maladies.[or]Also that enemies surround you.[or]To a young woman this dream is significant of unhappiness.[or]If she kills or exterminates flies, she will reinstate herself in the love of her intended by her ingenuity.[cycling]"
"flies"	"[one of]To dream of a swarm of flies denotes that you have many enemies; it also denotes that your sweetheart is not sincere and cares but little about you; to dream you kill them is a very good omen; it denotes success in love and trade.[cycling]"
"floods"	"[one of]To dream of a flood, shows that you will meet with great opposition from rich neighbors, and that a rich rival will attempt to alienate the affections of your mistress.[or]To the tradesman it denotes lawsuits, loss of business, and a prison; to the sailor, it denotes much success by sea, but danger on shore; to the farmer, it indicates loss of cattle and a dispute with the landlord.[or]To dream you are drowned in a flood, denotes that you will quit your native land and after many hardships and perils return to it rich and happy.[or]That you will marry a pretty woman and have fine children.[cycling]"
"floods"	"[one of]To dream of floods destroying vast areas of country and bearing you on with its muddy de'bris, denotes sickness, loss in business, and the most unhappy and unsettled situation in the marriage state.[cycling]"
"flowers"	"[one of]To dream you are gathering flowers, is a very favorable omen.[or]Expect to thrive in everything you undertake and that you will be successful in love, marry happily and have beautiful children.[or]Should they wilt in your hands, then expect heavy losses in trade, that your sweetheart will die; or, if you are married, that you will lose your husband or wife and also your favorite child.[cycling]"
"flowers"	"[one of]To dream you are gathering flowers is a very favorable omen: expect to thrive in every thing you undertake and that you will be successful in love marry happily and have beautiful children; should the flowers wither under your hands it foretells heavy losses in trade; that your sweetheart will die; or if you are married that you will lose your husband or wife or perhaps your favorite child.[cycling]"
"freckles"	"[one of]For a woman to dream that her face is freckled, denotes that many displeasing incidents will insinuate themselves into her happiness.[or]If she sees them in a mirror, she will be in danger of losing her lover to a rival.[cycling]"
"frogs"	"[one of]To dream of frogs, is a very favorable omen.[or]To the farmer, it foretells good crops and an increase of his live stock; to the tradesman, it denotes success in business; to the lover, a faithful sweetheart; to the married, an increase of children, who will be very happy; to the sailor, pleasant and prosperous voyages, with a wife in a distant country.[cycling]"
"frogs"	"[one of]To dream of catching frogs, denotes carelessness in watching after your health, which may cause no little distress among those of your family.[or]To see frogs in the grass, denotes that you will have a pleasant and even-tempered friend as your confidant and counselor.[or]To see a bullfrog, denotes, for a woman, marriage with a wealthy widower, but there will be children with him to be cared for.[or]To see frogs in low marshy places, foretells trouble, but you will overcome it by the kindness of others.[or]To dream of eating frogs, signifies fleeting joys and very little gain from associating with some people.[or]To hear frogs, portends that you will go on a visit to friends, but it will in the end prove fruitless of good.[cycling]"
"fruits"	"[one of]If you dream of fruits when out of season, or that you are gathering them when green, denotes sickness.[or]If you dream they are rotten, it foretells poverty.[or]To dream of gathering ripe fruit, when there is plenty, betokens happiness and riches, and the speedy receipt of money.[or]If you gather fruit from an old withered tree, it is a sign that you will unexpectedly inherit the effects of some aged person.[or]To dream you have made yourself sick by eating fruit, is a sorrowful omen.[cycling]"
"furs"	"[one of]To dream of dealing in furs, denotes prosperity and an interest in many concerns.[or]To be dressed in fur, signifies your safety from want and poverty.[or]To see fine fur, denotes honor and riches.[or]For a young woman to dream that she is wearing costly furs, denotes that she will marry a wise man.[cycling]"
"gallows"	"[one of]To dream of the gallows is a most fortunate omen.[or]It shows that the dreamer will become rich and arrive at great honors.[or]To the lover, it shows the consummation of his most sanguine wishes, and that by marriage he will become rich and happy, have many children, particularly a son, who will become a great man, and be the founder of his family’s honor.[cycling]"
"gallows"	"[one of]To dream of seeing a friend on the gallows of execution, foretells that desperate emergencies must be met with decision, or a great calamity will befall you.[or]To dream that you are on a gallows, denotes that you will suffer from the maliciousness of false friends.[or]For a young woman to dream that she sees her lover executed by this means, denotes that she will marry an unscrupulous and designing man.[or]If you rescue any one from the gallows, it portends desirable acquisitions.[or]To dream that you hang an enemy, denotes victory in all spheres.[cycling]"
"gallows"	"[one of]To dream of a gallows is a good omen as it denotes that you will have a chance to make money and if you are smart enough to avail yourself of the opportunity it will be all right.[or]To those embarking in new enterprises such a dream foretells success.[cycling]"
"games"	"[one of]To dream one plays at ball or top, signifies travail and pains, and to gain wealth by contention and injury.[or]To leap, run, or dance, signifies prosperity in affairs; but to dance without music, foretells want of money.[cycling]"
"gas"	"[one of]To dream of gas, denotes you will entertain harmful opinions of others, which will cause you to deal with them unjustly, and you will suffer consequent remorse.[or]To think you are asphyxiated, denotes you will have trouble which you will needlessly incur through your own wastefulness and negligence.[or]To try to blow gas out, signifies you will entertain enemies unconsciously, who will destroy you if you are not wary.[or]To extinguish gas, denotes you will ruthlessly destroy your own happiness.[or]To light it, you will easily find a way out of oppressive ill fortune.[cycling]"
"gas lamps"	"[one of]To see a gas lamp, denotes progress and pleasant surroundings.[or]To see one explode, or out of order other wise, foretells you are threatened with unseasonable distress.[cycling]"
"gas"	"[one of]If you dream of bright and pleasant gas-lights it shows success in love matters.[or]If the gas is dim and looks unnatural your beau or sweetheart will either leave you or die.[cycling]"
"gems"	"[one of]To dream of gems, foretells a happy fate both in love and business affairs.[cycling]"
"giants"	"[one of]To dream of seeing giants is ominous of good.[cycling]"
"gifts"	"[one of]To dream you have anything given you, is a sign that some good is about to happen to you.[or]It also denotes that a speedy marriage will take place between you and your sweetheart.[or]To dream you have given anything away, is the forerunner of adversity, and in love denotes sickness and inconstancy in your sweetheart or partner.[cycling]"
"girls"	"[one of]To dream of seeing a well, bright-looking girl, foretells pleasing prospects and domestic joys.[or]If she is thin and pale, it denotes that you will have an invalid in your family, and much unpleasantness.[or]For a man to dream that he is a girl, he will be weak-minded, or become an actor and play female parts.[cycling]"
"gloves"	"[one of]To dream of receiving a gift of a pair of gloves, signifies an offer of friendship.[or]If the gloves are light, the connection will be pleasant; if dark, it is doubtful.[or]To receive a package of gloves, signifies much good offered to you at one time.[or]To present gloves in a dream, signifies a gift in charity.[or]To dream of old, ragged gloves, signifies disappointment and deceit from your dearest friends.[cycling]"
"gloves"	"[one of]To dream of wearing new gloves, denotes that you will be cautious and economical in your dealings with others, but not mercenary.[or]You will have law suits, or business troubles, but will settle them satisfactorily to yourself.[or]If you wear old or ragged gloves, you will be betrayed and suffer loss.[or]If you dream that you lose your gloves, you will be deserted and earn your own means of livelihood.[or]To find a pair of gloves, denotes a marriage or new love affair.[or]For a man to fasten a lady's glove, he has, or will have, a woman on his hands who threatens him with exposure.[or]If you pull your glove off, you will meet with poor success in business or love.[cycling]"
"gloves"	"[one of]To dream of wearing good gloves brings happiness; if the gloves are torn many disappointments.[or]To the lover this dream is a sign he will get the mitten from his sweetheart.[cycling]"
"goggles"	"[one of]To dream of goggles, is a warning of disreputable companions who will wheedle you into lending your money foolishly.[or]For a young woman to dream of goggles, means that she will listen to persuasion which will mar her fortune.[cycling]"
"goggles"	"[one of]To dream that you are wearing these glasses to protect the eyes is a sign that you will see something disagreeable.[or]If a lover dreams such a dream he will be apt to see some young fellow making love or saying soft things to his sweetheart.[cycling]"
"gold leaves"	"[one of]To dream of gold leaves, signifies a flattering future is before you.[cycling]"
"gooseberries"	"[one of]To dream of gooseberries, indicates many children, chiefly sons, and an accomplishment of your present pursuits.[or]To the sailor, they declare dangers in his next voyage.[or]To the maiden, a proving husband, and to the man, a rakish wife.[cycling]"
"gooseberries"	"[one of]To dream of gathering gooseberries, is a sign of happiness after trouble, and a favorable indication of brighter prospects in one's business affairs.[or]If you are eating green gooseberries, you will make a mistake in your course to pleasure, and be precipitated into the vertex of sensationalism.[or]Bad results are sure to follow the tasting of green gooseberries.[or]To see gooseberries in a dream, foretells you will escape some dreaded work.[or]For a young woman to eat them, foretells she will be slightly disappointed in her expectations.[cycling]"
"gooseberries"	"[one of]To dream of gooseberries indicate many children chiefly sons and the accomplishment of your present pursuits.[or]To the maiden they foretell a cheerful husband; they also denote happiness in marriage and success in trade.[cycling]"
"grandparents"	"[one of]To dreaam{sic} of meeting your grandparents and conversing with them, you will meet with difficulties that will be hard to surmount, but by following good advice you will overcome many barriers.[cycling]"
"grapes"	"[one of]To dream of grapes, foretells to the maiden that her husband will be a cheerful companion and a great songster.[or]They denote much happiness in marriage and success in trade.[or]If you are in love, they augur a speedy union between you and your sweetheart.[cycling]"
"grapes"	"[one of]To eat grapes in your dream, you will be hardened with many cares; but if you only see them hanging in profuseness among the leaves, you will soon attain to eminent positions and will be able to impart happiness to others.[or]For a young woman, this dream is one of bright promise.[or]She will have her most ardent wish gratified.[or]To dream of riding on horseback and passing musca-dine bushes and gathering and eating some of its fruit, denotes profitable employment and the realization of great desires.[or]If there arises in your mind a question of the poisonous quality of the fruit you are eating, there will come doubts and fears of success, but they will gradually cease to worry you.[cycling]"
"grapes"	"[one of]To dream of an abundance of grapes is a good omen as is also a dream that you eat grapes of a pleasant flavor; but if the grapes are sour and broken it shows that you will have sorrow.[or]If a young girl dreams she has a present of beautiful grapes she will marry well within the year and be prolific of children.[cycling]"
"grasshoppers"	"[one of]This is an unfavorable dream to the sick but to a healthy person it foretells long life.[cycling]"
"groans"	"[one of]If you hear groans in your dream, decide quickly on your course, for enemies are undermining your business.[or]If you are groaning with fear, you will be pleasantly surprised at the turn for better in your affairs, and you may look for pleasant visiting among friends.[cycling]"
"groceries"	"[one of]To dream of general groceries, if they are fresh and clean, is a sign of ease and comfort.[cycling]"
"gulls"	"[one of]To dream of gulls, is a prophecy of peaceful dealings with ungenerous persons.[or]Seeing dead gulls, means wide separation for friends.[cycling]"
"guns"	"[one of]To dream you see people firing off guns or cannon, augurs that the dreamer will experience much adversity.[or]To dream that they are firing at you, shows that you will be exposed to many perilous dangers, such as shipwreck, assassination, or loss of liberty.[or]If you are firing at them yourself, it foretells that you will be involved in a lawsuit that will prove prejudicial to you.[cycling]"
"hairy hands"	"[one of]To dream that your hands are covered with hair like that of a beast, signifies you will intrigue against innocent people, and will find that you have alert enemies who are working to forestall your designs.[cycling]"
"handbills"	"[one of]To dream of distributing handbills over the country, is a sign of contentions and possible lawsuits.[or]If you dream of printing handbills, you will hear unfavorable news.[cycling]"
"handcuffs"	"[one of]To find yourself handcuffed, you will be annoyed and vexed by enemies.[or]To see others thus, you will subdue those oppressing you and rise above your associates.[or]To see handcuffs, you will be menaced with sickness and danger.[or]To dream of handcuffs, denotes formidable enemies are surrounding you with objectionable conditions.[or]To break them, is a sign that you will escape toils planned by enemies.[cycling]"
"handkerchiefs"	"[one of]To dream of handkerchiefs, denotes flirtations and contingent affairs.[or]To lose one, omens a broken engagement through no fault of yours.[or]To see torn ones, foretells that lovers' quarrels will reach such straits that reconciliation will be improbable if not impossible.[or]To see them soiled, foretells that you will be corrupted by indiscriminate associations.[or]To see pure white ones in large lots, foretells that you will resist the insistent flattery of unscrupulous and evil-minded persons, and thus gain entrance into high relations with love and matrimony.[or]To see them colored, denotes that while your engagements may not be strictly moral, you will manage them with such ingenuity that they will elude opprobrium.[or]If you see silk handkerchiefs, it denotes that your pleasing and magnetic personality will shed its radiating cheerfulness upon others, making for yourself a fortunate existence.[or]For a young woman to wave adieu or a recognition with her handkerchief, or see others doing this, denotes that she will soon make a questionable pleasure trip, or she may knowingly run the gauntlet of disgrace to secure some fancied pleasure.[cycling]"
"hands"	"[one of]If any one dreams that his hands are comelier and stronger than ordinary, he will be employed in some important affairs, which he will bring to a happy issue.[or]If one dreams that his hand is cut off, or that it has grown lean and dry, or hath been burnt, he will grow poor.[or]If a woman dreams thus, she will lose her husband, or her eldest son, or fall into a decay.[or]If any one dreams that he works with his right hand, it is a sign of good fortune to him and his family.[or]If with the left hand, that denotes bad luck.[or]To dream the hand is hairy, signifies trouble and imprisonment.[cycling]"
"heather bells"	"[one of]To dream of heather bells, foretells that joyous occasions will pass you in happy succession.[cycling]"
"hedges"	"[one of]To dream of hedges of evergreens, denotes joy and profit.[or]Bare hedges, foretells distress and unwise dealings.[or]If a young woman dreams of walking beside a green hedge with her lover, it foretells that her marriage will soon be consummated.[or]If you dream of being entangled in a thorny hedge, you will be hampered in your business by unruly partners or persons working under you.[or]To lovers, this dream is significant of quarrels and jealousies.[cycling]"
"herbs"	"[one of]To dream of herbs, denotes that you will have vexatious cares, though some pleasures will ensue.[or]To dream of poisonous herbs, warns you of enemies.[or]Balm and other useful herbs, denotes satisfaction in business and warm friendships.[cycling]"
"hieroglyphs"	"[one of]Hieroglyphs seen in a dream, foretells that wavering judgment in some vital matter may cause you great distress and money loss.[or]To be able to read them, your success in overcoming some evil is foretold.[cycling]"
"hills"	"[one of]To dream you are traveling over high hills and wading through great difficulties, having lost your way, shows you shall meet with assistance and have good counsel in your difficulties.[cycling]"
"hills"	"[one of]To dream of climbing hills is good if the top is reached, but if you fall back, you will have much envy and contrariness to fight against.[or]Ascend and.[cycling]"
"hips"	"[one of]To dream that you admire well-formed hips, denotes that you will be upbraided by your wife.[or]For a woman to admire her hips, shows she will be disappointed in love matters.[or]To notice fat hips on animals, foretells ease and pleasure.[or]For a woman to dream that her hips are too narrow, omens sickness and disappointments.[or]If too fat, she is in danger of losing her reputation.[cycling]"
"hives"	"[one of]To dream that your child is affected with hives, denotes that it will enjoy good health and be docile.[or]To see strange children thus affected, you will be unduly frightened over the condition of some favorite.[cycling]"
"hog’s-bristles"	"[one of]This dream denotes great violence and danger.[cycling]"
"hogs"	"[one of]To dream of seeing fat, strong-looking hogs, foretells brisk changes in business and safe dealings.[or]Lean hogs predict vexatious affairs and trouble with servants and children.[or]To see a sow and litter of pigs, denotes abundant crops to the farmer, and advance in the affairs of others.[or]To hear hogs squealing, denotes unpleasant news from absent friends, and foretells disappointment by death, or failure to realize the amounts you expected in deals of importance.[or]To dream of feeding your own hogs, denotes an increase in your personal belongings.[or]To dream that you are dealing in hogs, you will accumulate considerable property, but you will have much rough work to perform.[cycling]"
"hogs’ bristles"	"[one of]To dream that you have hogs’ bristles, signifies great and violent dangers.[cycling]"
"hops"	"[one of]To dream of hops, denotes thrift, energy and the power to grasp and master almost any business proposition.[or]Hops is a favorable dream to all classes, lovers and tradesmen.[cycling]"
"hops"	"[one of]To dream of seeing a large garden of hops in full leaf denotes thrift and wealth: if you see dried hops and smell their fragrance it shows that you will shortly come into a good lump of money from a legacy or a successful speculation.[cycling]"
"horns"	"[one of]To dream one hath horns on his head, signifies dominion, grandeur and royalty.[or]To dream you see a man with horns on his head, signifies he is in danger both of the loss of his person and estate.[cycling]"
"horns"	"[one of]To see horns on the head of another person danger to the dreamer on your own wealth and importance.[or]To dream you are gored by a horned animal denotes unhappiness.[or]To lovers it usually predicts that they will have difficulty in connection with their desires; if they think of marrying some obstacle will be placed in the way of their union though perhaps not prevent it in the end.[cycling]"
"horses"	"[one of]To see a horse with a tender foot, denotes that some unexpected unpleasantness will insinuate itself into your otherwise propitious state.[or]If you attempt to fit a broken shoe which is too small for the horse's foot, you will be charged with making fraudulent deals with unsuspecting parties.[or]To ride a horse down hill, your affairs will undoubtedly disappoint you.[or]For a young woman to dream that a friend rides behind her on a horse, denotes that she will be foremost in the favors of many prominent and successful men.[or]If she was frightened, she is likely to stir up jealous sensations.[or]If after she alights from the horse it turns into a pig, she will carelessly pass by honorable offers of marriage, preferring freedom until her chances of a desirable marriage are lost.[or]If afterward she sees the pig sliding gracefully along the telegraph wire, she will by intriguing advance her position,.[or]For a young woman to dream that she is riding a white horse up and down hill, often looking back and seeing some one on a black horse, pursuing her, denotes she will have a mixed season of success and sorow,{sic} but through it all a relentless enemy is working to overshadow her with gloom and disappointment.[or]To see a horse in human flesh, descending on a hammock through the air, and as it nears your house is metamorphosed into a man, and he approaches your door and throws something at you which seems to be rubber but turns into great bees, denotes miscarriage of hopes and useless endeavors to regain lost valuables.[or]To see animals in human flesh, signifies great advancement to the dreamer, and new friends will be made by modest wearing of well-earned honors, though if the human flesh appears diseased or freckled, the miscarriage of well-laid plans is denoted.[cycling]"
"horses"	"[one of]To dream of horses is a particularly good sign; inasmuch that if any one dreams that he is mounted on a stately horse, full of mettle, nimble and well-harnessed, he will have a handsome, noble and rich wife, provided the horse be his own.[or]To dream one sees a horse running, signifies prosperity and the accomplishment of one’s desires.[or]To dream of riding on a tired horse, shows one shall fall desperately in love.[or]To dream you see a horse dead, is a sign that stagnation will take place in your business, with some losses; but these may be overcome if the horse be well in flesh and has not died a natural death.[cycling]"
"hounds"	"[one of]To dream of hounds on a hunt, denotes coming delights and pleasant changes.[or]For a woman to dream of hounds, she will love a man below her in station.[or]To dream that hounds are following her, she will have many admirers, but there will be no real love felt for her.[cycling]"
"hymns"	"[one of]To dream of hearing hymns sung, denotes contentment in the home and average prospects in business affairs.[cycling]"
"icicles"	"[one of]To see icicles falling from trees, denotes that some distinctive misfortune, or trouble, will soon vanish.[cycling]"
"idols"	"[one of]Should you dream of worshiping idols, you will make slow progress to wealth or fame, as you will let petty things tyrannize over you.[or]To break idols, signifies a strong mastery over self, and no work will deter you in your upward rise to positions of honor.[or]To see others worshiping idols, great differences will rise up between you and warm friends.[or]To dream that you are denouncing idolatry, great distinction is in store for you through your understanding of the natural inclinations of the human mind.[cycling]"
"implements"	"[one of]To dream of implements, denotes unsatisfactory means of accomplishing some work.[or]If the implements are broken, you will be threatened with death or serious illness of relatives or friends, or failure n business.[cycling]"
"imps"	"[one of]To see imps in your dream, signifies trouble from what seems a passing pleasure.[or]To dream that you are an imp, denotes that folly and vice will bring you to poverty.[cycling]"
"infants"	"[one of]To dream of seeing a newly born infant, denotes pleasant surprises are nearing you.[or]For a young woman to dream she has an infant, foretells she will be accused of indulgence in immoral pastime.[or]To see an infant swimming, portends a fortunate escape from some entanglement.[cycling]"
"infernal things"	"[one of]If any one dreams that he sees the devil, or any other infernal spirit or representation, it is a very bad dream, bringing along with it to those sick, death, and to the healthy, melancholy, anger and violent sickness.[cycling]"
"infirmities"	"[one of]To dream of infirmities, denotes misfortune in love and business; enemies are not to be misunderstood, and sickness may follow.[or]To dream that you see others infirm, denotes that you may have various troubles and disappointments in business.[cycling]"
"jaws"	"[one of]To dream of seeing heavy, misshapen jaws, denotes disagreements, and ill feeling will be shown between friends.[or]If you dream that you are in the jaws of a wild beast, enemies will work injury to your affairs and happiness.[or]This is a vexatious and perplexing dream.[or]If your own jaws ache with pain, you will be exposed to climatic changes, and malaria may cause you loss in health and finances.[cycling]"
"jewels"	"[one of]To dream of possessing jewels, signifies that you are on the road to happiness.[cycling]"
"jewels"	"[one of]To dream of jewels, denotes much pleasure and riches.[or]To wear them, brings rank and satisfied ambitions.[or]To see others wearing them, distinguished places will be held by you, or by some friend.[or]To dream of jeweled garments, betokens rare good fortune to the dreamer.[or]Inheritance or speculation will raise him to high positions.[or]If you inherit jewelry, your prosperity will be unusual, but not entirely satisfactory.[or]To dream of giving jewelry away, warns you that some vital estate is threatening you.[or]For a young woman to dream that she receives jewelry, indicates much pleasure and a desirable marriage.[or]To dream that she loses jewels, she will meet people who will flatter and deceive her.[or]To find jewels, denotes rapid and brilliant advancement in affairs of interest.[or]To give jewels away, you will unconsciously work detriment to yourself.[or]To buy them, proves that you will be very successful in momentous affairs, especially those pertaining to the heart.[cycling]"
"jewels"	"[one of]Chains pearls or precious stones etc and all adornings upon the heads and necks of women are good dreams for the fair sex; to widows and maids they signify marriage; and to those that are married riches.[or]If a man dreams of possessing jewels it is a sure sign he will lose something of great value.[cycling]"
"juniper berries"	"[one of]To dream of these, signifies that the person so dreaming will shortly arrive at great honors and become a great person.[or]To the married it foretells the birth of a male child.[cycling]"
"katydids"	"[one of]To dream of hearing katydids, is a prognostic of misfortune and unusual dependence on others.[or]If any sick person ask you what they are, foretells there will be surprising events in your present and future.[or]For a woman to see them, signifies she will have a quarrelsome husband or lover.[cycling]"
"keys"	"[one of]To dream of keys is favorable to a person in trade, and to a sailor, they denote some gift, and that the dreamer will become rich.[or]To dream of finding a key, denotes an addition to your estate.[or]If you are married, it foretells the birth of a child.[or]If you give another a key, you will be speedily married.[or]In love, keys betoken faithfulness and a good tempered sweetheart.[or]To dream your keys are gone or lost.[or]Denotes that you’ll be vexed or crossed.[cycling]"
"kidneys"	"[one of]To dream about your kidneys, foretells you are threatened with a serious illness, or there will be trouble in marriage relations for you.[or]If they act too freely, you will be a party to some racy intrigue.[or]If they refuse to perform their work, there will be a sensation, and to your detriment.[or]If you eat kidney-stew, some officious person will cause you disgust in some secret lover affair.[cycling]"
"knives"	"[one of]To dream of knives is a very unpropitious omen.[or]It betokens lawsuits, poverty, disgrace, strife and a general failure in your projects.[or]In love, it shows that your sweetheart is of a bad temper, and unfaithful, and that if you marry you will live in enmity and misery.[cycling]"
"knives"	"[one of]To dream of knives is a bad omen; it betokens law-suits poverty disgrace and strife.[or]In love it shows quarrels and bad tempers.[cycling]"
"knots"	"[one of]To dream of seeing knots, denotes much worry over the most trifling affairs.[or]If your sweetheart notices another, you will immediately find cause to censure him.[or]To tie a knot, signifies an independent nature, and you will refuse to be nagged by ill-disposed lover or friend.[cycling]"
"ladies"	"[one of]To see one a sign of weakness; many ladies bring calumny and slander.[or]To see a light-haired one is a happy event to the dreamer; a brunette sickness; a pregnant lady brings good news; a naked lady signifies the death of a relative.[or]To hear a lady speak without seeing her foretells departure.[cycling]"
"lambs"	"[one of]To see young lambs frisking around their mother is an excellent omen as it denotes thrift and also happiness in your family ties; if you see them sucking it is a sign of an increase in your family by the birth of a child.[or]For lovers to dream of young lambs foretells a speedy and happy marriage.[cycling]"
"law and lawsuits"	"[one of]To dream of engaging in a lawsuit, warns you of enemies who are poisoning public opinion against you.[or]If you know that the suit is dishonest on your part, you will seek to dispossess true owners for your own advancement.[or]If a young man is studying law, he will make rapid rise in any chosen profession.[or]For a woman to dream that she engages in a law suit, means she will be calumniated, and find enemies among friends.[or]Judge and.[cycling]"
"lawns"	"[one of]To dream of walking upon well-kept lawns, denotes occasions for joy and great prosperity.[or]To join a merry party upon a lawn, denotes many secular amusements, and business engagements will be successfully carried on.[or]For a young woman to wait upon a green lawn for the coming of a friend or lover, denotes that her most ardent wishes concerning wealth and marriage will be gratified.[or]If the grass be dead and the lawn marshy, quarrels and separation may be expected.[or]To see serpents crawling in the grass before you, betrayal and cruel insinuations will fill you with despair.[cycling]"
"leaves"	"[one of]To dream of leaves, denotes happiness and wonderful improvement in your business.[or]Withered leaves, indicate false hopes and gloomy forebodings will harass your spirit into a whirlpool of despondency and loss.[or]If a young woman dreams of withered leaves, she will be left lonely on the road to conjugality.[or]Death is sometimes implied.[or]If the leaves are green and fresh, she will come into a legacy and marry a wealthy and prepossessing husband.[cycling]"
"leaves"	"[one of]To dream you see leaves growing freshly on a tree or plant is a good sign and shows you will live long and be happy; but to see leaves wither and fall to the ground is a sign of sickness and death.[cycling]"
"leeches"	"[one of]To dream of leeches, foretells that enemies will run over your interests.[or]If they are applied to you for medicinal purposes, you will have a serious illness tn your family (if you escape yourself).[or]To see them applied to others, denotes sickness or trouble to friends.[or]If they should bite you, there is danger for you in unexpected places, and you should heed well this warning.[cycling]"
"legs"	"[one of]To dream that your legs are scabby or itchy, signifies fruitless perplexity and care.[or]To dream one hath a wooden leg, signifies the alteration of condition, from good to bad, and from bad to worse.[cycling]"
"legs"	"[one of]If you dream of admiring well-shaped feminine legs, you will lose your judgment, and act very silly over some fair charmer.[or]To see misshapen legs, denotes unprofitable occupations and ill-tempered comrades.[or]A wounded leg, foretells losses and agonizing attacks of malaria.[or]To dream that you have a wooden leg, denotes that you will bemean yourself in a false way to your friends.[or]If ulcers are on your legs, it signifies a drain on your income to aid others.[or]To dream that you have three, or more, legs, indicates that more enterprises are planned in your imagination than will ever benefit you.[or]If you can't use your legs, it portends poverty.[or]To have a leg amputated, you will lose valued friends, and the home influence will render life unbearable.[or]For a young woman to admire her own legs, denotes vanity, and she will be repulsed by the man she admires.[or]If she has hairy legs, she will dominate her husband.[or]If your own legs are clean and well shaped, it denotes a happy future and devoted friends.[cycling]"
"legs"	"[one of]To dream of thick and fat legs is a bad omen as it foreshadows sickness: thin spindleshank legs are excellent ones to dream about as they denote a successful race with fortune.[or]It is not to be supposed that a lover will ever dream of his sweetheart’s legs but if he should do so he will probably imagine them to be round plump and of an alabaster whiteness; this is a bad dream and he should by all means avoid thinking of her legs when he goes to sleep: if a lady dreams that her lover’s legs are thin it foretells that he will be a rich man.[cycling]"
"lemons"	"[one of]To dream of lemons denotes contentions in your family and uneasiness on account of children.[or]They announce the death of some relation and disappointment in love.[cycling]"
"lemons"	"[one of]To dream of seeing lemons on their native trees among rich foliage, denotes jealousy toward some beloved object, but demonstrations will convince you of the absurdity of the charge.[or]To eat lemons, foretells humiliation and disappointments.[or]Green lemons, denotes sickness and contagion.[or]To see shriveled lemons, denotes divorce, if married, and separation, to lovers.[cycling]"
"lemons"	"[one of]To dream of lemons denotes contentions in your family and uneasiness on account of children; they announce the death of some relation and disappointment in love.[cycling]"
"leopards"	"[one of]Dreaming of leopards, foretells honor.[cycling]"
"letters"	"[one of]To dream you receive letters, is demonstrative of your being beloved by a person of the opposite sex, who is very much your friend.[or]To dream of writing letters, shows success in enterprises.[cycling]"
"letters"	"[one of]These paper missives are good to dream about: if you dream you receive a great number of letters it foretells that honors await you: to receive one letter in your dream denotes that some one is praising you behind your back.[or]If a girl dreams that she receives a love-letter from her beau it shows that he adores her: a gentleman who has a similar dream of a letter from his sweetheart may rest satisfied that he only possesses her heart.[cycling]"
"lilies"	"[one of]To dream that one sees, holds, smells lilies out of their season, it signifies that the hope of the thing desired will be frustrated.[or]But the same dream of lilies in their season is good.[cycling]"
"lilies"	"[one of]If you dream of an abundance of these beautiful flowers in your garden or door-yard it foretells good luck in getting servants or people to work for you; it also denotes thrift generally about a farm.[or]If a young girl dreams about lilies it is a sign she will marry a smart and industrious man and live happily with him.[cycling]"
"limes"	"[one of]To dream of eating limes, foretells continued sickness and adverse straits.[cycling]"
"lips"	"[one of]To dream that one hath red, handsome lips, is a sign that your friends enjoy their health.[or]And to have them dry and chapped, the contrary.[cycling]"
"lips"	"[one of]To dream of thick, unsightly lips, signifies disagreeable encounters, hasty decision, and ill temper in the marriage relation.[or]Full, sweet, cherry lips, indicates harmony and affluence.[or]To a lover, it augurs reciprocation in love, and fidelity.[or]Thin lips, signifies mastery of the most intricate subjects.[or]Sore, or swollen lips, denotes privations and unhealthful desires.[cycling]"
"loaves"	"[one of]To dream of loaves of bread, denotes frugality.[or]If they be of cake, the dreamer has cause to rejoice over his good fortune, as love and wealth will wait obsequiously upon you.[or]Broken loaves, bring discontent and bickerings between those who love.[or]To see loaves multiply phenomenally, prognosticates great success.[or]Lovers will be happy in their chosen ones.[cycling]"
"logs"	"[one of]To dream that one is cleaving a log is a sign that strangers shall come to the party dreaming.[cycling]"
"losses"	"[one of]To dream you lose something on which you set great value, denotes that you will hear of something which will give you great pleasure.[or]If you dream of losing money, you will receive a gift from some one which will astonish and please you.[or]To dream that you have lost some part of your dress, foretells you that there is some one intending to confer some favor on you.[cycling]"
"losses"	"[one of]To dream of losing your hat is a sign you will entertain a large company either by making a speech or otherwise attracting their attention: dreaming of the loss of money a watch or any valuables of that kind predicts that you will gain as much and perhaps more than your loss amounts to: if a girl dreams of losing her shoe-strings she will be kissed by an agreeable young man; any article of clothing that you may dream of having lost shows that you will rig yourself out in a new suit.[cycling]"
"lozenges"	"[one of]To dream of lozenges, foretells success in small matters.[or]For a woman to eat or throw them away, foretells her life will be harassed by little spites from the envious.[cycling]"
"maggots"	"[one of]To dream of seeing any thing putrid and covered with maggots is a sign of death; but the death may be that of your favorite dog cat or bird though such a dream often foretells the death of a relative or friend.[cycling]"
"manners"	"[one of]To dream of seeing ugly-mannered persons, denotes failure to carry out undertakings through the disagreeableness of a person connected with the affair.[or]If you meet people with affable manners, you will be pleasantly surprised by affairs of moment with you taking a favorable turn.[cycling]"
"manners"	"[one of]To dream of ill-mannered people who annoy you by their awkwardness and selfish conduct shows that you will shortly go on a journey and be introduced to a fool.[cycling]"
"markets"	"[one of]To dream of markets filled with goods and folks, is a good dream to those that traffic.[or]But riding to market signifies a short voyage.[or]If in a storm, the voyage will be difficult and the success of your voyage doubtful.[or]If in fair weather, the result will be the contrary.[cycling]"
"mars"	"[one of]To dream of Mars, denotes that your life will be made miserable and hardly worth living by the cruel treatment of friends.[or]Enemies will endeavor to ruin you.[or]If you feel yourself drawn up toward the planet, you will develop keen judgment and advance beyond your friends in learning and wealth.[cycling]"
"may bugs"	"[one of]To dream of May bugs, denotes an ill-tempered companion where a congenial one was expected.[cycling]"
"meals"	"[one of]To dream of meals, denotes that you will let trifling matters interfere with momentous affairs and business engagements.[cycling]"
"measles"	"[one of]If any one dreams he hath the measles, it denotes he shall gain profit and wealth, but it shall be with infamy.[cycling]"
"measles"	"[one of]To dream that you have measles, denotes much worry, and anxious care will interfere with your business affairs.[or]To dream that others have this disease, denotes that you will be troubled over the condition of others.[cycling]"
"measles"	"[one of]To dream you have this troublesome disorder shows that you will be fortunate provided you engage in some disreputable or dishonest speculation or in a robbery of money: but to conscientious people the omen does not hold good.[or]If a girl dreams of having the measles it predicts that a rogue will make love to her.[cycling]"
"melons"	"[one of]To dream of melons, to sick persons is a prognostic of recovery, by reason of their humidity or juicy substance.[cycling]"
"melons"	"[one of]To dream of ripe fine looking melons is an excellent omen as it foretells good health good luck and much happiness.[or]A watermelon full of black seeds denotes so much money to be paid to you.[or]If a married woman dreams this it promises her many children.[cycling]"
"meshes"	"[one of]To dream of being entangled in the meshes of a net, or other like constructions, denotes that enemies will oppress you in time of seeming prosperity.[or]To a young woman, this dream foretells that her environments will bring her into evil and consequent abandonment.[or]If she succeeds in disengaging herself from the meshes, she will narrowly escape slander.[cycling]"
"metals"	"[one of]To dream of metals has different signification and interpretations according to the metal you dream of To enable our readers to more readily discover the meaning of their dreams we subjoin a list of the metals with their explanations.[cycling]"
"models"	"[one of]To dream of a model, foretells your social affairs will deplete your purse, and quarrels and regrets will follow.[or]For a young woman to dream that she is a model or seeking to be one, foretells she will be entangled in a love affair which will give her trouble through the selfishness of a friend.[cycling]"
"molasses"	"[one of]To dream of molasses, is a sign that some one is going to extend you pleasant hospitality, and, through its acceptance, you will meet agreeable and fortunate surprises.[or]To eat it, foretells that you will be discouraged and disappointed in love.[or]To have it smeared on your clothing, denotes you will have disagreeable offers of marriage, and probably losses in business.[cycling]"
"moles"	"[one of]To dream of moles, indicates secret enemies.[or]To dream of catching a mole, you will overcome any opposition and rise to prominence.[or]To see moles, or such blemishes, on the person, indicates illness and quarrels.[cycling]"
"monkeys"	"[one of]To dream of these mischievous creatures, is ominous of evil.[or]They announce deceit in love, unfaithfulness in the married state, undutiful children, malicious enemies, and an attack by thieves.[cycling]"
"monuments"	"[one of]If a sick person dreams of seeing monuments, he or she is dreaming will quickly recover.[or]For the healthy to dream of monuments is a sign of good luck.[cycling]"
"moses"	"[one of]To dream that you see.[or]Moses, means personal gain and a connubial alliance which will be a source of sweet congratulation to yourself.[cycling]"
"mountains"	"[one of]To dream you see steep and craggy mountains, presages difficulties in accomplishing your designs.[or]If you ascend them and gain the top, you will be successful in whatever you undertake, become very rich, and arrive at great honors in the state.[or]To a maid, they denote that she will marry a man who will become rich and powerful, and that her children will be people of consequence.[cycling]"
"mulberries"	"[one of]To dream of mulberries is of good import.[or]To the maiden, they foretell a speedy and happy marriage.[or]To the lover, constancy and affection in his mistress.[or]They also denote wealth, honors and many children.[or]They are particularly favoring to sailors and farmers.[cycling]"
"mulberries"	"[one of]To see mulberries in your dreams, denotes that sickness will prevent you from obtaining your desires, and you will be called upon often to relieve suffering.[or]To eat them, signifies bitter disappointments.[cycling]"
"mulberries"	"[one of]To dream of mulberries denotes to the maiden a happy marriage; to the married affection and constancy.[cycling]"
"musical instruments"	"[one of]To see musical instruments, denotes anticipated pleasures.[or]If they are broken, the pleasure will be marred by uncongenial companionship.[or]For a young woman, this dream foretells for her the power to make her life what she will.[cycling]"
"mussels"	"[one of]To dream of water mussels, denotes small fortune, but contentment and domestic enjoyment.[cycling]"
"nails"	"[one of]To dream your nails are growing long is very good, and denotes riches, prosperity and happiness; great success in love, a good, industrious husband or wife, with dutiful children; it also foretells that you will suddenly receive a sum of money that will be of great use to you.[cycling]"
"nails"	"[one of]To see nails in your dreams, indicates much toil and small recompense.[or]To deal in nails, shows that you will engage in honorable work, even if it be lowly.[or]To see rusty or broken nails, indicates sickness and failure in business.[cycling]"
"nails"	"[one of]To dream that one’s nails are longer than usual signifies profit and the contrary loss: to dream your nails are cut off signifies loss and disgrace and contention with friends and relations.[or]If one dreams his nails are pulled off it threatens with misery and affliction and danger of death: for a man to dream he bites his nails shows quarrels and dissensions: to dream of paring your nails foretells a lingering sickness.[cycling]"
"nectarines"	"[one of]To dream of nectarines is ominous of strife between friends, of riches to the farmer and tradesman, of infidelity to lovers, of children to the married, of bad weather to the sailor, and to the poor they announce plenty and increase of wages.[cycling]"
"needles"	"[one of]To dream of needles signifies that you will be grievously injured by the deceit of supposed friends.[or]For a girl to dream that she pricks herself with a needle is a sign that her beau will attempt improper liberties.[cycling]"
"negroes"	"[one of]It is not good to dream of negroes, unless they be singing or dancing, or otherwise making merry.[or]To dream of seeing negroes in a church is ominous of evil.[cycling]"
"nets"	"[one of]To dream of ensnaring anything with a net, denotes that you will be unscrupulous in your dealings and deportment with others.[or]To dream of an old or torn net, denotes that your property has mortgages, or attachments, which will cause you trouble.[cycling]"
"nettles"	"[one of]If in your dreams you walk among nettles without being stung, you will be prosperous.[or]To be stung by them, you will be discontented with yourself and make others unhappy.[or]For a young woman to dream of passing through nettles, foretells that she will be offered marriage by different men, and her decision will fill her with anxious foreboding.[or]To dream of nettles, is portentous of stringent circumstances and disobedience from children or servants.[cycling]"
"news"	"[one of]To hear good news in a dream, denotes that you will be fortunate in affairs, and have harmonious companions; but if the news be bad, contrary conditions will exist.[cycling]"
"night-birds"	"[one of]To dream of any kind of night-birds, as the owl, bittern and bat, is ominous, and those who have such dreams should undertake no business on the day following.[or]He that travels by sea or land, and sees in his dream any of these birds, will fall into a great tempest or into the hands of thieves.[cycling]"
"night-walks"	"[one of]To dream of walking in the night, signifies trouble and melancholy.[cycling]"
"nine-pins"	"[one of]To dream of playing at nine-pins is a sign of quarreling; if successful, you will get the better of your adversary; if the reverse, you will be worsted.[cycling]"
"ninepins"	"[one of]To dream that you play ninepins, denotes that you are foolishly wasting your energy and opportunities.[or]You should be careful in the selection of companions.[or]All phases of this dream are bad.[cycling]"
"noodles"	"[one of]To dream of noodles, denotes an abnormal appetite and desires.[or]There is little good in this dream.[cycling]"
"nosegays"	"[one of]To dream of gathering and making nosegays is unlucky, showing that our hope shall wither as flowers do in a nosegay.[cycling]"
"numbers"	"[one of]To dream of numbers, denotes that unsettled conditions in business will cause you uneasiness and dissatisfaction.[cycling]"
"nuns"	"[one of]For a religiously inclined man to dream of nuns, foretells that material joys will interfere with his spirituality.[or]He should be wise in the control of self.[or]For a woman to dream of nuns, foretells her widowhood, or her separation from her lover.[or]If she dreams that she is a nun, it portends her discontentment with present environments.[or]To see a dead nun, signifies despair over the unfaithfulness of loved ones, and impoverished fortune.[or]For one to dream that she discards the robes of her order, foretells that longing for worldly pleasures will unfit her for her chosen duties.[cycling]"
"nutmegs"	"[one of]To dream of nutmegs is a sign that many changes will overtake you.[cycling]"
"nutmegs"	"[one of]To dream of nutmegs, is a sign of prosperity, and pleasant journeyings.[cycling]"
"nuts"	"[one of]To dream you see clusters of them denotes riches and happiness.[or]To the lover, success and a good-tempered sweetheart.[or]If you are gathering them, it is not a good omen, for you will pursue some matter that will not turn out to your advantage.[or]If you crack them, the person who courts you, or to whom you pay your addresses, will treat you with indifference, or be very unfaithful.[cycling]"
"nuts"	"[one of]To dream of gathering nuts, augurs successful enterprises, and much favor in love.[or]To eat them, prosperity will aid you in grasping any desired pleasure.[or]For a woman to dream of nuts, foretells that her fortune will be on blissful heights.[cycling]"
"nuts"	"[one of]To dream of nuts denotes riches and happiness; to the lover success; if you are gathering them it is a good omen; but if you crack them unfavorable.[cycling]"
"oats"	"[one of]To dream that oats hold the vision, portends a variety of good things.[or]The farmer will especially advance in fortune and domestic harmony.[or]To see decayed oats, foretells that sorrow will displace bright hopes.[cycling]"
"oats"	"[one of]To dream of this grain foretells a journey by land: if an engaged young girl dreams of oats it denotes that her wedding tour is not far off.[cycling]"
"olive trees"	"[one of]Dreaming that you see an olive tree with olives, denotes peace, delight, concord, liberty, dignity, and fruition of your desires.[or]To dream that you beat the olives down, is good for all but servants.[cycling]"
"olives"	"[one of]To dream you see olives, denotes happiness, and that you will be successful in all your present undertakings.[or]To the lover, they foretell a speedy marriage with the object of your affections.[or]If you are gathering them off the trees, they announce much trouble and vexation through friends and children; to the lover, they show your sweetheart is unfaithful.[cycling]"
"olives"	"[one of]Gathering olives with a merry band of friends, foretells favorable results in business, and delightful surprises.[or]If you take them from bottles, it foretells conviviality.[or]To break a bottle of olives, indicates disappointments on the eve of pleasure.[or]To eat them, signifies contentment and faithful friends.[cycling]"
"omnibus"	"[one of]To dream that you are being drawn through the streets in an omnibus, foretells misunderstandings with friends, and unwise promises will be made by you.[cycling]"
"onions"	"[one of]To dream of eating onions means.[or]Much strife in thy domestic scenes;.[or]Secrets found out or else betrayed,.[or]And many falsehoods made and said.[cycling]"
"onions"	"[one of]Seeing quantities of onions in your dreams, represents the amount of spite and envy that you will meet, by being successful.[or]If you eat them, you will overcome all opposition.[or]If you see them growing, there will be just enough of rivalry in your affairs, to make things interesting.[or]Cooked onions, denote placidity and small gains in business.[or]To dream that you are cutting onions and feel the escaping juice in your eyes, denotes that you will be defeated by your rivals.[cycling]"
"onions"	"[one of]To dream of this vegetable denotes both good and bad luck: if you are eating them you will soon receive some money; your sweetheart will be faithful but cross and you will be engaged in some dispute; if you are throwing onions away it is the forerunner of mischief; in love quarrels; in trade opposition.[cycling]"
"oranges"	"[one of]Dreaming that you see and cut oranges, signifies wounds, grief and vexation, whether they be ripe or not.[cycling]"
"oranges"	"[one of]Seeing a number of orange trees in a healthy condition, bearing ripe fruit, is a sign of health and prosperous surroundings.[or]To eat oranges is signally bad.[or]Sickness of friends or relatives will be a source of worry to you.[or]Dissatisfaction will pervade the atmosphere in business circles.[or]If they are fine and well-flavored, there will be a slight abatement of ill luck.[or]A young woman is likely to lose her lover, if she dreams of eating oranges.[or]If she dreams of seeing a fine one pitched up high, she will be discreet in choosing a husband from many lovers.[or]To slip on an orange peel, foretells the death of a relative.[or]To buy oranges at your wife's solicitation, and she eats them, denotes that unpleasant complications will resolve themselves into profit.[cycling]"
"orphans"	"[one of]Whoever dreams of orphans will receive profits or riches by the hand of a stranger.[or]For a man to dream of a female orphan, denotes that his wife will be rich.[or]To dream about orphans in any way is an excellent dream to both sexes.[cycling]"
"over-alls"	"[one of]For a woman to dream that she sees a man wearing over-alls, she will be deceived as to the real character of her lover.[or]If a wife, she will be deceived in her husband's frequent absence, and the real cause will create suspicions of his fidelity.[cycling]"
"oyster shells"	"[one of]To see oyster shells in your dreams, denotes that you will be frustrated in your attempt to secure the fortune of another.[cycling]"
"oysters"	"[one of]To dream you are eating oysters, is a very favorable omen.[cycling]"
"oysters"	"[one of]If you dream that you eat oysters, it denotes that you will lose all sense of propriety and morality in your pursuit of low pleasures, and the indulgence of an insatiate thirst for gaining.[or]To deal in oysters, denotes that you will not be over-modest in your mode of winning a sweetheart, or a fortune.[or]To see them, denotes easy circumstances, and many children are promised you.[cycling]"
"oysters"	"[one of]If in your dream you imagine you are eating oysters it denotes that you will have difficulties relative to money matters: but to rake them out of the water is a sign of money-getting: to dream of opening nice fat oysters for other people to eat is also a favorable omen as it shows that you will have plenty of cash.[cycling]"
"pantaloons"	"[one of]If you dream you have a new pair of pantaloons it is a sign you will be prosperous; if they do not fit and are too tight it is a sign you will be pinched in money matters; if they are dark it is a sign of long life but if light it denotes sickness.[or]Young girls should try and not dream about pantaloons for such an omen is very dangerous to them.[cycling]"
"parables"	"[one of]To dream of parables, denotes that you will be undecided as to the best course to pursue in dissenting to some business complication.[or]To the lover, or young woman, this is a prophecy of misunderstandings and disloyalty.[cycling]"
"paralysis"	"[one of]Paralysis is a bad dream, denoting financial reverses and disappointment in literary attainment.[or]To lovers, it portends a cessation of affections.[cycling]"
"parents"	"[one of]To see your parents looking cheerful while dreaming, denotes harmony and pleasant associates.[or]If they appear to you after they are dead, it is a warning of approaching trouble, and you should be particular of your dealings.[or]To see them while they are living, and they seem to be in your home and happy, denotes pleasant changes for you.[or]To a young woman, this usually brings marriage and prosperity.[or]If pale and attired in black, grave disappointments will harass you.[or]To dream of seeing your parents looking robust and contented, denotes you are under fortunate environments; your business and love interests will flourish.[or]If they appear indisposed or sad, you will find life's favors passing you by without recognition.[or]Father and.[cycling]"
"parsnips"	"[one of]To see or eat parsnips, is a favorable omen of successful business or trade, but love will take on unfavorable and gloomy aspects.[cycling]"
"partridges"	"[one of]Dreaming of partridges, is a sign that a man shall have to do with women that are malicious, ungrateful, and void of conscience.[cycling]"
"patches"	"[one of]For a woman to dream of patching the clothes of her husband or children is an excellent omen as it denotes that each patch will be a good lump of money brought into the family.[cycling]"
"paths"	"[one of]To dream in path both straight and fair,.[or]Your work doth happiness declare;.[or]But crooked ways denote much ill.[or]To those who have a headstrong will.[cycling]"
"paths"	"[one of]To dream you are walking in a broad good pathway denotes health and success; in love it shows you will meet with a sweetheart who will make you happy but if the path is crooked it foretells trouble to the dreamer.[cycling]"
"peaches"	"[one of]Dreaming of peaches in season, denotes content, health and pleasure.[cycling]"
"peaches"	"[one of]Dreaming of seeing or eating peaches, implies the sickness of children, disappointing returns in business, and failure to make anticipated visits of pleasure; but if you see them on trees with foliage, you will secure some desired position or thing after much striving and risking of health and money.[or]To see dried peaches, denotes that enemies will steal from you.[or]For a young woman to dream of gathering luscious peaches from well-filled trees, she will, by her personal charms and qualifications, win a husband rich in worldly goods and wise in travel.[or]If the peaches prove to be green and knotty, she will meet with unkindness from relatives and ill health will steal away her attractions.[cycling]"
"peaches"	"[one of]To dream of fine ripe yellow peaches denotes that you will get just so much yellow gold which makes this dream a splendid one for gold-diggers: if the peaches you dream about are very red or look small and wilted it shows that your gold will turn out to be about half copper or that your luck will not amount to much.[cycling]"
"peanuts"	"[one of]To dream of an abundance of ground-nuts or peanuts shows that you will be poor but contented healthy and happy.[or]If a married woman in the family-way dreams of them it is a sign she will have a boy.[cycling]"
"pearls"	"[one of]To dream of pearls, is a forerunner of good business and trade and affairs of social nature.[or]If a young woman dreams that her lover sends her gifts of pearls, she will indeed be most fortunate, as there will be occasions of festivity and pleasure for her, besides a loving and faithful affianced devoid of the jealous inclinations so ruinous to the peace of lovers.[or]If she loses or breaks her pearls, she will suffer indescribable sadness and sorrow through bereavement or misunderstandings.[or]To find herself admiring them, she will covet and strive for love or possessions with a pureness of purpose.[cycling]"
"pearls"	"[one of]To dream of these gems denotes poverty and misery; if a girl dreams that a lover gives her a piece of jewelry set in pearls it shows that he will never be well off; and if she imagines that he presents her with a string or necklace of pearls she may safely calculate that he will turn out to be a wretchedly poor man.[cycling]"
"pears"	"[one of]Dreaming of pears well baked, denotes great success and expedition in business.[cycling]"
"pears"	"[one of]To dream of eating pears, denotes poor success and debilitating health.[or]To admire the golden fruit upon graceful trees, denotes that fortune will wear a more promising aspect than formerly.[or]To dream of gathering them, denotes pleasant surprises will follow quickly upon disappointment.[or]To preserve them, denotes that you will take reverses philosophically.[or]Baking them, denotes insipid love and friendships.[cycling]"
"pears"	"[one of]To dream of ripe mellow pears portends elevation in life riches honors and constancy in love.[or]If a woman with child dream of them she will have a daughter.[or]To dream of unripe choke-pears is a sign of misfortunes and inconstancy in love.[cycling]"
"peas"	"[one of]Dreaming of eating peas, augurs robust health and the accumulation of wealth.[or]Much activity is indicated for farmers and their women folks.[or]To see them growing, denotes fortunate enterprises.[or]To plant them, denotes that your hopes are well grounded and they will be realized.[or]To gather them, signifies that your plans will culminate in good and you will enjoy the fruits of your labors.[or]To dream of canned peas, denotes that your brightest hopes will be enthralled in uncertainties for a short season, but they will finally be released by fortune.[or]To see dried peas, denotes that you are overtaxing your health.[or]To eat dried peas, foretells that you will, after much success, suffer a slight decrease in pleasure or wealth.[cycling]"
"peas"	"[one of]To dream of eating green peas is a sign of health; and if you imagine that you eat crooked dry peas it foretells both health and thrift.[or]If you dream of feeding any animal with dry peas it foreshadows good luck.[cycling]"
"pebbles"	"[one of]For a young woman to dream of a pebble-strewn walk, she will be vexed with many rivals and find that there are others with charms that attract besides her own.[or]She who dreams of pebbles is selfish and should cultivate leniency towards others' faults.[cycling]"
"pecans"	"[one of]To dream of eating this appetizing nut, you will see one of your dearest plans come to full fruition, and seeming failure prove a prosperous source of gain.[or]To see them growing among leaves, signifies a long, peaceful existence.[or]Failure in love or business will follow in proportion as the pecan is decayed.[or]If they are difficult to crack and the fruit is small, you will succeed after much trouble and expense, but returns will be meagre.[cycling]"
"penalties"	"[one of]To dream that you have penalties imposed upon you, foretells that you will have duties that will rile you and find you rebellious.[or]To pay a penalty, denotes sickness and financial loss.[or]To escape the payment, you will be victor in some contest.[cycling]"
"pens"	"[one of]To dream of writing with a steel pen is a sign you will get yourself into a bad scrape by tattling about your friends and neighbors.[or]If the pen be gold it foreshadows good news and success in business and love affairs.[or]To dream you are making a quill pen is a sign you have many enemies but that you will triumph over them and be successful in all you undertake.[or]But this dream does not amount to much as it is only a 'set-off' to dreaming of a pen-knife which is a bad omen.[cycling]"
"peppers"	"[one of]To dream of picking pepper-pods foretells to married people smart children if they have any.[or]A girl who dreams this will have a smart man for a lover but he will not pet her much either as a sweetheart or wife.[cycling]"
"phosphorus"	"[one of]To dream of seeing phosphorus, is indicative of evanescent joys.[or]For a young woman, it foretells a brilliant but brief success with admirers.[cycling]"
"pickles"	"[one of]To dream of pickles, denotes that you will follow worthless pursuits if you fail to call energy and judgment to your aid.[or]For a young woman to dream of eating pickles, foretells an unambitious career.[or]To dream of pickles, denotes vexation in love, but final triumph.[or]For a young woman to dream that she is eating them, or is hungry for them, foretells she will find many rivals, and will be overcome unless she is careful of her private affairs.[or]Impure pickles, indicate disappointing engagements and love quarrels.[cycling]"
"pickles"	"[one of]If a girl dreams of eating pickles it is a sign some old bachelor will kiss her: if a young man dreams of pickles he will be beloved by a maid older than himself and probably of a sour and crabbed temper.[cycling]"
"pictures"	"[one of]To dream you are looking at beautiful pictures, foreshows that you will be allured by false appearances into some unprofitable concern, that you will waste your time on some idle project, and that you will always be in pursuit of happiness without attaining it.[or]In love, it denotes great pleasure in the enjoyment of the beloved object.[or]It promises a handsome wife, a good husband, and beautiful children.[cycling]"
"pictures"	"[one of]Pictures appearing before you in dreams, prognosticate deception and the ill will of contemporaries.[or]To make a picture, denotes that you will engage in some unremunerative enterprise.[or]To destroy pictures, means that you will be pardoned for using strenuous means to establish your rights.[or]To buy them, foretells worthless speculation.[or]To dream of seeing your likeness in a living tree, appearing and disappearing, denotes that you will be prosperous and seemingly contented, but there will be disappointments in reaching out for companionship and reciprocal understanding of ideas and plans.[or]To dream of being surrounded with the best efforts of the old and modern masters, denotes that you will have insatiable longings and desires for higher attainments, compared to which present success will seem poverty-stricken and miserable.[or]Painting and.[cycling]"
"pictures"	"[one of]To dream of seeing pictures is a sign of joy without profit.[cycling]"
"pies"	"[one of]Dreaming of making pies is joy and profit.[cycling]"
"pies"	"[one of]To dream of eating pies, you will do well to watch your enemies, as they are planning to injure you.[or]For a young woman to dream of making pies, denotes that she will flirt with men for pastime.[or]She should accept this warning.[cycling]"
"pies"	"[one of]To dream of eating pie is a sign that you will soon be in want.[or]To dream you are making pies is a sign of pleasure and happiness.[cycling]"
"pigeons"	"[one of]Dreaming you see pigeons is good.[cycling]"
"pigeons"	"[one of]To dream of pigeons is a sign of content and delight and success in business.[cycling]"
"pigs"	"[one of]To dream of seeing pigs is good; if you are in trade you will have great increase in your business from foreign parts; if you are in love your sweetheart is thereby denoted to be of a good temper faithful and sincere to you and that if you marry you will become happy.[cycling]"
"pincers"	"[one of]To dream of feeling pincers on your flesh, denotes that you will be burdened with exasperating cares.[or]Any dream of pincers, signifies unfortunate incidents.[cycling]"
"pine trees"	"[one of]Dreaming that you see a pine tree, denotes idleness and remissness.[cycling]"
"pinks"	"[one of]If a lady dreams of pinks it foretells she will soon have a new bonnet that she will be delighted with: if a gentleman dreams of them his wife or sweetheart will get a new bonnet that will please him.[or]That’s all.[cycling]"
"pins"	"[one of]To dream of pins, augurs differences and quarrels ill families.[or]To a young woman, they warn her of unladylike conduct towards her lover.[or]To dream of swallowing a pin, denotes that accidents will force you into perilous conditions.[or]To lose one, implies a petty loss or disagreement.[or]To see a bent or rusty pin, signifies that you will lose esteem because of your careless ways.[or]To stick one into your flesh, denotes that some person will irritate you.[cycling]"
"pins"	"[one of]To dream of pins signifies that you will have small troubles all through life but no great disasters; to dream you find a pin is a sign of success in business; if a girl dream she is pricked with a pin she must keep a sharp look out for her lover or she may get in trouble.[cycling]"
"plains"	"[one of]To dream of being on a beautiful plain signifies health happiness and riches but portends some crosses in love.[cycling]"
"plants"	"[one of]To dream of healthy thriving plants is a good omen as it foretells success in life and smart children: such a dream is an excellent one for lovers as it denotes an early and happy marriage.[cycling]"
"plays"	"[one of]To dream you are at play, is the forerunner of good luck.[or]It betokens great happiness in the marriage state, and success in business.[or]To a maid, it shows speedy marriage with a young man, who will be very successful in life, and acquire riches and honors and make her happy.[cycling]"
"plums"	"[one of]To dream of plums, augurs but little good to the dreamer; they are the forerunners of ill luck, and show loss of goods and reputation.[or]They are indicative of infidelity in lovers and much vexation in the married state.[cycling]"
"plums"	"[one of]Plums, if they are green, unless seen on trees, are signs of personal and relative discomfort.[or]To see them ripe, denotes joyous occasions, which, however, will be of short duration.[or]To eat them, denotes that you will engage in flirtations and other evanescent pleasures.[or]To gather them, you will obtain your desires, but they will not prove so solid as you had imagined.[or]If you find yourself gathering them up from the ground, and find rotten ones among the good, you will be forced to admit that your expectations are unrealized, and that there is no life filled with pleasure alone.[cycling]"
"plums"	"[one of]To dream of an abundance of this fruit is a sign of health but yet you are liable to lose your life by an accident: if a girl dreams she is presented with plums it foretells her early death.[cycling]"
"pomegranates"	"[one of]To dream of pomegranates, foretells some very unexpected legacy, by which you will be enabled to make a fortune.[or]They denote that your sweetheart is of good temper, sings well, and is very faithful.[or]To the married, they show an increase of riches and children, and great success in trade.[cycling]"
"poplars"	"[one of]To dream of seeing poplars, is an omen of good, if they are in leaf or bloom.[or]For a young woman to stand by her lover beneath the blossoms and leaves of a tulip poplar, she will realize her most extravagant hopes.[or]Her lover will be handsome and polished.[or]Wealth and friends will be hers.[or]If they are leafless and withered, she will meet with disappointments.[cycling]"
"poppies"	"[one of]Poppies seen in dreams, represents a season of seductive pleasures and flattering business, but they all occupy unstable foundations.[or]If you inhale the odor of one, you will be the victim of artful persuasions and flattery.[or](The mesmeric influence of the poppy inducts one into strange atmospheres, leaving materiality behind while the subjective self explores these realms as in natural sleep; yet these dreams do not bear truthful warnings to the material man.[or]Being, in a manner, enforced.).[cycling]"
"pot herbs"	"[one of]To dream that you see pot herbs, especially such as have a strong smell, signifies a discovery of hidden secrets and domestic concerns.[cycling]"
"potatoes"	"[one of]Dreaming of potatoes, brings incidents often of good.[or]To dream of digging them, denotes success.[or]To dream of eating them, you will enjoy substantial gain.[or]To cook them, congenial employment.[or]Planting them, brings realization of desires.[or]To see them rotting, denotes vanished pleasure and a darkening future.[cycling]"
"prayers"	"[one of]To dream you offer up prayers and supplications to.[or]God, signifies happiness.[cycling]"
"precious stones"	"[one of]Precious stones, earrings, &c., and all adornings of the hands and necks of women, are good dreams to the fair sex; to widows and maids they signify marriage; and to those that have husbands and children, purchases and riches; for as women are provided with these deckings, so shall they be stored with husbands, children and goods.[cycling]"
"precipices"	"[one of]Dreaming that you see great precipices, signifies much injury to person and goods.[cycling]"
"predecessors"	"[one of]Dreaming of your predecessors, as grandfathers and other ancestors, signifies care.[cycling]"
"preserves"	"[one of]To dream that you make or eat them foretells the acquisition of much money and property also health and happiness.[cycling]"
"prisoners"	"[one of]To dream of seeing prisoners executed, is a good dream, signifies a boldness of courage and a very clear conscience.[cycling]"
"profits"	"[one of]To dream of profits, brings success in your immediate future.[cycling]"
"puddings"	"[one of]To dream of puddings, denotes small returns from large investments, if you only see it.[or]To eat it, is proof that your affairs will be disappointing.[or]For a young woman to cook, or otherwise prepare a pudding, denotes that her lover will be sensual and worldly minded, and if she marries him, she will see her love and fortune vanish.[cycling]"
"purchases"	"[one of]To dream of purchases usually augurs profit and advancement with pleasure.[cycling]"
"quails"	"[one of]Dreaming of quails signifies bad news.[cycling]"
"quills"	"[one of]To dream of quills, denotes to the literary inclined a season of success.[or]To dream of them as ornaments, signifies a rushing trade, and some remuneration.[or]For a young woman to be putting a quill on her hat, denotes that she will attempt many conquests, and her success will depend upon her charms.[cycling]"
"quilts"	"[one of]To dream of quilts, foretells pleasant and comfortable circumstances.[or]For a young woman, this dream foretells that her practical and wise business-like ways will advance her into the favorable esteem of a man who will seek her for a wife.[or]If the quilts are clean, but having holes in them, she will win a husband who appreciates her worth, but he will not be the one most desired by her for a companion.[or]If the quilts are soiled, she will bear evidence of carelessness in her dress and manners, and thus fail to secure a very upright husband.[cycling]"
"quinces"	"[one of]To dream of quinces, is favorable to the dreamer.[or]If you are in prison, you will be shortly liberated; if you are in trouble, a change will take place that will relieve you from it; if you are sick, you will soon recover; if you are in love, you will marry and become rich and happy.[cycling]"
"quinces"	"[one of]To dream of quinces is an excellent omen: if you imagine you are gathering quinces from trees full of fine-looking yellow ones it predicts that you will get just so much yellow gold which will be a fortune.[cycling]"
"quoits"	"[one of]If woman dreams she is playing at quoits, it denotes that she will have some disagreeable and laborious undertaking to go through.[or]To a man, it is a sign of quarreling.[or]Quoits were always considered a harbinger of ill luck by the gipsies.[cycling]"
"quoits"	"[one of]To play at quoits in dreams, foretells low engagements and loss of good employment.[or]To lose, portends of distressing conditions.[cycling]"
"quoits"	"[one of]If a man dreams he is playing quoits it is a sign he will soon have a quarrel.[or]If a woman dreams she is playing quoits it foretells she will have much trouble through life.[or]To dream of quoits is not a good omen to lovers.[cycling]"
"rabbits"	"[one of]To dream that you are among rabbits, denotes that, if you are a married person, you will have a numerous family of healthy children.[or]For a single person to dream of being among rabbits, indicates a speedy marriage.[or]To dream you are shooting rabbits, foretells sorrow and distress to the dreamer.[cycling]"
"rabbits"	"[one of]To dream of these animals foretells many small children: if a newly married woman dreams of them it is a sign that she will have twins or triplets within a year: such a dream will not be very pleasant to a young girl unless she means to marry right sudden for rabbits do not predict anything else but breeding children.[cycling]"
"races"	"[one of]To dream of running a race on foot and winning it is a sign of success in any undertaking—losing it foretells disappointment.[or]If you dream of going to a horse-race it predicts poverty and shiftlessness.[cycling]"
"radishes"	"[one of]To dream of radishes signifies a discovery of secrets or domestic jars.[or]To lovers they foretell misfortune.[cycling]"
"radishes"	"[one of]To dream of this vegetable signifies that a secret will be discovered which will occasion a muss in the family.[or]girl it is a sign she will lose her beau and to a lover it foreshadows he will be 'cut out' by some other nice young man.[cycling]"
"raisins"	"[one of]To dream of eating raisins, implies that discouragements will darken your hopes when they seem about to be realized.[cycling]"
"rapids"	"[one of]To imagine that you are being carried over rapids in a dream, denotes that you will suffer appalling loss from the neglect of duty and the courting of seductive pleasures.[cycling]"
"raspberries"	"[one of]To dream of raspberries, foretells you of success in marriage, fidelity in your sweetheart, and some news from beyond the sea to your advantage.[cycling]"
"raspberries"	"[one of]To dream of an abundance of this fruit is a sign of health and riches: if you dream you are eating raspberries it shows that you will be engaged in some enterprise that will bring you in a good deal of cash most of which will be spent lavishly.[cycling]"
"rats"	"[one of]To dream of seeing rats is a sign of having many enemies.[or]If you are attacked by rats, and get the better, it betokens you will overcome your difficulties.[or]If they should tear you, and make you run away, then expect some heavy misfortune.[cycling]"
"rats"	"[one of]To dream of rats is a sign that thieves are around: if you see any of these animals it shows that some friend will be robbed but if you hear them gnawing you will suffer a loss from robbery yourself.[or]If a girl who has a lover dreams of rats she had better be careful and not let him be too free with her person or he may rob her of that which cannot be restored.[cycling]"
"ravens"	"[one of]To dream you see a raven, is a very unfavorable omen.[or]It denotes mischief and adversity.[or]In love, it shows falsehood; to the married, they forebode much mischief, through the adultery of your conjugal partner.[or]To the sailor, they betoken shipwreck and much distress on a foreign shore.[cycling]"
"reapers"	"[one of]To dream of seeing reapers busy at work at their task, denotes prosperity and contentment.[or]If they appear to be going through dried stubble, there will be a lack of good crops, and business will consequently fall off.[or]To see idle ones, denotes that some discouraging event will come in the midst of prosperity.[or]To see a broken reaping machine, signifies loss of employment, or disappointment in trades.[cycling]"
"relations"	"[one of]If you dream of being annoyed at home by your relations it is a sign that you will be the subject of much scandal: if on the contrary you imagine that your relatives visit you and give you great pleasure by their society it foretells that you are talked about a good deal but always with respect and veneration.[cycling]"
"religious"	"[one of]For any one to dream of becoming religious foretells that they will be cheated or swindled in some way as such a dream works contrariwise: if you dream that a minister or any religious person exhorts you to become pious you had better look out sharp for some rogue is around contriving how to victimize you.[cycling]"
"rhinestones"	"[one of]To dream of rhinestones, denotes pleasures and favors of short duration.[or]For a young woman to dream that a rhinestone proves to be a diamond, foretells she will be surprised to find that some insignificant act on her part will result in good fortune.[cycling]"
"rhinoceros"	"[one of]To dream of this East.[or]India animal, denotes success to the man of business, but disappointment in love matters.[or]But to dream they injure you, is unfavorable to the dreamer.[or]If you dream you see one dead, you will soon lose a relative.[cycling]"
"rhinoceros"	"[one of]To dream that you see a rhinoceros, foretells you will have a great loss threatening you, and that you will have secret troubles.[or]To kill one, shows that you will bravely overcome obstacles.[cycling]"
"rhinoceros"	"[one of]To dream of this East.[or]India animal denotes success to the man of business but disappointment in love matters; but to dream they injure you is unfavorable to the dreamer.[or]If you dream you see one dead you’ll soon leave a relative.[cycling]"
"ribbons"	"[one of]For a girl to dream that she has got new and beautiful ribbons on her bonnet or dress is a sign some one will flatter her to her disadvantage: if she does not like the ribbon it shows that she will hear of some scandal relative to herself; and if the ribbon is red the scandal will impeach her chastity.[cycling]"
"ribs"	"[one of]If one dreams he hath his upper ribs broken or sunk, he will have some dissensions with his wife.[or]If he dreams his lower ribs are broken, he will be afflicted by his female relations and kindred.[or]If one dreams his limbs are grown longer and stronger than ordinary, he will take delight in his wife.[cycling]"
"riches"	"[one of]To dream that you are possessed of riches, denotes that you will rise to high places by your constant exertion and attention to your affairs.[cycling]"
"riddles"	"[one of]To dream that you are trying to solve riddles, denotes you will engage in some enterprise which will try your patience and employ your money.[or]The import of riddles is confusion and dissatisfaction.[cycling]"
"ringworms"	"[one of]To dream of having ringworms appear on you, you will have a slight illness, and some exasperating difficulty in the near future.[or]To see them on others, beggars and appeals for charity will beset you.[cycling]"
"rocks"	"[one of]To dream of rocks, denotes that you will meet reverses, and that there will be discord and general unhappiness.[or]To climb a steep rock, foretells immediate struggles and disappointing surroundings.[cycling]"
"rooks"	"[one of]To dream of rooks, denotes that while your friends are true, they will not afford you the pleasure and contentment for which you long, as your thoughts and tastes will outstrip their humble conception of life.[or]A dead rook, denotes sickness or death in your immediate future.[cycling]"
"roots"	"[one of]To dream of seeing roots of plants or trees, denotes misfortune, as both business and health will go into decline.[or]To use them as medicine, warns you of approaching illness or sorrow.[cycling]"
"ropes"	"[one of]Ropes in dreams, signify perplexities and complications in affairs, and uncertain love making.[or]If you climb one, you will overcome enemies who are working to injure you.[or]To decend{sic} a rope, brings disappointment to your most sanguine moments.[or]If you are tied with them, you are likely to yield to love contrary to your judgment.[or]To break them, signifies your ability to overcome enmity and competition.[or]To tie ropes, or horses, denotes that you will have power to control others as you may wish.[or]To walk a rope, signifies that you will engage in some hazardous speculation, but will surprisingly succeed.[or]To see others walking a rope, you will benefit by the fortunate ventures of others.[or]To jump a rope, foretells that you will startle your associates with a thrilling escapade bordering upon the sensational.[or]To jump rope with children, shows that you are selfish and overbearing; failing to see that children owe very little duty to inhuman parents.[or]To catch a rope with the foot, denotes that under cheerful conditions you will be benevolent and tender in your administrations.[or]To dream that you let a rope down from an upper window to people below, thinking the proprietors would be adverse to receiving them into the hotel, denotes that you will engage in some affair which will not look exactly proper to your friends, but the same will afford you pleasure and interest.[or]For a young woman, this dream is indicative of pleasures which do not bear the stamp of propriety.[cycling]"
"roses"	"[one of]To the married, foretell the loss of their children.[or]To the lover, infidelity in the sweetheart.[cycling]"
"roses"	"[one of]To dream of seeing roses blooming and fragrant, denotes that some joyful occasion is nearing, and you will possess the faithful love of your sweetheart.[or]For a young woman to dream of gathering roses, shows she will soon have an offer of marriage, which will be much to her liking.[or]Withered roses, signify the absence of loved ones.[or]White roses, if seen without sunshine or dew, denotes serious if not fatal illness.[or]To inhale their fragrance, brings unalloyed pleasure.[or]For a young woman to dream of banks of roses, and that she is gathering and tying them into bouquets, signifies that she will be made very happy by the offering of some person whom she regards very highly.[cycling]"
"ruins"	"[one of]To dream of ruins, signifies broken engagements to lovers, distressing conditions in business, destruction to crops, and failing health.[or]To dream of ancient ruins, foretells that you will travel extensively, but there will be a note of sadness mixed with the pleasure in the realization of a long-cherished hope.[or]You will feel the absence of some friend.[cycling]"
"samples"	"[one of]To dream of receiving merchandise samples, denotes improvement in your business.[or]For a traveling man to lose his samples, implies he will find himself embarrassed in business affairs, or in trouble through love engagements.[or]For a woman to dream that she is examining samples sent her, denotes she will have chances to vary her amusements.[cycling]"
"sardines"	"[one of]To eat sardines in a dream, foretells that distressing events will come unexpectedly upon you.[or]For a young woman to dream of putting them on the table, denotes that she will be worried with the attentions of a person who is distasteful to her.[cycling]"
"sausages"	"[one of]To dream of eating fried sausages foretells that you will come in contact with some person who is very poor and will be disagreeable to you: a girl who dreams this will be very sure to get a shiftless and needy lover and perhaps marry him if she is in much of a hurry to get married.[cycling]"
"scabs"	"[one of]To dream you are covered with scabs, is the sure forerunner of great success and riches.[cycling]"
"scales"	"[one of]To dream of weighing on scales, portends that justice will temper your conduct, and you will see your prosperity widening.[or]For a young woman to weigh her lover, the indications are that she will find him of solid worth, and faithfulness will balance her love.[cycling]"
"scales"	"[one of]To dream you are weighing any article is a good omen and signifies that you will be happy and long-lived; but to dream you see another using the scales is a sign you will be ruined by law-suits.[cycling]"
"scissors"	"[one of]To dream of scissors is an unlucky omen; wives will be jealous and distrustful of their husbands, and sweethearts will quarrel and nag each other into crimination and recrimination.[or]Dulness will overcast business horizons.[or]To dream that you have your scissors sharpened, denotes that you will work to do that which will be repulsive to your feelings.[or]To break them, there will be quarrels, and probable separations for you.[or]To lose them, you will seek to escape from unpleasant tasks.[cycling]"
"scissors"	"[one of]To dream of a pair of scissors is a sign of a marriage; if a girl dreams of them she will positively be married within a year: to a married woman such a dream is a bad omen as it denotes some gay seducer will flatter her and probably succeed in enticing her from the path of virtue.[or]Here is an old prediction in rhyme:.[cycling]"
"scorpions"	"[one of]To dream you see scorpions, signifies ill luck and misfortunes.[cycling]"
"serpents"	"[one of]To dream of serpents, is indicative of cultivated morbidity and depressed surroundings.[or]There is usually a disappointment after this dream.[or]Snakes and.[cycling]"
"servants"	"[one of]To dream that you are robbed by your servants is a sign that some one among them that you think the most of is deceiving you: if in your dream you imagine you have had your silver stolen by a servant it shows that you will have a difficulty and discharge one who will be replaced by a dishonest person.[cycling]"
"shakers"	"[one of]To dream of seeing members of the sect called.[or]Shakers in a dream, denotes that you will change in your business, and feel coldness growing towards your sweetheart.[or]If you imagine you belong to them, you will unexpectedly renounce all former ties, and seek new pleasures in distant localities.[cycling]"
"shaking hands"	"[one of]For a young woman to dream that she shakes hands with some prominent ruler, foretells she will be surrounded with pleasures and distinction from strangers.[or]If she avails herself of the opportunity, she will stand in high favor with friends.[or]If she finds she must reach up to shake hands, she will find rivalry and opposition.[or]If she has on gloves, she will overcome these obstacles.[or]To shake hands with those beneath you, denotes you will be loved and honored for your kindness and benevolence.[or]If you think you or they have soiled hands, you will find enemies among seeming friends.[or]For a young woman to dream of shaking hands with a decrepit old man, foretells she will find trouble where amusement was sought.[cycling]"
"shears"	"[one of]To see shears in your dream, denotes that you will become miserly and disagreeable in your dealings.[or]To see them broken, you will lose friends and standing by your eccentric demeanor.[cycling]"
"sheaves"	"[one of]To dream of sheaves, denotes joyful occasions.[or]Prosperity holds before you a panorama of delightful events, and fields of enterprise and fortunate gain.[cycling]"
"shells"	"[one of]To walk among and gather shells in your dream, denotes extravagance.[or]Pleasure will leave you naught but exasperating regrets and memories.[cycling]"
"shelves"	"[one of]To see empty shelves in dreams, indicates losses and consequent gloom.[or]Full shelves, augurs happy contentment through the fulfillment of hope and exertions.[cycling]"
"shirt-studs"	"[one of]To dream of shirt-studs, foretells you will struggle to humor your pride, and will usually be successful.[or]If they are diamonds, and the center one is larger than the others, you will enjoy wealth, or have an easy time, surrounded by congenial friends.[cycling]"
"shoes"	"[one of]To dream of losing one’s shoes and walking barefooted, signifies pain in the feet and sickness.[or]It also denotes loss of reproaches to those of a sanguine complexion, and more especially if this dream comes to you in the first days of the moon.[cycling]"
"shoes"	"[one of]To dream of seeing your shoes ragged and soiled, denotes that you will make enemies by your unfeeling criticisms.[or]To have them blacked in your dreams, foretells improvement in your affairs, and some important event will cause you satisfaction.[or]New shoes, augur changes which will prove beneficial.[or]If they pinch your feet, you will be uncomfortably exposed to the practical joking of the fun-loving companions of your sex.[or]To find them untied, denotes losses, quarrels and ill-health.[or]To lose them, is a sign of desertion and divorces.[or]To dream that your shoes have been stolen during the night, but you have two pairs of hose, denotes you will have a loss, but will gain in some other pursuit.[or]For a young woman to dream that her shoes are admired while on her feet, warns her to be cautious in allowing newly introduced people, and men of any kind, to approach her in a familiar way.[cycling]"
"shoes"	"[one of]If you dream that one of your shoes has a hole in it it foretells that your sweetheart will offend you by favoring a supposed rival: if a girl dreams this her lover will be jealous of her: for a young man to dream that he has lost a shoe-string is a sign that he will be kissed by a lady with whom he had no previous acquaintance.[cycling]"
"silks"	"[one of]For a lady to dream of silks and satins and that she is having fine dresses made of those fabrics foretells poverty and want: if she imagines that she is presented with a plain cheap dress and is pleased with the present it is a sign she will have some excellent luck; but if she dislikes it it shows that she will refuse an offer that will cause her after regrets.[cycling]"
"sisters"	"[one of]To dream you see your deceased brothers and sisters, signifies long life.[cycling]"
"slippers"	"[one of]To dream of slippers, warns you that you are about to perform an unfortunate alliance or intrigue.[or]You are likely to find favor with a married person which will result in trouble, if not scandal.[or]To dream that your slippers are much admired, foretells that you will be involved in a flirtation, which will suggest disgrace.[cycling]"
"snakes"	"[one of]To dream you see snakes and serpents, shows that you will be imprisoned, and encounter many dangers.[or]If you are in love, your sweetheart will be false; to dream you kill a snake, shows you will overcome difficulties and enemies and be successful in love, trade or farming, but unsuccessful at sea.[cycling]"
"snakes"	"[one of]For a woman to dream that a dead snake is biting her, foretells she will suffer from malice of a pretended friend.[or]To dream of snakes, is a foreboding of evil in its various forms and stages.[or]To see them wriggling and falling over others, foretells struggles with fortune and remorse.[or]To kill them, you will feel that you have used every opportunity of advancing your own interests, or respecting that of others.[or]You will enjoy victory over enemies.[or]To walk over them, you will live in constant fear of sickness, and selfish persons will seek to usurp your place in your companion's life.[or]If they bite you, you will succumb to evil influences, and enemies will injure your business.[or]To dream that a common spotted snake approaches you from green herbs, and you quickly step aside as it passes you, and after you had forgotten the incident to again see it approaching and growing in dimensions as it nears you, finally taking on the form of an enormous serpent; if you then, after frantic efforts, succeed in escaping its attack, and altogether lose sight of it, it foretells that you will soon imagine you are being disobeyed and slighted, and things will go on from bad to worse.[or]Sickness, uneasiness and unkindness will increase to frightful proportions in your mind; but they will adjust themselves to a normal basis, and by the putting aside of imaginary trouble, and masterfully shouldering duties, you will be contented and repaid.[or]To dream that a snake coils itself around you and darts its tongue out at you, is a sign that you will be placed in a position where you will be powerless in the hands of enemies, and you will be attacked with sickness.[or]To handle them, you will use strategy to aid in overthrowing opposition.[or]To see hairs turn into snakes, foretells that seeming insignificant incidents will make distressing cares for you.[or]If snakes turn into unnatural shapes, you will have troubles which will be dispelled if treated with indifference, calmness and will power.[or]To see or step on snakes while wading or bathing, denotes that there will be trouble where unalloyed pleasure was anticipated.[cycling]"
"snakes"	"[one of]To see snakes bite others foretells that some friend will be injured and criticised by you.[or]To see little snakes, denotes you will entertain persons with friendly hospitality who will secretly defame you and work to overthrow your growing prospects.[or]To see children playing with them, is a sign that you will be nonplussed to distinguish your friends from your enemies.[or]For a woman to think a child places one on the back of her head, and she hears the snake's hisses, foretells that she will be persuaded to yield up some possession seemingly for her good, but she will find out later that she has been inveigled into an intrigue in which enemies will tantalize her.[or]To see snakes raising up their heads in a path just behind your friend, denotes that you will discover a conspiracy which has been formed to injure your friend and also yourself.[or]To think your friend has them under control, denotes that some powerful agency will be employed in your favor to ward off evil influences.[or]For a woman to hypnotize a snake, denotes your rights will be assailed, but you will be protected by law and influential friends.[or]Serpents and.[cycling]"
"snouts"	"[one of]To dream of snouts, foretells dangerous seasons for you.[or]Enemies are surrounding you, and difficulties will be numerous.[cycling]"
"snuffers"	"[one of]To dream of snuffing out a candle is a sign of a death in the family: if you imagine that you snuff it too short without putting it out it foretells that you will do something that will make a female friend shed tears.[cycling]"
"soldiers"	"[one of]To see soldiers in your dream, shows troubles, persecution and lawsuits.[or]To the lover, they denote that the object of your affections will be obliged to quit the present place of residence by command of a father, on your account.[or]To the tradesman, they presage loss of goods and quarrels with creditors.[or]To dream they are pursuing you, shows that you will be imprisoned and meet with heavy losses, and be much disliked by your rich neighbors; this is one of those dreams after which the dreamer is advised to change quarters.[cycling]"
"soldiers"	"[one of]To see soldiers marching in your dreams, foretells for you a period of flagrant excesses, but at the same time you will be promoted to elevations above rivals.[or]To see wounded soldiers, is a sign of the misfortune of others causing you serious complications in your affairs.[or]Your sympathy will outstrip your judgment.[or]To dream that you are a worthy soldier, you will have literal fulfilment of ideals.[or]Women are in danger of disrepute if they find themselves dreaming of soldiers.[cycling]"
"sores"	"[one of]To dream of seeing sores, denotes that illness will cause you loss and mental distress.[or]To dress a sore, foretells that your personal wishes and desires will give place to the pleasure of others.[or]To dream of an infant having a deep sore so that you can see the bone, denotes that distressing and annoying incidents will detract from your plans, and children will be threatened with contagion.[or]To dream of sores on yourself, portends early decay of health and impaired mentality.[or]Sickness and unsatisfactory business will follow this dream.[cycling]"
"sores"	"[one of]To dream of your body being covered with blotches shows that a great fortune will fall to you.[or]To have the arms full of sores shows ill success in business.[cycling]"
"sparrows"	"[one of]To dream you see sparrows jumping about your door step, is a sign of good fortune attending any project you may set your mind on accomplishing.[cycling]"
"spectacles"	"[one of]To dream of spectacles, foretells that strangers will cause changes in your affairs.[or]Frauds will be practised on your credulity.[or]To dream that you see broken spectacles, denotes estrangement caused by fondness for illegal pleasures.[cycling]"
"sponges"	"[one of]Sponges seen in a dream, denote that deception is being practised upon you.[or]To use one in erasing, you will be the victim of folly.[cycling]"
"spools"	"[one of]To dream of spools of thread, indicates some long and arduous tasks, but which when completed will meet your most sanguine expectations.[or]If they are empty, there will be disappointments for you.[cycling]"
"spoons"	"[one of]To see, or use, spoons in a dream, denotes favorable signs of advancement.[or]Domestic affairs will afford contentment.[or]To think a spoon is lost, denotes that you will be suspicious of wrong doing.[or]To steal one, is a sign that you will deserve censure for your contemptible meanness in your home.[or]To dream of broken or soiled spoons, signifies loss and trouble.[cycling]"
"stairs"	"[one of]To dream of passing up a stairs, foretells good fortune and much happiness.[or]If you fall down stairs, you will be the object of hatred and envy.[or]To walk down, you will be unlucky in your affairs, and your lovemaking will be unfavorable.[or]To see broad, handsome stairs, foretells approaching riches and honors.[or]To see others going down stairs, denotes that unpleasant conditions will take the place of pleasure.[or]To sit on stair steps, denotes a gradual rise in fortune and delight.[cycling]"
"stars"	"[one of]To dream you see stars clear and fair, is good for a traveler, for it shows prosperity and advantage to a voyage or journey, also good news; but, on the contrary, to see them dusky and pale-colored, signifies all sorts of mischief.[or]Seeing the stars vanish and disappear, signifies poverty, vexation and disturbing cares to those that are rich, and death to those that are poor.[cycling]"
"stars"	"[one of]To dream of looking upon clear, shining stars, foretells good health and prosperity.[or]If they are dull or red, there is trouble and misfortune ahead.[or]To see a shooting or falling star, denotes sadness and grief.[or]To see stars appearing and vanishing mysteriously, there will be some strange changes and happenings in your near future.[or]If you dream that a star falls on you, there will be a bereavement in your family.[or]To see them rolling around on the earth, is a sign of formidable danger and trying times.[cycling]"
"stars"	"[one of]that she will have a great many children and troops of good friends: to a man of business such a dream denotes as many customers as he sees stars in a clear sky.[or]If a girl dreams of seeing stars and notices one or more to be brighter than the rest those bright ones are lovers and the small ones are her children or friends.[cycling]"
"statues"	"[one of]To dream of seeing brazen statues moving, signifies riches.[or]But to dream you see great statues moving, like monsters, denotes terror and perils.[cycling]"
"statues"	"[one of]To see statues in dreams, signifies estrangement from a loved one.[or]Lack of energy will cause you disappointment in realizing wishes.[cycling]"
"steps"	"[one of]To dream that you ascend steps, denotes that fair prospects will relieve former anxiety.[or]To decend them, you may look for misfortune.[or]To fall down them, you are threatened with unexpected failure in your affairs.[cycling]"
"sticks"	"[one of]To dream of sticks, is an unlucky omen.[cycling]"
"stilts"	"[one of]To dream of walking on stilts, denotes that your fortune is in an insecure condition.[or]To fall from them, or feel them break beneath you, you will be precipitated into embarrassments by trusting your affairs to the care of others.[cycling]"
"stings"	"[one of]To dream of stings, signifies grief and care.[or]To many, they have signified love and injuries by wicked persons.[cycling]"
"stockings"	"[one of]For a female to dream that she is darning stockings, denotes that she will be gladdened by hearing of something to her advantage.[or]For a person to dream of having lost his or her stockings, is an indication that trouble and distress will assail the dreamer.[cycling]"
"stockings"	"[one of]To dream of stockings, denotes that you will derive pleasure from dissolute companionship.[or]For a young woman to see her stockings ragged, or worn, foretells that she will be guilty of unwise, if not immoral conduct.[or]To dream that she puts on fancy stockings, she will be fond of the attention of men, and she should be careful to whom she shows preference.[or]If white ones appear to be on her feet, she is threatened with woeful disappointment or illness.[cycling]"
"stockings"	"[one of]To dream of cotton-stockings foretells moderate happiness; of silk poverty.[or]To take them off denotes the reception of money.[or]Stockings with holes in them signify the loss of property.[cycling]"
"strawberries"	"[one of]To dream of strawberries, denotes to a woman with child a good time and a boy.[or]To a maiden, speedy marriage with a man who will become rich and make her happy.[or]To a youth, they denote that his wife will be sweet tempered, and bring him many children, all boys.[or]They foretell riches to the tradesman and to the sailor.[or]They are a very fortunate dream to the farmer.[cycling]"
"strawberries"	"[one of]To dream of strawberries, is favorable to advancement and pleasure.[or]You will obtain some long wished-for object.[or]To eat them, denotes requited love.[or]To deal in them, denotes abundant harvest and happiness.[cycling]"
"strawberries"	"[one of]To dream of this fruit denotes success in love affairs and a happy marriage.[cycling]"
"stumps"	"[one of]To dream of a stump, foretells you are to have reverses and will depart from your usual mode of living.[or]To see fields of stumps, signifies you will be unable to defend yourself from the encroachments of adversity.[or]To dig or pull them up, is a sign that you will extricate yourself from the environment of poverty by throwing off sentiment and pride and meeting the realities of life with a determination to overcome whatever opposition you may meet.[cycling]"
"sugar-tongs"	"[one of]To dream of sugar-tongs, foretells that disagreeable tidings of wrong-doings will be received by you.[cycling]"
"surgical instruments"	"[one of]To see surgical instruments in a dream, foretells dissatisfaction will be felt by you at the indiscreet manner a friend manifests toward you.[cycling]"
"swallows"	"[one of]To dream of these harbingers of summer is a very favorable omen.[or]They denote success in trade and riches to the dreamer.[or]In love, they denote a speedy marriage with the object of your affections.[cycling]"
"swallows"	"[one of]To dream of these birds is a good omen as it foretells health and abundant crops to farmers: if you dream of killing a swallow it is a sign of a misfortune; if you catch the bird you will have splendid luck and get plenty of money; but if after capturing you dream you let him go a fortune will slip through your fingers.[cycling]"
"sweethearts"	"[one of]If a man dreams of his sweetheart that is absent, and she seems to be more fair than usual, it is a sign she is chaste or constant; but if she looks black or sickly, you may be assured she hath broken her faith and has become altogether inconstant.[cycling]"
"tacks"	"[one of]To dream of tacks, means to you many vacations and quarrels.[or]For a woman to drive one, foretells she will master unpleasant rivalry.[or]If she mashes her finger while driving it, she will be distressed over unpleasant tasks.[cycling]"
"tamarinds"	"[one of]To dream of tamarinds denotes vexation and uneasiness through a woman, bad success in trade, a rainy season and news from beyond the sea that is disagreeable.[or]In love, it denotes disappointment.[cycling]"
"tamarinds"	"[one of]To dream of tamarinds shows much vexation and uneasiness through a woman bad success in trade a rainy season and news from beyond sea that is disagreeable: in love they denote disappointment.[cycling]"
"tarts"	"[one of]To dream one makes tarts, signifies joy and delight.[cycling]"
"tassels"	"[one of]To see tassels in a dream, denotes you will reach the height of your desires and ambition.[or]For a young woman to lose them, denotes she will undergo some unpleasant experience.[cycling]"
"taxes"	"[one of]To dream that you pay your taxes, foretells you will succeed in destroying evil influences rising around you.[or]If others pay them, you will be forced to ask aid of friends.[or]If you are unable to pay them, you will be unfortunate in experiments you are making.[cycling]"
"teacups"	"[one of]To dream of teacups, foretells that affairs of enjoyment will be attended by you.[or]For a woman to break or see them broken, omens her pleasure and good fortune will be marred by a sudden trouble.[or]To drink wine from one, foretells fortune and pleasure will be combined in the near future.[cycling]"
"teapots"	"[one of]If a person dream of teapots they will soon form new friendships.[cycling]"
"tears"	"[one of]To dream that you are shedding tears from some heavy trouble, denotes that you will be speedily removed to a situation in which you will enjoy much happiness.[cycling]"
"tears"	"[one of]To dream that you are in tears, denotes that some affliction will soon envelope you.[or]To see others shedding tears, foretells that your sorrows will affect the happiness of others,.[cycling]"
"tears"	"[one of]To dream of shedding tears of sympathy is a sign that some one is in love with you; this applies to both sexes but more particularly to girls who cry easy: if you imagine you cry from grief some good fortune awaits you and you will have riches in proportion to the tears shed: if you dream that you shed tears from vexation it shows that you will experience a loss just in proportion to the tears or that some one will injure your prospects by circulating a scandal.[cycling]"
"tempests"	"[one of]To dream you are in a storm or tempest, shows that you will after many difficulties arrive at great happiness; that you will become rich and marry well.[or]For a lover to dream of being in a tempest, denotes that he will have rivals, over whom, after a great deal of vexation, he will triumph.[or]It also foretells that you will receive some good news from a long absent friend, who will overcome many difficulties.[cycling]"
"ten-pins"	"[one of]To dream of playing ten-pins foretells disgrace; if the centre pin falls one of the players will die; if many pins fall all of the players will suffer loss.[cycling]"
"tenpins"	"[one of]If you dream at playing at tenpins, you will doubtless soon engage in some affair which will bring discredit upon your name, and you will lose your money and true friendship.[or]To see others engaged in this dream, foretells that you will find pleasure in frivolous people and likely lose employment.[or]For a young woman to play a successful game of tenpins, is an omen of light pleasures, but sorrow will attend her later.[cycling]"
"thorns"	"[one of]To dream you walk upon thorns, signifies destruction to your enemies.[cycling]"
"thorns"	"[one of]To dream of thorns, is an omen of dissatisfaction, and evil will surround every effort to advancement.[or]If the thorns are hidden beneath green foliage, you prosperity will be interfered with by secret enemies.[cycling]"
"ticks"	"[one of]To dream you see ticks crawling on your flesh, is a sign of impoverished circumstances and ill health.[or]Hasty journeys to sick beds may be made.[or]To mash a tick on you, denotes that you will be annoyed by treacherous enemies.[or]To see in your dreams large ticks on stock, enemies are endeavoring to get possession of your property by foul means.[cycling]"
"toads"	"[one of]To dream you see these venomous reptiles, argues ill to the dreamer.[or]It shows enemies and disappointment among friends.[or]To the lover, it denotes infidelity in your sweetheart.[or]In trade, loss by swindlers and spoiling of goods.[or]To dream you kill a toad, denotes that you will overcome an enemy and discover a person who is robbing you and in whom you place great confidence.[cycling]"
"tomatoes"	"[one of]To dream of eating tomatoes, signals the approach of good health.[or]To see them growing, denotes domestic enjoyment and happiness.[or]For a young woman to see ripe ones, foretells her happiness in the married state.[cycling]"
"tomatoes"	"[one of]To dream of this valuable vegetable denotes prosperity in life; if you have children they will thrive; if you are in love your suit will be successful.[or]If a maiden dreams of them it denotes that she will marry her present sweetheart have many children and be very happy; to a farmer it denotes abundant crops.[cycling]"
"tombs"	"[one of]To dream of being amongst the tombs denotes a speedy marriage, great success in business and the gaining of a lawsuit, also the birth of children and unexpected news.[cycling]"
"tooth-picks"	"[one of]To dream of tooth-picks, foretells that small anxieties, and spites will harass you unnecessarily if you give them your attention.[or]If you use one, you will be a party to a friend's injury.[cycling]"
"tops"	"[one of]To dream you are spinning tops is ill.[cycling]"
"tops"	"[one of]To dream of a top, denotes that you will be involved in frivolous difficulties.[or]To see one spinning, foretells that you will waste your means in childish pleasures.[or]To see a top, foretells indiscriminate friendships will involve you in difficulty.[cycling]"
"toys"	"[one of]To see toys in dreams, foretells family joys, if whole and new, but if broken, death will rend your heart with sorrow.[or]To see children at play with toys, marriage of a happy nature is indicated.[or]To give away toys in your dreams, foretells you will be ignored in a social way by your acquaintances.[cycling]"
"treasures"	"[one of]To dream that you find treasures, denotes that you will be greatly aided in your pursuit of fortune by some unexpected generosity.[or]If you lose treasures, bad luck in business and the inconstancy of friends is foretold.[cycling]"
"trees"	"[one of]To dream that you fell trees, signifies loss; to dream you are climbing them, signifies future honor.[or]To see withered trees, deceit; to see trees bear fruit, gain.[cycling]"
"trees"	"[one of]To dream of trees in new foliage, foretells a happy consummation of hopes and desires.[or]Dead trees signal sorrow and loss.[or]To climb a tree is a sign of swift elevation and preferment.[or]To cut one down, or pull it up by the roots, denotes that you will waste your energies and wealth foolishly.[or]To see green tress newly felled, portends unhappiness coming unexpectedly upon scenes of enjoyment, or prosperity.[cycling]"
"trees"	"[one of]To dream of green and flourishing trees is an excellent omen as it foretells riches—the larger the trees the better the fortune: if you dream of climbing into a high tree you will not only be rich but will come to great distinction.[or]If a girl should dream of seeing her lover up a tree she will marry a wealthy and distinguished man.[cycling]"
"trenches"	"[one of]To see trenches in dreams, warns you of distant treachery.[or]You will sustain loss if not careful in undertaking new enterprises, or associating with strangers.[or]To see filled trenches, denotes many anxieties are gathering around you.[cycling]"
"triplets"	"[one of]To dream of seeing triplets, foretells success in affairs where failure was feared.[or]For a man to dream that his wife has them, signifies a pleasant termination to some affair which has been long in dispute.[or]To hear newly-born triplets crying, signifies disagreements which will be hastily reconciled to your pleasure.[or]For a young woman to dream that she has triplets, denotes that she will suffer loss and disappointment in love, but will succeed to wealth.[cycling]"
"triplets"	"[one of]If a woman dreams that she gives birth to three children at one parturition it foretells riches and honors: if a husband dreams that his wife is so delivered the omen is the same: if any one dreams of seeing triplets who are healthy and well-formed it foretells good luck and success particularly in love matters.[cycling]"
"trousers"	"[one of]To dream of trousers, foretells that you will be tempted to dishonorable deeds.[or]If you put them on wrong side out, you will find that a fascination is fastening its hold upon you.[cycling]"
"trusts"	"[one of]To dream of trusts, foretells indifferent success in trade or law.[or]If you imagine you are a member of a trust, you will be successful in designs of a speculative nature.[cycling]"
"tulips"	"[one of]To dream of these beautiful flowers is a sign of abundance: if you imagine you see a garden full of them belonging to yourself it foretells that you will become rich and distinguished: if a girl dreams that her lover presents her with tulips she will undoubtedly marry well and probably her husband will be wealthy.[cycling]"
"turkish baths"	"[one of]To dream of taking a Turkish bath, foretells that you will seek health far from your home and friends, but you will have much pleasurable enjoyment.[or]To see others take a Turkish bath, signifies that pleasant companions will occupy your attention.[cycling]"
"turnips"	"[one of]To dream of being in a turnip field, or that you see this wholesome vegetable, denotes acquisition of riches, and high employments in the state.[or]To the lover, they augur great fidelity and an exceedingly good temper in your sweetheart, and that if you marry you will be very happy, have fine children and thrive in the world.[cycling]"
"turnips"	"[one of]To see turnips growing, denotes that your prospects will brighten, and that you will be much elated over your success.[or]To eat them is a sign of ill health.[or]To pull them up, denotes that you will improve your opportunities and your fortune thereby.[or]To eat turnip greens, is a sign of bitter disappointment.[or]Turnip seed is a sign of future advancement.[or]For a young woman to sow turnip seed, foretells that she will inherit good property, and win a handsome husband.[cycling]"
"tweezers"	"[one of]To see tweezers in a dream, denotes uncomfortable situations will fill you with discontent, and your companions will abuse you.[cycling]"
"twins"	"[one of]To dream of seeing twins, foretells security in business, and faithful and loving contentment in the home.[or]If they are sickly, it signifies that you will have disappointment and grief.[cycling]"
"twins"	"[one of]To dream of having twins brings good news and is a sign of honor or riches; it is also a good omen in love matters if a man dreams it but if a girl has this dream she must look out for the boys.[cycling]"
"utensils"	"The pot denotes the life; the platter the actions of life; the candlestick intends the wife; the light or lantern the husband; the hearth the estate; vessels of wine are the servants; the stores cupboards and cabinets mean the wife."
"vegetables"	"[one of]To dream of eating vegetables, is an omen of strange luck.[or]You will think for a time that you are tremendously successful, but will find to your sorrow that you have been grossly imposed upon.[or]Withered, or decayed vegetables, bring unmitigated woe and sadness.[or]For a young woman to dream that she is preparing vegetables for dinner, foretells that she will lose the man she desired through pique, but she will win a well-meaning and faithful husband.[or]Her engagements will be somewhat disappointing.[cycling]"
"vessels"	"[one of]To dream of vessels, denotes labor and activity.[or]Ships and similar words.[cycling]"
"victuals"	"[one of]To dream of victuals and that you eat a variety of them, signifies loss.[cycling]"
"vines"	"[one of]To dream of vines denotes health and wealth to the dreamer.[or]To dream you are a vine, foretells abundance and fertility; for which we have the example of Astyages,.[or]King of the.[or]Medes, who dreamed that his daughter brought forth a vine, which was a prognostic of the grandeur, riches and felicity of Cyrus, who was born of her body after this dream.[cycling]"
"vines"	"[one of]To dream of seeing or pruning grape-vines or gathering grapes is prosperity to persons in trade journeys to the rich employment to the poor and comfort to those in affliction.[cycling]"
"violets"	"[one of]To see violets in your dreams, or gather them, brings joyous occasions in which you will find favor with some superior person.[or]For a young woman to gather them, denotes that she will soon meet her future husband.[or]To see them dry, or withered, denotes that her love will be scorned and thrown aside.[cycling]"
"visions"	"[one of]To dream that you have a strange vision, denotes that you will be unfortunate in your dealings and sickness will unfit you for pleasant duties.[or]If persons appear to you in visions, it foretells uprising and strife of families or state.[or]If your friend is near dissolution and you are warned in a vision, he will appear suddenly before you, usually in white garments.[or]Visions of death and trouble have such close resemblance, that they are sometimes mistaken one for the other.[or]To see visions of any order in your dreams, you may look for unusual developments in your business, and a different atmosphere and surroundings in private life.[or]Things will be reversed for a while with you.[or]You will have changes in your business and private life seemingly bad, but eventually good for all concerned.[or]Will is always directed toward the ultimate good of the race.[cycling]"
"vultures"	"[one of]To dream of vultures, signifies that some scheming person is bent on injuring you, and will not succeed unless you see the vulture wounded, or dead.[or]For a woman to dream of a vulture, signifies that she will be overwhelmed with slander and gossip.[cycling]"
"wages"	"[one of]For a workingman to dream that he has had his wages reduced, signifies that he is about to be removed to a more lucrative situation.[or]To dream that he has had his wages advanced, denotes that he will shortly be without employment.[cycling]"
"wages"	"[one of]Wages, if received in dreams, brings unlooked for good to persons engaging in new enterprises.[or]To pay out wages, denotes that you will be confounded by dissatisfaction.[or]To have your wages reduced, warns you of unfriendly interest that is being taken against you.[or]An increase of wages, suggests unusual profit in any undertaking.[cycling]"
"walls"	"[one of]To dream you are walking on a crazy, old and narrow wall, denotes that you will engage in some very dangerous enterprise that will cause you much trouble and vexation.[or]If you get down without hurting yourself, or the wall’s falling, then you will succeed.[or]If the wall should fall whilst you are upon it, you will be disappointed.[or]If you are walking between walls and the passage is very narrow and difficult, you will be engaged in some quarrel, or disagreeable affair, from which it will require great circumspection and caution on your part to disengage yourself.[or]But if you get from between them safe, you will settle well in life, marry an agreeable partner, have children and become rich and happy.[cycling]"
"walls"	"[one of]To dream that you find a wall obstructing your progress, you will surely succumb to ill-favored influences and lose important victories in your affairs.[or]To jump over it, you will overcome obstacles and win your desires.[or]To force a breach in a wall, you will succeed in the attainment of your wishes by sheer tenacity of purpose.[or]To demolish one, you will overthrow your enemies.[or]To build one, foretells that you will carefully lay plans and will solidify your fortune to the exclusion of failure, or designing enemies.[or]For a young woman to walk on top of a wall, shows that her future happiness will soon be made secure.[or]For her to hide behind a wall, denotes that she will form connections that she will be ashamed to acknowledge.[or]If she walks beside a base wall she will soon have run the gamut of her attractions, and will likely be deserted at a precarious time.[cycling]"
"walls"	"[one of]To dream you are walking on or climbing over walls denotes some dangerous enterprise trouble and vexation: if you get down without the wall falling or hurting yourself you will succeed; if not be disappointed.[cycling]"
"walnuts"	"[one of]To dream of walnuts, portends difficulties and misfortunes in life.[or]If you have children, your eldest son will marry a woman who will make him very unhappy.[or]In love, it foretells infidelity and disappointment.[or]To the seaman, storms and shipwreck.[or]To the tradesman, loss of goods and reputation through a confidential servant.[cycling]"
"walnuts"	"[one of]To dream of them denotes riches and happiness; to the lover success and a good tempered sweetheart.[cycling]"
"warts"	"[one of]If you are troubled with warts on your person, in dreams, you will be unable to successfully parry the thrusts made at your honor.[or]To see them leaving your hands, foretells that you will overcome disagreeable obstructions to fortune.[or]To see them on others, shows that you have bitter enemies near you.[or]If you doctor them, you will struggle with energy to ward off threatened danger to you and yours.[cycling]"
"warts"	"[one of]To dream of warts on your left hand is a sign you will receive some money; if they are on the right hand it foretells that you will pay away money: to dream of a wart on the nose signifies that you will be distinguished; on the neck or bosom of a female denotes riches.[cycling]"
"wasps"	"[one of]To dream that you are stung by wasps, signifies vexation and trouble by envious persons.[cycling]"
"waves"	"[one of]To dream that you are on the sea-shore, and surrounded by the waves, is an indication that you will be shortly placed in very difficult and distressing circumstances, out of which it will require all your energy and perseverance to escape.[cycling]"
"waves"	"[one of]To dream of waves, is a sign that you hold some vital step in contemplation, which will evolve much knowledge if the waves are clear; but you will make a fatal error if you see them muddy or lashed by a storm.[or]Ocean and.[cycling]"
"wedding clothes"	"[one of]To see wedding clothes, signifies you will participate in pleasing works and will meet new friends.[or]To see them soiled or in disorder, foretells you will lose close relations with some much-admired person.[cycling]"
"welsh rarebits"	"[one of]To dream of preparing or eating.[or]Welsh rarebits, denotes that your affairs will assume a complicated state, owing to your attention being absorbed by artful women and enjoyment of neutral fancies.[cycling]"
"whales"	"[one of]If you dream you are sitting on a whale’s back, it is good.[or]As the whale is the greatest of the water animals, so the one so dreaming will become a great person and live in peace many years.[cycling]"
"wheels"	"[one of]To see swiftly rotating wheels in your dreams, foretells that you will be thrifty and energetic in your business and be successful in pursuits of domestic bliss.[or]To see idle or broken wheels, proclaims death or absence of some one in your household.[cycling]"
"whiskers"	"[one of]If a man dreams that he has very long whiskers or beard it foretells that he will commit some folly in connection with a female; to a married man it shows that he will appear ridiculous from neglect of his wife and attentions to other women who flatter him; to a single man that he will lose caste by foolish though perhaps not criminal conduct toward silly girls.[cycling]"
"whortleberries"	"[one of]For a girl to dream of picking these berries in abundance is a sign she will marry very young and get a good husband though not a rich one: to dream of eating whortleberries denotes health.[cycling]"
"wings"	"[one of]To dream that you have wings, foretells that you will experience grave fears for the safety of some one gone on a long journey away from you.[or]To see the wings of fowls or birds, denotes that you will finally overcome adversity and rise to wealthy degrees and honor.[cycling]"
"woods"	"[one of]To dream of woods, brings a natural change in your affairs.[or]If the woods appear green, the change will be lucky.[or]If stripped of verdure, it will prove calamitous.[or]To see woods on fire, denotes that your plans will reach satisfactory maturity.[or]Prosperity will beam with favor upon you.[or]To dream that you deal in firewood, denotes that you will win fortune by determined struggle.[cycling]"
"woods"	"[one of][or]Grove and.[cycling]"
"worms"	"[one of]To dream that you see a great number of worms in your path, is an indication that the death of either yourself or of some one dear to you may shortly be expected.[or]For a young woman to dream that she has trod upon a worm that was crawling in her path, signifies that the engagement between her and her lover will be in danger of being broken off through the machinations of a jealous rival, but eventually a reconciliation will be accomplished.[cycling]"
"worms"	"[one of]To dream of worms, denotes that you will be oppressed by the low intriguing of disreputable persons.[or]For a young woman to dream they crawl on her, foretells that her aspirations will always tend to the material.[or]If she kills or throws them off, she will shake loose from the material lethargy and seek to live in morality and spirituality.[or]To use them in your dreams as fish bait, foretells that by your ingenuity you will use your enemies to good advantage.[cycling]"
"worms"	"[one of]To dream of fish-worms such as are dug in the garden is a sign of health and good fortune; dreaming of any destructive worms foretells sickness and losses: if you dream that worms spin down from a tree and light upon you it denotes difficulties and bad luck.[cycling]"
"wounds"	"[one of]To dream you are wounded, is a very favorable omen, especially if it be with a sword.[or]To the lover, it denotes success in your amours, and with an agreeable partner, who will be faithful and affectionate.[or]To the tradesman, profit; and to the farmer, increase in his cattle and plentiful crops.[or]To the sailor, a profitable voyage, with success in love.[cycling]"
"wrecks"	"[one of]To see a wreck in your dream, foretells that you will be harassed with fears of destitution or sudden failure in business.[cycling]"
"wrinkles"	"[one of]If a lady dreams that her face has become wrinkled it is a sign that some one is or has been praising her good looks; an old bachelor who dreams this 'had better believe' that some young lady is in love with him for there is no accounting for taste.[cycling]"
"zinc"	"[one of]To work with or to see zinc in your dreams, indicates substantial and energetic progress.[or]Business will assume a brisk tone in its varying departments.[or]To dream of zinc ore promises the approach of eventful success.[cycling]"
"smallpox"	"[one of]To see people with smallpox in your dream, denotes unexpected and shocking sickness, and probably contagion.[or]You will meet failure in accomplishing your designs.[cycling]"
"candy"	"[one of]To dream of candy is a sign of domestic tranquillity.[cycling]"

	
Dream Tables ends here.